zip_code,y-2016,y-2015,y-2014,y-2013,y-2012,y-2011,y-2010,aggregate
00601,17800,17982,18088,18450,18544,18533,18570,127967
00602,39716,40260,40859,41302,41640,41930,41520,287227
00603,51565,52408,53162,53683,54540,54475,54689,374522
00606,6320,6331,6415,6591,6593,6386,6615,45251
00610,27976,28328,28805,28963,29141,29111,29016,201340
00612,63884,64816,66251,68055,69017,70541,67010,469574
00616,10321,10707,10466,10183,10750,10617,11017,74061
00617,24648,24793,24917,24879,24733,24458,24597,173025
00622,7385,7425,6589,6165,5923,5419,7853,46759
00623,42711,42955,44117,44704,44943,45314,43061,307805
00624,23945,24628,24902,25340,26016,26439,26241,177511
00627,33481,33949,34438,34806,35085,35260,35159,242178
00631,1689,1664,1847,1747,1800,1836,1852,12435
00637,24013,24398,24799,24996,25312,25511,25287,174316
00638,17795,18084,18365,18742,18997,19166,18941,130090
00641,28925,29516,30183,30401,30771,30987,31191,211974
00646,38292,38396,38305,38303,38179,37942,38199,267616
00647,5711,5740,5245,5640,5869,5605,6172,39982
00650,14569,14738,14679,14969,15120,15359,14998,104432
00652,3893,3800,3831,3461,3244,3378,4715,26322
00653,12125,12514,13427,13461,13502,14048,13307,92384
00656,19996,20414,20839,21172,21438,21684,21481,147024
00659,41327,41578,41830,41932,41945,41843,41953,292408
00660,16678,16845,17023,17151,17217,17239,17250,119403
00662,41986,42499,43101,43535,43598,43600,43282,301601
00664,15693,15974,16298,16508,16665,16907,16784,114829
00667,24492,24968,25510,25797,26102,26300,25968,179137
00669,27063,27703,28442,28984,29569,30210,29744,201715
00670,9087,9333,9478,9689,9814,9867,9807,67075
00674,41545,42358,43240,43848,44365,44838,44457,304651
00676,38488,38999,39513,39916,40145,40310,40316,277687
00677,14755,14855,15012,15108,15197,15201,15272,105400
00678,26490,26815,27045,27229,27419,27733,27819,190550
00680,50628,52431,54824,56003,57220,57649,58140,386895
00682,32433,32431,31908,32509,32899,33510,32615,228305
00683,32058,32569,33050,33442,33581,34123,33772,232595
00685,40102,40800,41403,41947,42552,42753,42831,292388
00687,32087,32294,32484,32609,32617,32508,32610,227209
00688,12797,12870,13251,13340,13036,12311,13543,91148
00690,5328,5565,5906,6299,6174,6909,6255,42436
00692,36700,36777,37329,37618,37615,37691,37511,261241
00693,57428,58615,59513,60211,60873,61208,61038,418886
00694,66,77,134,157,152,199,328,1113
00698,38502,39395,40276,41179,41788,42394,41782,285316
00703,27797,28165,28739,29153,29175,29189,28605,200823
00704,8390,8007,8100,7867,7950,7879,8577,56770
00705,24387,24717,25090,25373,25575,25665,25598,176405
00707,11506,11701,11904,12070,12201,12304,12225,83911
00714,18640,18988,19229,19443,19542,19601,19566,135009
00715,3692,3586,3714,4315,4270,4582,3656,27815
00716,29351,30876,31362,32180,32840,33314,33779,223702
00717,17958,17704,18176,17972,18615,18821,18457,127703
00718,26460,26547,26786,26767,26604,26429,26606,186199
00719,30094,30588,30772,30793,30992,30998,30990,215227
00720,22148,22676,22862,23080,23259,23212,23129,160366
00723,18135,18441,18766,19017,19225,19397,19277,132258
00725,83479,86276,88152,90206,91035,92339,89374,620861
00727,57079,56503,57036,56972,56679,56000,58382,398651
00728,41245,41337,42333,42692,43260,43451,44908,299226
00729,52897,53439,54198,54768,54914,54523,53750,378489
00730,33899,34965,36201,37931,39124,40412,35742,258274
00731,14988,14382,14320,14525,13869,13559,15524,101167
00735,12798,13063,13203,13495,13803,14088,13730,94180
00736,49841,50335,51116,51576,51689,51805,51532,357894
00738,32409,33205,33835,34492,35127,35077,34922,239067
00739,37558,37970,38424,38673,39171,39479,39678,270953
00740,1503,1515,1704,1760,1730,2310,2071,12593
00741,5042,5514,5365,5025,5189,5211,4971,36317
00745,53395,53797,54253,54681,54984,55315,55062,381487
00751,22110,22777,23020,23430,23203,23467,23129,161136
00754,39218,39651,40022,40330,40631,40846,40828,281526
00757,22732,22913,23114,23231,23261,23210,23263,161724
00765,8801,8993,9139,9206,9236,9182,9098,63655
00766,24489,24875,25549,25991,26315,26727,26488,180434
00767,35734,36340,36962,37442,37863,38138,38019,260498
00769,39630,39670,39871,40026,40088,40179,40248,279712
00771,38132,38340,38435,38504,38231,38000,38394,268036
00772,21096,21478,21682,21712,21883,22194,23105,153150
00773,19237,19497,19731,19918,20050,20106,20068,138607
00775,1493,1554,1585,1478,1535,1790,1786,11221
00777,40398,40570,40863,40892,40945,40772,40684,285124
00778,46990,46765,46569,46109,45564,44880,45429,322306
00780,11597,13016,13678,13418,13340,13954,13800,92803
00782,18544,18530,18595,18504,18989,18991,19304,131457
00783,34702,35151,35856,36466,36756,37004,36557,252492
00784,41993,42625,43251,43746,44782,45043,44637,306077
00786,287,288,327,335,386,346,357,2326
00791,50515,50809,51757,52760,53104,53454,53417,365816
00794,29635,30215,30462,30688,30674,30675,30585,212934
00795,45852,46450,47106,47580,48403,48671,48736,332798
00901,6541,6132,6428,6444,6257,6064,7080,44946
00906,76,73,43,36,36,10,4,278
00907,17472,17382,17910,17696,17049,16169,17458,121136
00909,5563,5616,6071,5910,5394,5717,6230,40501
00911,7227,7444,7425,7595,7481,7772,8623,53567
00912,5758,5979,6414,6541,6353,6724,6801,44570
00913,8333,8122,8179,8255,8648,9617,9312,60466
00915,28173,29387,30642,31812,32368,33413,32820,218615
00917,19005,19086,19723,20557,21275,21779,21053,142478
00918,16400,16552,16553,16472,16890,17382,18056,118305
00920,17576,17995,18729,18540,19528,19016,17893,129277
00921,36104,37696,38499,38077,38800,39489,37763,266428
00923,25745,26591,27853,28618,30072,30755,29086,198720
00924,54062,54584,56236,58061,57860,57518,56691,395012
00925,6924,6899,7120,6877,6896,6567,8696,49979
00926,101337,104645,105093,107139,108427,111275,108862,746778
00927,14229,14447,14764,15340,15769,15449,14936,104934
00934,67,67,188,245,266,274,288,1395
00936,893,731,877,1151,1316,1431,681,7080
00949,77458,78552,80406,81758,82068,82644,82278,565164
00950,0,0,0,0,0,0,9,9
00951,8,15,15,16,16,6,35,111
00952,9078,9363,9338,9611,10099,10294,10008,67791
00953,72712,73099,73537,73236,73159,72520,73014,511277
00956,71602,74529,75830,77151,79371,80531,79304,538318
00957,42155,43336,44639,46252,46330,46777,45680,315169
00959,48349,48168,48699,48495,48030,48521,50560,340822
00960,2429,2355,2037,1496,1585,2240,1779,13921
00961,30655,30978,31774,32691,33000,32703,32429,224230
00962,20509,20975,21204,21717,22200,22523,22491,151619
00965,7543,8483,8978,8988,9256,9579,9134,61961
00966,15981,16058,15785,16371,17445,17696,16676,116012
00968,3293,3492,3594,3532,3986,3774,3478,25149
00969,43372,43021,42316,42756,42731,42066,42219,298481
00971,28550,29095,30349,30410,30042,30911,30986,210343
00976,61084,61762,61862,63387,64104,64650,65136,441985
00979,15019,15234,16157,16248,16247,16836,17030,112771
00982,14874,15029,15132,16216,16656,16370,16428,110705
00983,38533,39407,40273,41590,42485,42438,39234,283960
00985,33320,33653,35236,36507,37382,38155,36553,250806
00987,58705,60377,60544,59324,59995,60789,63661,423395
01001,17423,17438,17141,17245,17380,16775,16769,120171
01002,29970,29780,29844,29266,28718,27684,29049,204311
01003,11296,11241,11062,11032,11286,11516,10372,77805
01005,5228,5201,5113,5356,5120,5045,5079,36142
01007,14888,14838,14774,14673,14593,14479,14649,102894
01008,1194,1171,1212,1144,1160,1196,1263,8340
01009,237,429,546,716,636,663,741,3968
01010,3718,3695,3667,3635,3610,3582,3609,25516
01011,1523,1506,1478,1414,1326,1331,1370,9948
01012,528,539,499,577,506,509,661,3819
01013,22943,22394,22299,22113,21822,22391,23188,157150
01020,30629,30952,30593,30571,30893,30225,29668,213531
01022,2528,2840,2711,2794,2611,2589,2451,18524
01026,1018,1036,1009,1057,1066,1100,946,7232
01027,17872,17787,17652,17605,17622,17641,17660,123839
01028,16063,16017,15917,15816,15710,15555,15720,110798
01029,760,717,701,596,601,577,789,4741
01030,11278,11250,11485,11310,11096,11633,11669,79721
01031,1192,1369,1389,1484,1547,1524,1308,9813
01032,590,611,585,570,626,681,570,4233
01033,6310,6304,6214,6182,6197,6159,6227,43593
01034,2323,2190,2061,2174,1952,1856,2021,14577
01035,5338,5324,5285,5254,5239,5209,5250,36899
01036,5190,5179,5141,5129,5096,5078,5109,35922
01037,755,731,721,624,716,819,838,5204
01038,2853,2794,2837,2832,2676,2553,2545,19090
01039,1194,1236,1354,1566,1532,1470,1336,9688
01040,40280,40342,40079,40029,39996,39897,39880,280503
01050,2343,2513,2512,2548,2670,2656,2530,17772
01053,1697,1772,1847,1909,1926,1913,1685,12749
01054,1972,1993,1836,1759,1812,1756,1851,12979
01056,21352,21348,21288,21247,21146,21131,21103,148615
01057,8773,8712,8645,8707,8511,8492,8534,60374
01060,15407,15229,15348,15026,15065,14984,15284,106343
01062,10867,11029,10830,11007,10980,11027,11150,76890
01063,563,572,612,644,671,697,430,4189
01066,12,10,10,0,0,0,64,96
01068,1825,1803,1791,1839,1796,1822,1902,12778
01069,8753,8976,8982,8975,8881,8935,8469,61971
01070,562,565,580,579,529,580,629,4024
01071,1271,1318,1361,1401,1485,1619,1596,10051
01072,1542,1465,1482,1464,1449,1518,1478,10398
01073,6081,6022,5958,5878,5828,5758,5792,41317
01074,228,247,301,56,271,338,319,1760
01075,17770,17781,17832,17796,17705,17566,17527,123977
01077,9650,9640,9599,9552,9496,9425,9502,66864
01079,811,593,542,495,492,195,692,3820
01080,2452,2286,2176,2012,2329,2527,2334,16116
01081,1823,1720,1807,1703,1862,1812,1698,12425
01082,10612,10460,10394,10318,10265,10175,10322,72546
01083,3148,2960,3108,3137,2913,2928,2888,21082
01084,154,155,211,209,239,235,176,1379
01085,41479,41509,41121,40721,40590,40212,41117,286749
01086,690,685,1038,1219,1298,1463,687,7080
01088,433,493,446,451,595,719,670,3807
01089,28575,28600,28554,28498,28411,28320,28391,199349
01092,1191,1291,1078,1080,1440,1460,1394,8934
01093,289,307,282,282,298,355,325,2138
01094,347,336,310,340,240,214,351,2138
01095,14569,14514,14436,14344,14275,14183,14319,100640
01096,2564,2494,2522,2249,2220,2078,2217,16344
01097,78,31,36,83,83,53,111,475
01098,1117,1149,1095,1081,1138,1136,1101,7817
01103,2430,2564,2472,2556,2340,2481,2479,17322
01104,23183,23485,22285,23083,22833,23038,22865,160772
01105,11576,12027,12054,12360,12664,13105,12350,86136
01106,15983,16007,16077,16018,16079,16087,16021,112272
01107,11474,11224,11706,11271,11071,11368,11611,79725
01108,28449,27342,26670,25755,25551,24808,26688,185263
01109,30139,30541,30987,31429,31503,31134,30250,215983
01118,14293,14453,14192,13722,13762,13754,14071,98247
01119,13091,13269,13942,13962,14946,15044,14152,98406
01128,2695,2498,2568,2468,2347,2536,2631,17743
01129,7220,7377,7160,7505,7330,7165,7019,50776
01151,9295,9037,9581,9134,8655,8244,8698,62644
01199,0,0,0,0,0,0,0,0
01201,45001,45328,45557,45887,45975,46257,46504,320509
01220,8266,8391,8536,8586,8657,8706,8603,59745
01222,829,812,811,805,875,783,829,5744
01223,2247,2294,2336,2346,2399,2358,2314,16294
01224,176,138,242,322,291,249,182,1600
01225,3192,3124,3057,3059,3036,3033,3117,21618
01226,6885,6892,6944,6981,7024,6971,6945,48642
01229,102,114,131,111,170,178,95,901
01230,8195,8048,8148,8200,8486,8697,8430,58204
01235,2666,2866,2904,3032,2867,2861,2766,19962
01236,1422,1538,1574,1631,1396,1323,1509,10393
01237,2755,2841,2735,2509,2599,2544,2496,18479
01238,5950,5950,6245,6198,6190,6209,6047,42789
01240,4592,4603,4823,4818,4442,4418,4534,32230
01242,429,394,192,155,569,578,476,2793
01243,381,374,383,345,267,249,334,2333
01244,82,115,149,150,133,172,151,952
01245,870,950,807,726,821,833,985,5992
01247,15725,15737,15859,16025,16160,16213,16087,111806
01253,734,708,683,742,623,584,731,4805
01254,985,954,1043,997,1120,1187,972,7258
01255,869,852,896,930,886,985,915,6333
01256,764,796,703,675,663,706,692,4999
01257,2164,2203,2140,2183,2072,2138,2121,15021
01258,359,334,334,304,321,262,374,2288
01259,556,563,540,613,564,516,635,3987
01260,545,485,246,240,157,73,240,1986
01262,1196,1239,1337,1257,1171,1040,1238,8478
01264,161,153,156,167,143,138,137,1055
01266,1380,1430,1491,1433,1600,1686,1463,10483
01267,7846,7884,7906,7985,7994,8035,7989,55639
01270,814,789,766,806,776,798,778,5527
01301,17730,17766,17731,17806,17843,17822,17700,124398
01330,1468,1432,1596,1540,1439,1574,1506,10555
01331,13205,13290,13264,13383,13520,13456,13263,93381
01337,2598,2593,2576,2609,2528,2569,2596,18069
01338,138,196,209,169,231,245,187,1375
01339,1461,1378,1514,1597,1586,1441,1438,10415
01340,1689,1686,1686,1784,1671,1734,1701,11951
01341,1716,1711,1583,1605,1776,1753,1833,11977
01342,1768,1616,1577,1506,1481,1234,1492,10674
01343,46,46,72,76,85,113,75,513
01344,1582,1559,1557,1526,1471,1454,1498,10647
01346,465,496,466,448,426,395,533,3229
01347,133,143,128,93,102,74,166,839
01349,1106,1078,888,844,847,980,1091,6834
01350,95,104,118,117,105,122,121,782
01351,2312,2212,2167,2253,2367,2407,2270,15988
01354,1656,1641,1573,1532,1565,1428,1500,10895
01355,915,925,981,990,895,843,878,6427
01360,3006,3022,3031,3033,3043,3034,3032,21201
01364,7832,7880,7932,7960,7966,7942,7969,55481
01366,1202,1167,1355,1294,1301,1335,1277,8931
01367,686,666,569,590,530,450,522,4013
01368,1363,1336,1230,1161,1051,1058,1261,8460
01370,3879,3990,4143,4113,4127,4362,4084,28698
01373,4184,4355,4406,4441,4631,4770,4600,31387
01375,3673,3680,3683,3692,3690,3696,3684,25798
01376,5101,5275,5511,5513,5432,5329,5247,37408
01378,734,726,690,639,631,601,774,4795
01379,775,843,873,957,1004,1042,813,6307
01420,40441,40462,40419,40358,40327,40309,40337,282653
01430,6171,6160,6133,6119,6077,6033,6089,42782
01431,3196,3177,3147,3114,3066,3030,3074,21804
01432,7594,7489,7337,7061,7105,6945,7089,50620
01434,1716,1658,1656,1702,1564,1607,1795,11698
01436,3823,3897,3931,3838,3641,3320,3336,25786
01438,635,553,464,359,313,379,559,3262
01440,20334,20320,20293,20388,20393,20479,20347,142554
01450,11182,11120,10997,10842,10687,10478,10646,75952
01451,4629,4758,4841,4964,4915,4711,4747,33565
01452,4537,4474,4452,4398,4366,4341,4382,30950
01453,41336,41206,40978,41002,41113,41069,40883,287587
01460,9538,9359,9157,9038,8934,8810,8924,63760
01462,11087,11029,10797,10549,10356,10034,10086,73938
01463,12031,11953,11782,11645,11537,11407,11497,81852
01464,7433,7436,7404,7435,7352,7235,7211,51506
01467,560,472,440,398,401,590,316,3177
01468,3704,3717,3682,3710,3880,4055,4021,26769
01469,7430,7348,7328,7044,6822,6669,6801,49442
01473,7480,7414,7361,7320,7282,7250,7277,51384
01474,1939,1934,1855,1993,2159,2237,2125,14242
01475,10613,10542,10466,10386,10333,10250,10270,72860
01501,16239,16208,16136,16089,16080,16025,16075,112852
01503,3061,2957,2917,2886,2856,2819,2866,20362
01504,9068,9078,9055,9035,9030,9028,9026,63320
01505,4480,4432,4399,4366,4341,4320,4355,30693
01506,3386,3405,3396,3382,3378,3363,3390,23700
01507,13292,13215,13126,13034,12947,12827,12981,91422
01510,13759,13727,13675,13634,13618,13614,13606,95633
01515,2259,2198,2263,2253,2152,2058,2183,15366
01516,8689,8650,8624,8575,8466,8372,8500,59876
01518,3009,2951,2418,2689,3089,2972,2974,20102
01519,6548,6301,6573,6514,6386,6431,6595,45348
01520,14880,14929,14724,14354,14333,14156,13997,101373
01521,2374,2498,2491,2442,2477,2595,2481,17358
01522,3380,3089,3038,3145,2994,3041,3310,21997
01523,7811,7877,7847,7680,7395,7329,7582,53521
01524,6649,6827,7103,6940,7029,6841,6696,48085
01525,128,138,152,145,136,203,290,1192
01527,13431,13391,13350,13264,13257,13216,13246,93155
01529,3218,3208,3208,3197,3168,3154,3190,22343
01531,1106,1133,1109,1053,1084,1124,999,7608
01532,14846,14814,14644,14529,14407,14180,14155,101575
01534,6406,6378,6303,5299,5168,5142,5631,40327
01535,4761,4734,4715,4706,4681,4686,4680,32963
01536,7557,7634,7138,7042,7156,7063,6888,50478
01537,2671,2444,2392,2458,2334,2312,2248,16859
01540,10921,11112,11219,11148,11237,11377,11291,78305
01541,3451,3456,3432,3424,3423,3412,3413,24011
01542,2366,2110,1747,1782,1655,1744,2202,13606
01543,8402,8316,8188,8075,7967,7812,7973,56733
01545,36103,35963,35818,35575,35413,35146,35299,249317
01550,16824,16802,16775,16741,16775,16800,16719,117436
01560,4504,4558,4565,4531,4290,4073,4527,31048
01561,249,141,155,174,293,359,330,1701
01562,11801,11773,11746,11733,11713,11715,11688,82169
01564,7954,7896,7870,7839,7808,7768,7808,54943
01566,6442,6469,6945,6617,6141,6161,6294,45069
01568,7532,7468,7453,7431,7367,7281,7480,52012
01569,13881,13828,13703,13559,13422,13171,13569,95133
01570,16838,16827,16806,16782,16760,16752,16767,117532
01571,11608,11515,11633,11445,11401,11276,11390,80268
01581,18706,18611,18481,18371,18345,18285,18272,129071
01583,7602,7442,7687,7698,7627,7600,7591,53247
01585,4606,4664,4705,4646,4481,4448,4554,32104
01588,9731,9668,9569,10350,10411,10262,9733,69724
01590,9184,9080,9014,8943,8836,8808,8875,62740
01602,23812,23709,24228,23707,23185,22353,22819,163813
01603,20505,20053,20380,19385,19123,18858,19916,138220
01604,35866,35441,34628,34720,35844,35564,34677,246740
01605,28696,28242,27387,27279,26247,25895,26221,189967
01606,19258,19209,19043,19495,19899,20283,19077,136264
01607,8636,9288,8991,8957,8265,8425,8351,60913
01608,3511,3275,3351,3558,3767,3961,3888,25311
01609,19982,20916,20948,21178,21571,21346,22421,148362
01610,23919,23912,23885,23964,23826,24114,23945,167565
01611,2466,2548,2458,2481,2446,2362,2242,17003
01612,4889,4895,4879,4856,4846,4767,4845,33977
01701,32061,31949,31780,31435,31144,30895,31217,220481
01702,38781,38573,38180,38020,37700,36996,37206,265456
01718,526,415,303,343,367,563,469,2986
01719,5287,5137,5102,5048,5017,4957,4996,35544
01720,22638,22436,22197,21804,21382,20897,21361,152715
01721,17420,17159,16985,16792,16587,16305,16593,117841
01730,14018,13847,13709,13649,13515,13297,13221,95256
01731,1957,2082,1893,1717,1865,1883,1396,12793
01740,5113,5067,5019,4967,4905,4827,4897,34795
01741,5125,5074,4967,4918,4870,4814,4852,34620
01742,19448,19345,18948,18586,18309,17719,17726,130081
01745,482,373,309,305,365,378,397,2609
01746,14324,14197,14008,13811,13668,13512,13547,97067
01747,5942,5942,5934,5928,5911,5909,5911,41477
01748,16257,15925,15604,15271,14982,14691,14925,107655
01749,19680,19602,19464,19263,19077,18845,19063,134994
01752,39545,39425,39141,38842,38491,38087,38499,272030
01754,10526,10459,10314,10211,10151,10083,10106,71850
01756,5963,5938,5895,5851,5827,5787,5839,41100
01757,28600,28543,28391,28252,28120,28008,28061,197975
01760,35133,34683,34043,33353,32821,32559,32786,235378
01770,4255,4245,4200,4169,4128,4102,4119,29218
01772,9486,9536,9560,9502,9380,9293,9370,66127
01773,4793,5262,5367,4836,4672,4701,5112,34743
01775,7027,6957,6841,6737,6618,6488,6590,47258
01776,18594,18397,18197,17922,17712,17482,17659,125963
01778,13697,13562,13421,13280,13136,13062,13109,93267
01801,39775,39609,39315,38961,38732,38252,38903,273547
01803,25698,25467,25190,24700,24372,23998,24487,173912
01810,34963,34616,34251,33746,33385,32945,33201,237107
01821,31780,31607,31157,30591,30569,30168,30310,216182
01824,25803,25669,25582,24673,24603,24934,24911,176175
01826,30855,30633,30315,29968,29555,29213,29422,209961
01827,3310,3343,3299,3255,3190,3128,3179,22704
01830,25882,26499,26415,25687,25229,25062,25137,179911
01832,23305,22397,22137,22121,22324,21934,22060,156278
01833,8514,8441,8379,8295,8203,8083,8183,58098
01834,6681,6646,6805,6675,6530,6401,6459,46197
01835,13153,13183,13217,13527,13400,13548,13682,93710
01840,5524,5165,4799,4547,4493,4432,4733,33693
01841,47836,48242,47125,47676,47547,47741,47225,333392
01843,25963,25397,25440,24597,24291,23686,24425,173799
01844,49057,48607,48159,47690,47238,46687,47249,334687
01845,29705,29271,28963,28677,28114,28156,28352,201238
01850,16394,16006,16198,15496,15924,16170,15237,111425
01851,30026,30022,30379,29791,29404,29726,30190,209538
01852,34332,33822,32735,33106,33316,32664,33508,233483
01854,29204,29557,29214,29073,28113,27336,27606,200103
01860,6695,6601,6536,6440,6368,6297,6338,45275
01862,11134,10985,10904,10992,10385,10145,10227,74772
01863,9103,9088,8913,9526,9328,8676,8891,63525
01864,15476,15396,15249,15076,14919,14703,14892,105711
01867,24935,24852,24687,24524,24252,24083,23956,171289
01876,29692,29479,29103,28778,28634,28395,28667,202748
01879,12133,12053,11867,11675,11484,11198,11305,81715
01880,26062,25819,25460,25116,24906,24699,24733,176795
01886,23850,23232,22854,22458,22107,21716,21951,158168
01887,23310,23141,22907,22656,22392,22116,22325,158847
01890,22491,22075,21863,21621,21437,21205,21382,152074
01901,1637,1371,1807,2023,2147,1832,1689,12506
01902,47081,47052,46119,44827,44654,44991,45139,319863
01904,17103,17521,18053,18803,18765,19076,18203,127524
01905,26209,25668,25269,25090,24779,24071,25251,176337
01906,27773,27620,27369,27051,26761,26516,26660,189750
01907,14418,14217,14123,14086,14011,13974,14027,98856
01908,3471,3454,3451,3432,3438,3420,3410,24076
01913,17082,16907,16554,16429,16344,16267,16283,115866
01915,40967,40670,40370,40026,39748,39455,39502,280738
01921,8198,8138,8105,8040,7990,7950,7961,56382
01922,2829,2803,2649,3025,3013,3062,3108,20489
01923,27419,27266,26963,26810,26507,26265,26342,187572
01929,3632,3608,3580,3546,3520,3470,3504,24860
01930,29546,29399,29237,29043,28937,28869,28789,203820
01937,139,134,112,89,61,38,151,724
01938,13682,13616,13480,13354,13271,13127,13175,93705
01940,13143,12944,12704,12299,12019,11793,12108,87010
01944,5321,5286,5247,5185,5158,5137,5136,36470
01945,20363,20270,20163,19958,19879,19811,19808,140252
01949,9514,9436,9273,9131,8992,8839,8987,64172
01950,17837,17766,17662,17569,17460,17370,17416,123080
01951,4076,4051,4145,3707,3673,3585,3558,26795
01952,8899,8672,8495,8396,8289,8212,8283,59246
01960,51948,51729,51597,51319,51036,50674,50944,359247
01966,7167,7111,7078,7040,7018,7021,6952,49387
01969,6145,6081,5995,5914,5857,5815,5856,41663
01970,42650,42332,42151,41747,41500,41051,41109,292540
01982,8136,8102,8098,7995,7942,7809,7764,55846
01983,6434,6379,6286,6211,6127,6075,6089,43601
01984,5135,5092,5039,4964,4892,4831,4875,34828
01985,4484,4427,4370,4305,4263,4222,4235,30306
02019,16833,16682,16564,16438,16304,16165,16332,115318
02021,22562,22276,22036,21781,21596,21408,21561,153220
02025,8316,8281,8100,7935,7756,7483,7542,55413
02026,25272,25224,25111,24906,24716,24521,24711,174461
02030,5864,5814,5727,5677,5608,5564,5589,39843
02032,4070,4080,4103,3884,3536,3709,4226,27608
02035,17348,17243,17129,16990,16864,16734,16865,119173
02038,32873,32731,32393,32064,31760,31317,31635,224773
02043,22901,22733,22550,22330,22136,21916,22157,156723
02045,10437,10403,10324,10319,10342,10391,10293,72509
02047,47,151,125,111,136,171,180,921
02048,23615,23482,23389,23293,23191,23094,23184,163248
02050,25961,25786,25543,25647,25485,25360,25429,179211
02052,12510,12368,12236,12136,12067,12004,12024,85345
02053,13135,13069,12965,12866,12742,12670,12752,90199
02054,8110,8051,8007,7950,7905,7852,7891,55766
02056,11442,11427,11407,11274,11142,10994,10981,78667
02061,10845,10740,10651,10560,10501,10430,10506,74233
02062,29018,28962,28844,28698,28580,28483,28602,201187
02066,17978,17880,18002,17730,17708,17643,17656,124597
02067,18066,17837,17703,17591,17399,17341,17486,123423
02071,1686,1837,1911,1770,1947,1831,1707,12689
02072,28260,28110,27833,27522,27359,27008,26999,193091
02081,19481,19270,18855,19006,18899,18561,18472,132544
02090,15364,15094,14809,14714,14616,14508,14636,103741
02093,11483,11287,11169,11058,10960,10879,10955,77791
02108,4049,4183,4049,4062,4155,3923,3825,28246
02109,4015,3947,3993,4241,4277,4042,3771,28286
02110,2124,2048,1906,1752,1486,1586,1733,12635
02111,7564,7537,7505,7771,7616,6995,7383,52371
02113,7495,7221,7360,6843,7276,6768,6915,49878
02114,13001,12882,12801,11994,11933,11882,11999,86492
02115,28976,28536,29465,28928,29178,29413,28441,202937
02116,23004,22433,22229,21793,21318,20689,20628,152094
02118,27664,27526,27534,27873,26779,27113,26498,190987
02119,26833,26259,25734,24767,24237,24166,25346,177342
02120,15322,15500,15073,14221,13217,12691,15181,101205
02121,28029,28051,27459,27093,26801,24972,25978,188383
02122,24624,24880,25613,24546,25437,24761,23479,173340
02124,52986,53227,51544,51382,49867,48384,47783,355173
02125,36353,35379,33937,34172,31996,31503,33295,236635
02126,29531,27835,28279,27984,27335,26719,25562,193245
02127,36311,36494,34732,33825,32547,31954,31799,237662
02128,46208,44989,44512,43575,41680,41128,40508,302600
02129,18314,18058,17954,17454,17052,16685,16439,121956
02130,39316,39257,38214,37541,36866,35323,35401,261918
02131,32459,31890,31733,30960,30370,30914,29826,218152
02132,28292,28506,28791,27628,27163,26813,25861,193054
02134,17598,18238,18277,19009,20478,20183,21503,135286
02135,40513,38682,36486,36932,38839,40493,42780,274725
02136,31762,31052,30207,29271,29219,29082,28488,209081
02138,37067,37252,36937,35554,35661,34301,36314,253086
02139,36338,36422,35783,36015,35945,35994,36349,252846
02140,19604,18384,17894,18164,17924,18398,17607,127975
02141,13059,13055,13344,13126,12703,12716,11910,89913
02142,2807,2935,3030,2838,2805,2902,3141,20458
02143,26800,26267,25915,26056,24965,24652,24514,179169
02144,24475,24930,24539,23854,24399,24338,23891,170426
02145,26006,25291,24807,24659,24153,24061,25439,174416
02148,60812,60725,60293,59819,59402,58826,59503,419380
02149,44496,43717,42717,42076,41607,41074,41550,297237
02150,38237,37567,37074,36222,35527,34872,35124,254623
02151,53172,53109,53268,52534,51729,50845,51808,366465
02152,18031,17962,17992,17763,17584,17430,17497,124259
02155,59348,59166,59193,58832,58567,58211,57964,411281
02163,2575,2361,2208,2100,1842,1664,2582,15332
02169,55876,55706,55408,55064,54043,53270,55055,384422
02170,19574,19860,19318,19796,19962,19889,19505,137904
02171,17899,17611,18194,17735,18073,18325,17711,125548
02176,27787,27681,27509,27239,27043,26864,26983,191106
02180,21831,21752,21611,21498,21414,21413,21437,150956
02184,37066,36905,36543,36051,35731,35409,35744,253449
02186,27351,27303,27204,27094,26954,26828,27003,189737
02188,15347,14911,14642,14655,14206,14233,14608,102602
02189,15076,15161,15128,14609,14807,14350,14559,103690
02190,16886,16880,16667,16733,16176,16308,16119,115769
02191,8292,8352,8378,8369,8744,8674,8457,59266
02199,1260,1173,1359,1273,1290,1218,1146,8719
02203,0,0,0,0,0,0,0,0
02210,2461,2179,1984,1894,1905,1658,2090,14171
02215,24698,24521,24046,24213,23719,23933,26125,171255
02301,60659,59775,59275,58982,60265,60850,61025,420831
02302,34154,34757,34992,34929,33651,33066,32741,238290
02322,4476,4453,4421,4400,4349,4341,4356,30796
02324,27381,27243,26931,26573,26687,26508,26563,187886
02330,11557,11562,11541,11493,11497,11481,11509,80640
02332,15444,15297,15208,15126,15040,14978,15059,106152
02333,14222,14113,13996,13894,13794,13704,13794,97517
02338,7753,7684,7629,7546,7524,7516,7518,53170
02339,14332,14226,14120,14027,13902,13813,13879,98299
02341,10477,10372,10316,10250,10209,10180,10218,72022
02343,10654,10975,10795,10667,10595,10527,10745,74958
02346,24005,23708,23541,23247,23037,22807,23106,163451
02347,11230,11098,10933,10798,10674,10533,10612,75878
02351,16196,16112,16081,16009,15930,15841,16029,112198
02356,12498,12690,12923,12625,12730,13043,12564,89073
02357,1234,1282,938,959,1010,1011,1360,7794
02359,18166,18081,18006,17916,17831,17708,17828,125536
02360,58024,57658,57275,56816,56425,55865,56271,398334
02364,13106,12958,12846,12673,12609,12556,12629,89377
02366,192,190,139,149,149,146,197,1162
02367,2913,2868,2840,2834,2817,2799,2820,19891
02368,33880,33409,33265,32952,32577,32089,32158,230330
02370,17725,17663,17616,17546,17518,17515,17489,123072
02375,10038,9611,9687,9833,9480,9007,9188,66844
02379,7044,7008,6981,6928,6907,6896,6916,48680
02382,14767,14715,14643,14567,14493,14430,14489,102104
02420,14325,14414,13947,14073,13927,13831,14052,98569
02421,18611,18286,18359,17813,17600,17298,17342,125309
02445,21029,20785,20723,20844,20853,21110,20679,146023
02446,29589,29099,28796,28924,28807,28601,29311,203127
02451,18130,18140,17454,17299,16573,16662,17426,121684
02452,15295,15232,15495,15025,14434,14318,14238,104037
02453,29256,29066,28959,28997,29829,29229,28968,204304
02457,1622,1642,1334,1343,1343,1278,1432,9994
02458,12868,12781,12093,11602,11362,11048,12131,83885
02459,19020,19104,18519,18339,18210,18244,19095,130531
02460,10125,9477,9591,9046,8639,9080,8742,64700
02461,7267,7278,7099,6808,6856,6923,7059,49290
02462,1419,1389,1306,1412,1292,1453,1554,9825
02464,3136,2901,2868,2947,3112,2834,2953,20751
02465,11875,11618,11499,11673,11822,11759,11710,81956
02466,8573,8572,8973,9105,8591,8338,8096,60248
02467,22048,23520,23724,23092,22796,21952,22491,159623
02468,5485,5713,5374,5267,5251,4897,5273,37260
02472,33874,33350,32943,32622,32274,32025,32014,229102
02474,27916,27346,27113,26646,26079,26433,26312,187845
02476,16492,16782,16615,16662,16873,16137,16532,116093
02478,25548,25337,25110,24864,24691,24473,24664,174687
02481,16328,16342,16320,16215,16332,16021,16244,113802
02482,10959,10848,11204,10946,10513,10519,10306,75295
02492,20185,20067,20163,20131,19950,19901,19931,140328
02493,11946,11850,11704,11538,11430,11229,11261,80958
02494,9982,9786,9377,9109,9055,8885,8955,65149
02532,12370,11972,11857,11455,11592,11698,12690,83634
02534,952,913,988,1247,982,895,842,6819
02535,1812,1511,1268,1283,1240,1267,1177,9558
02536,19366,19344,19060,19470,19524,19864,19583,136211
02537,6249,6500,6301,6288,6256,6181,6293,44068
02538,3228,3009,3294,3245,3162,3451,3603,22992
02539,4247,4217,4186,4135,4086,4034,4067,28972
02540,8635,8526,8710,8554,8521,8355,8221,59522
02542,756,869,1069,1155,1284,1237,1139,7509
02543,935,843,806,736,684,613,635,5252
02553,115,237,191,210,314,275,226,1568
02554,10434,10287,10154,9843,9847,9914,9852,70331
02556,2621,2852,3021,2852,2890,2880,3115,20231
02557,4647,4626,4599,4563,4513,4449,4491,31888
02558,1243,1322,1538,1489,1791,1363,2156,10902
02559,4243,4366,4174,4056,3941,3772,3376,27928
02561,479,478,496,468,471,443,539,3374
02562,3194,3139,3128,3371,3232,3403,2977,22444
02563,9469,9721,9972,9616,9746,10285,10359,69168
02564,250,260,249,381,347,221,310,2018
02568,4072,4055,4036,3995,3967,3999,4000,28124
02571,10628,11229,10490,10497,11255,11535,10481,76115
02575,2306,2564,2727,2628,2606,2421,2725,17977
02576,5225,4763,5032,4888,3898,3492,3754,31052
02584,10,9,11,0,0,0,10,40
02601,14503,14371,14252,13552,13402,13442,14089,97611
02630,2355,2224,2265,2113,2129,1706,1850,14642
02631,9782,9761,9736,9610,9721,9734,9679,68023
02632,10293,10454,11294,11543,11466,11491,10742,77283
02633,3859,3849,3846,3868,4057,4298,3884,27661
02635,3486,3435,3282,3355,3366,3464,3296,23684
02637,125,117,53,84,82,105,253,819
02638,3479,3489,3557,3355,3562,3378,3207,24027
02639,2435,2550,2698,3138,3240,3368,2875,20304
02641,236,265,222,355,501,532,532,2643
02642,4898,4896,4903,4919,4963,5011,4937,34527
02643,9,9,18,17,17,9,26,105
02644,4829,4347,4256,4469,4389,3934,3955,30179
02645,9457,9354,9668,9487,9417,9440,9663,66486
02646,1888,2057,1782,1946,1878,1771,1676,12998
02647,169,113,108,129,123,125,129,896
02648,6456,6413,6454,6898,7206,7633,7301,48361
02649,14080,14027,13988,14000,13950,13900,14006,97951
02650,1197,1222,1190,1222,1183,884,848,7746
02651,26,27,29,26,20,0,16,144
02652,781,886,995,1133,1125,1407,1175,7502
02653,5879,5904,5978,5982,5950,6001,5911,41605
02655,3465,3584,3616,3943,3846,3638,3518,25610
02657,2962,2962,2959,2964,2974,2994,2942,20757
02659,835,801,806,837,741,915,1108,6043
02660,6557,6381,6393,6018,5881,5881,6261,43372
02663,120,125,83,121,96,49,173,767
02664,9049,9407,9342,9487,9562,9295,9371,65513
02666,808,758,743,598,528,496,828,4759
02667,3048,2984,2928,2891,3002,2809,2580,20242
02668,2934,3192,2708,2755,3178,3414,3278,21459
02669,251,254,287,211,183,80,285,1551
02670,1325,1362,1243,1302,1087,1233,1307,8859
02671,913,851,755,844,1011,1103,1023,6500
02672,257,155,137,150,91,109,180,1079
02673,8571,8297,8574,8407,8384,8793,8402,59428
02675,6383,6410,6345,6254,6155,6190,6577,44314
02702,4632,4730,4651,4567,4268,4090,4125,31063
02703,44121,43953,43774,43677,43603,43459,43593,306180
02713,40,60,78,114,139,145,52,628
02715,3625,3269,3344,3195,3057,2747,3123,22360
02717,4479,4301,4306,4356,4599,4738,4745,31524
02718,6524,6275,6529,6774,6854,6919,6655,46530
02719,16078,16027,15971,15952,15893,15915,15873,111709
02720,30785,30546,31091,30811,30782,31341,30287,215643
02721,25722,25926,25557,26141,25566,25660,26290,180862
02723,14162,14333,14403,14298,14799,14753,14767,101515
02724,17601,17173,16882,16769,17147,16882,16908,119362
02725,2320,2399,2629,2717,2577,2779,2631,18052
02726,15959,15872,15633,15524,15654,15393,15534,109569
02738,5014,4979,4935,4915,4913,4926,4907,34589
02739,6216,6176,6138,6086,6070,6073,6045,42804
02740,43531,43797,43513,43308,43863,43505,43087,304604
02743,10422,10384,10339,10321,10310,10310,10307,72393
02744,11231,11210,11589,11722,11551,11892,11900,81095
02745,24419,24731,24641,24830,25005,25039,24576,173241
02746,15419,14850,14755,14835,14345,14451,15342,103997
02747,23382,23024,22790,22092,21538,20903,22927,156656
02748,11849,12032,12160,12591,12893,12974,11442,85941
02760,27130,26986,27177,27081,26997,26666,26739,188776
02762,8892,8735,8581,8429,8278,8176,8264,59355
02763,1815,1877,1602,1638,1676,1927,1973,12508
02764,3708,3962,3837,3926,4006,4256,3988,27683
02766,19409,19362,19280,19209,19123,18970,19031,134384
02767,13872,13765,13588,13450,13461,13383,13566,95085
02769,11914,11835,11742,11664,11570,11470,11608,81803
02770,5219,5150,5163,5275,5199,5135,5093,36234
02771,14653,14371,14131,13932,13785,13700,13708,98280
02777,16236,16132,15997,15943,15903,15886,15840,111937
02779,6589,6547,6492,6452,6411,6336,6411,45238
02780,49807,49836,49456,49151,48972,48836,49036,345094
02790,15805,16016,16142,16154,16074,15941,15717,111849
02791,284,177,127,80,46,29,246,989
02802,1078,1079,998,919,582,460,786,5902
02804,2026,2228,2413,2587,2657,2761,2607,17279
02806,16304,16280,16290,16298,16352,16415,16310,114249
02807,885,906,893,836,863,953,1051,6387
02808,2327,2228,2312,2202,2491,2704,2401,16665
02809,22376,22364,22493,22531,22792,23116,22938,158610
02812,1424,1669,1947,1969,1901,1829,1497,12236
02813,7776,7772,7788,7821,7823,7854,7831,54665
02814,7562,7328,7386,7477,7584,7467,7496,52300
02815,183,130,162,200,256,283,278,1492
02816,32647,32695,32707,32800,32646,32825,32611,228931
02817,6112,6117,6118,6102,6081,6028,6135,42693
02818,18299,18065,18207,18241,18189,18296,18082,127379
02822,6480,6470,6358,6460,6379,6227,6111,44485
02825,5263,5235,5183,5305,5381,5377,5377,37121
02826,611,690,700,637,450,387,791,4266
02827,2078,2033,2042,2067,2149,2082,2172,14623
02828,7479,7492,7398,7403,7590,7488,7704,52554
02830,5875,6314,6617,6356,6788,6974,5976,44900
02831,3436,3191,3174,3129,3340,3340,3515,23125
02832,4839,5006,4801,5263,5222,5166,4608,34905
02833,775,625,565,513,495,467,784,4224
02835,5462,5464,5444,5423,5420,5418,5405,38036
02836,185,93,86,103,119,61,136,783
02837,3494,3504,3491,3490,3491,3502,3492,24464
02838,3667,3878,3855,3615,3780,3713,3400,25908
02839,1882,1445,1539,1617,1744,1999,1902,12128
02840,23149,23171,23246,23306,23438,23652,23335,163297
02841,1442,1293,1389,1066,967,969,1392,8518
02842,16021,16052,16045,16116,16122,16200,16095,112651
02852,22342,22358,22487,22567,22587,22706,22551,157598
02857,9116,9672,9368,8919,8479,8256,8412,62222
02858,650,662,451,605,554,526,570,4018
02859,7196,7059,6944,6932,6610,6246,6738,47725
02860,46221,45372,45227,43862,43960,44005,45199,313846
02861,25400,26225,26233,27431,27434,27555,26178,186456
02863,19366,19378,19406,19387,19374,19360,19385,135656
02864,34228,34003,33714,33429,33340,33085,33396,235195
02865,16742,16513,16634,16881,16878,17119,16951,117718
02871,17112,17127,17093,17155,17222,17239,17171,120119
02872,239,234,259,184,105,79,218,1318
02873,315,218,186,181,172,105,235,1412
02874,6152,6621,6252,6077,6132,5838,5860,42932
02875,467,426,493,428,375,366,307,2862
02876,250,251,314,237,281,81,430,1844
02878,15795,15818,15805,15805,15738,15706,15780,110447
02879,20928,20358,20247,20675,20620,21009,20371,144208
02881,7715,7969,8061,7681,7651,7258,7841,54176
02882,13475,13448,13938,13966,14013,14397,14184,97421
02885,10548,10532,10555,10597,10652,10733,10627,74244
02886,28848,28330,28310,28758,29080,29449,29269,202044
02888,19805,20010,19843,19551,19805,19718,19912,138644
02889,27446,27915,28312,28571,28409,28676,28217,197546
02891,21379,21415,21391,21248,21078,20997,21198,148706
02892,4651,4434,4252,4256,4200,4390,4988,31171
02893,29450,29561,29489,29416,29487,29446,29630,206479
02894,854,755,674,563,552,303,722,4423
02895,41272,41213,41136,41113,41244,41476,41186,288640
02896,11977,11908,11792,11782,11651,11771,11537,82418
02898,1324,1406,1465,1231,1362,1546,1696,10030
02903,10895,10440,10651,10613,10096,10011,10780,73486
02904,29480,29467,29145,28793,28662,29446,29359,204352
02905,26148,25635,25041,25285,25936,25685,25223,178953
02906,28412,28648,28281,28920,28039,28673,28387,199360
02907,28013,27568,27733,27448,28015,28081,27445,194303
02908,37234,38132,38141,36842,37533,38895,37467,264244
02909,43291,43243,43344,43752,43446,41014,43540,301630
02910,21024,20613,20157,20135,20715,21167,21000,144811
02911,15832,15754,16014,15811,15939,15757,15574,110681
02912,1383,1538,1729,1850,1898,2014,1370,11782
02914,21575,21971,22364,21978,22291,22154,21963,154296
02915,16892,16515,16188,16381,16210,16506,16897,115589
02916,8683,8656,8547,8700,8644,8605,8139,59974
02917,14079,14017,14080,14051,13882,13965,13762,97836
02919,29126,29122,29010,28910,28887,28832,28790,202677
02920,37463,38117,38678,38679,38276,37908,37547,266668
02921,12561,12217,12171,12207,11865,11792,12361,85174
03031,11460,11291,11282,11283,11201,11198,11247,78962
03032,5222,5141,5078,5027,4993,4958,4953,35372
03033,5148,5100,5051,5023,4979,4930,4987,35218
03034,3946,3948,3970,3961,3970,3985,3970,27750
03036,4866,4825,4802,4789,4759,4684,4782,33507
03037,4350,4314,4280,4248,4229,4200,4219,29840
03038,33491,33561,33585,33417,33495,33689,33269,234507
03042,6710,6636,6526,6460,6352,6261,6341,45286
03043,1522,1482,1573,1547,1603,1606,1573,10906
03044,4402,4319,4253,4290,4260,4232,4263,30019
03045,13777,13634,13582,13742,13614,13704,13560,95613
03046,2805,2791,2779,2774,2756,2727,2758,19390
03047,1648,1641,1477,1496,1488,1493,1767,11010
03048,3418,3411,3523,3513,3696,3656,3426,24643
03049,7759,7733,7721,7700,7679,7653,7688,53933
03051,24801,24780,24646,24541,24484,24394,24480,172126
03052,8389,8268,8267,8299,8263,8216,8258,57960
03053,24656,24237,23884,24013,23967,23909,23957,168623
03054,25580,25595,25563,25538,25540,25559,25477,178852
03055,15000,15150,15085,15067,15079,15009,15086,105476
03057,2540,2704,2597,2534,2421,2467,2500,17763
03060,29512,29886,29480,28959,28847,28182,29357,204223
03062,27331,26885,27008,27338,27476,28026,26694,190758
03063,16273,16026,16028,15936,15814,15871,16216,112164
03064,14163,14313,14283,14533,14686,14784,14227,100989
03070,5400,5342,5321,5291,5287,5228,5254,37123
03071,5167,5157,5157,5112,5100,5039,5109,35841
03076,13189,13113,13032,12960,12850,12742,12897,90783
03077,10349,10375,10339,10218,10207,10158,10155,71801
03079,28932,28853,28841,28820,28824,28893,28776,201939
03082,1680,1664,1581,1515,1411,1459,1615,10925
03084,1509,1489,1594,1605,1571,1399,1366,10533
03086,3745,3757,3825,3812,3791,3814,3728,26472
03087,14238,14104,13943,13777,13603,13378,13592,96635
03101,2809,2722,2901,2940,3055,2835,3049,20311
03102,32292,31433,31409,31806,31575,31707,31096,221318
03103,37011,37219,37301,36432,36780,36649,36476,257868
03104,31846,32832,32686,33145,32844,32309,32798,228460
03106,13954,13765,13582,13470,13382,13317,13374,94844
03109,10384,10202,10038,9711,9673,10251,10314,70573
03110,21879,21659,21449,21339,21180,20980,21203,149689
03215,186,214,260,240,318,428,247,1893
03216,2392,2318,2114,2138,2133,2021,2159,15275
03217,2159,2196,2066,1796,1653,1507,2076,13453
03218,912,1097,978,893,805,760,960,6405
03220,7371,7370,7345,7337,7360,7364,7430,51577
03221,2226,2310,2294,2014,1853,1910,2091,14698
03222,5566,5656,5572,5684,5692,5673,5353,39196
03223,3417,3366,3389,3384,3389,3385,3427,23757
03224,2203,2223,2291,2290,2419,2458,2318,16202
03225,3633,3505,3627,3700,3781,3834,3660,25740
03226,1011,1057,1012,994,1034,960,1117,7185
03227,1020,1223,1146,1039,867,1054,925,7274
03229,5601,5602,5591,5594,5608,5622,5589,39207
03230,1385,1247,1324,1371,1290,1178,1231,9026
03231,266,223,314,313,370,401,202,2089
03233,74,134,151,96,170,167,115,907
03234,4649,4666,4627,4596,4572,4555,4572,32237
03235,8522,8564,8571,8596,8615,8675,8562,60105
03237,2098,2046,2173,2155,2499,2601,2254,15826
03238,120,105,106,89,68,62,75,625
03240,1276,1192,1278,1318,1383,1325,1340,9112
03241,852,909,925,838,797,739,876,5936
03242,4891,4849,4822,4815,4839,4837,4836,33889
03243,1022,1173,1164,1200,1210,1270,1085,8124
03244,8162,8058,8035,7988,8052,8117,8092,56504
03245,2181,2050,1945,1674,1671,1600,2027,13148
03246,16238,16075,16014,16001,16067,16126,15963,112484
03249,7103,7140,7142,7136,7140,7157,7113,49931
03251,1337,1345,1309,1264,1278,1261,1662,9456
03253,6231,6284,6283,6284,6265,6260,6219,43826
03254,4072,4040,4052,4065,4078,4131,4049,28487
03255,1892,1865,1756,1968,2110,2092,2090,13773
03256,2295,2253,2266,2288,2229,2283,2169,15783
03257,4808,4712,4650,4584,4411,4367,4455,31987
03258,2580,2514,2522,2519,2532,2524,2517,17708
03259,305,336,318,303,323,318,368,2271
03260,685,789,742,805,762,748,809,5340
03261,4299,4281,4269,4253,4244,4208,4246,29800
03262,920,969,1043,1111,1180,1301,1231,7755
03263,4052,4084,4082,4101,4104,4128,4114,28665
03264,7230,7370,7453,7469,7543,7378,7468,51911
03266,2317,2280,2284,2234,2366,2277,2163,15921
03268,1223,1237,1290,1295,1155,1205,1272,8677
03269,2982,2981,2977,2966,2958,2939,2966,20769
03273,363,293,322,279,302,275,312,2146
03275,11412,11422,11424,11447,11504,11585,11437,80231
03276,8286,8350,8363,8394,8414,8410,8324,58541
03278,2879,2912,2951,2991,3029,3012,2952,20726
03279,749,768,620,650,701,679,829,4996
03280,1028,1104,1013,1074,1071,1116,1123,7529
03281,8892,8883,8849,8828,8779,8711,8785,61727
03282,787,937,896,900,916,999,902,6337
03284,953,1026,1106,1140,1115,866,999,7205
03285,2000,2104,2479,2473,2282,2512,2479,16329
03287,1419,1423,1286,1286,1318,1310,1295,9337
03290,4827,4801,4780,4747,4689,4636,4731,33211
03291,25,26,31,34,29,50,39,234
03293,84,85,94,87,77,79,143,649
03301,32291,32225,32488,32665,32814,33116,33008,228607
03303,16189,16049,15879,15665,15671,15523,15524,110500
03304,7698,7645,7611,7573,7571,7559,7519,53176
03307,5419,5352,5343,5321,5307,5281,5334,37357
03431,25715,25487,25312,25563,25388,25466,25280,178211
03440,2670,2671,2640,2639,2623,2623,2692,18558
03441,471,605,572,584,566,384,395,3577
03442,1381,1424,1367,1497,1384,1347,1491,9891
03443,773,861,787,918,917,939,742,5937
03444,1468,1569,1642,1674,1709,1665,1590,11317
03445,733,672,745,697,700,749,691,4987
03446,6039,6149,6254,6131,6248,6246,6285,43352
03447,2392,2507,2445,2567,2567,2389,2422,17289
03448,731,671,610,662,542,588,811,4615
03449,1832,1755,1805,1791,1722,1703,1654,12262
03450,951,933,911,860,923,857,961,6396
03451,3985,4011,4034,4018,4046,4081,4077,28252
03452,5337,5371,5416,5440,5462,5498,5457,37981
03455,1935,1801,1870,1922,1997,2077,2086,13688
03456,688,764,753,782,890,990,742,5609
03457,589,671,644,695,776,895,852,5122
03458,6786,6771,6707,6678,6641,6654,6643,46880
03461,5907,5907,5958,5950,6001,5991,6014,41728
03462,1727,1681,1800,1840,1787,1596,1562,11993
03464,1063,1127,1086,1053,998,1000,1109,7436
03465,2188,2352,2271,2313,2121,1974,2156,15375
03466,1096,1075,1052,888,946,1115,1332,7504
03467,1879,1877,2028,1923,2150,2045,1842,13744
03470,4914,4674,4780,4660,4758,5086,5033,33905
03561,5922,5943,5954,5941,5958,5968,5939,41625
03570,10154,9580,9710,9836,10009,10126,10051,69466
03574,2540,2551,2537,2529,2515,2502,2526,17700
03575,132,126,112,106,87,73,124,760
03576,3188,3128,3260,3277,3206,3205,3238,22502
03579,392,464,462,419,447,457,461,3102
03580,1343,1359,1421,1515,1494,1499,1369,10000
03581,3112,3110,3139,3179,3211,3263,3230,22244
03582,2464,2542,2468,2542,2715,2795,2577,18103
03583,978,933,902,864,812,865,1107,6461
03584,3699,3735,3638,3657,3618,3638,3774,25759
03585,2756,2651,2560,2593,2671,2599,2519,18349
03586,664,648,600,574,596,629,547,4258
03588,1643,1665,1655,1642,1766,1750,1641,11762
03590,837,880,965,977,1067,1175,1052,6953
03592,1116,1099,1190,1300,1334,1266,1145,8450
03593,410,371,433,459,419,460,313,2865
03595,765,820,879,838,726,578,639,5245
03597,372,374,383,375,458,505,521,2988
03598,3026,3112,3067,3119,3065,3152,3285,21826
03601,437,528,538,553,497,490,477,3520
03602,2853,2774,2689,2759,2604,2570,2654,18903
03603,5328,5315,5331,5324,5364,5486,5412,37560
03604,431,379,444,237,249,250,69,2059
03605,982,977,1089,1189,1212,1144,1160,7753
03607,438,384,335,293,250,261,322,2283
03608,2505,2299,2177,2304,2167,2227,2811,16490
03609,811,1033,1083,1179,1315,1267,854,7542
03740,757,710,689,747,761,733,911,5308
03741,4137,4177,4218,4261,4231,4213,4208,29445
03743,13734,13765,13904,13956,14036,14200,14103,97698
03745,1415,1449,1410,1462,1511,1520,1424,10191
03746,249,221,191,152,154,175,216,1358
03748,4636,4593,4584,4580,4657,4625,4762,32437
03750,905,1187,1073,1099,1048,883,870,7065
03751,479,594,584,408,485,593,583,3726
03752,707,770,821,728,767,816,810,5419
03753,2975,2966,2968,2966,2928,2914,2971,20688
03754,184,204,201,0,0,41,86,716
03755,10689,10334,10430,10311,10268,10395,10538,72965
03765,510,471,460,698,593,576,503,3811
03766,9238,9523,9345,9591,9379,9310,8958,65344
03768,1754,1716,1733,1937,1857,1950,1716,12663
03770,602,662,585,528,550,445,524,3896
03771,952,899,877,1016,882,918,754,6298
03773,7556,7557,7506,7750,7729,7833,7841,53772
03774,1953,1716,1710,1735,1726,1415,1966,12221
03777,1504,1507,1572,1454,1451,1332,1237,10057
03779,840,772,754,817,827,864,790,5664
03780,486,418,412,343,283,365,410,2717
03781,1982,1714,1933,2002,2020,2083,1840,13574
03782,3006,2950,2928,3071,3033,2944,2945,20877
03784,4116,3926,3999,3724,3859,3893,4086,27603
03785,2409,2817,2794,2569,2706,2909,2400,18604
03801,22297,22163,22166,22005,21799,21598,21532,153560
03809,3375,3702,3554,3749,3503,3566,3716,25165
03810,1996,1593,1716,1510,1737,1648,1538,11738
03811,6757,6796,6788,6775,6756,6739,6753,47364
03812,639,625,678,616,649,690,824,4721
03813,3171,3068,3471,3693,3916,3490,3250,24059
03814,2343,2373,2413,2471,2316,2234,2329,16479
03816,1259,1266,1252,1420,1352,1450,1368,9367
03817,535,484,563,656,802,786,574,4400
03818,3485,3701,3583,3628,3599,3848,3807,25651
03819,4447,4446,4423,4410,4410,4379,4377,30892
03820,30762,30560,30352,30228,30041,29907,30039,211889
03823,1832,1832,1983,2034,1997,1927,1719,13324
03824,15934,15669,15180,14949,14695,14508,14638,105573
03825,8898,8710,8593,8552,8517,8445,8512,60227
03826,2251,2385,2582,2670,2629,2660,2470,17647
03827,3189,3365,3229,3221,3155,3051,3150,22360
03830,2277,1922,1925,1708,1468,1235,1610,12145
03832,322,328,348,366,393,413,395,2565
03833,21475,21199,21139,21083,20993,20823,20955,147667
03835,6827,6825,6824,6797,6768,6726,6786,47553
03836,1324,1286,1195,1200,1197,1077,1489,8768
03837,1646,1733,1605,1616,1262,1138,1519,10519
03838,1123,885,994,981,1337,1166,1031,7517
03839,3914,3965,3955,3796,3959,3795,3735,27119
03840,3930,3895,3799,3815,3571,3533,3566,26109
03841,6424,6317,6126,6110,6272,6199,6334,43782
03842,15156,15060,14998,14788,14983,15260,15345,105590
03844,2371,2320,2312,2321,2287,2247,2238,16096
03845,1077,1324,1163,1248,869,990,991,7662
03846,1082,905,1027,1029,986,874,799,6702
03847,194,283,245,272,258,185,294,1731
03848,6094,6077,6060,6057,6047,6034,6020,42389
03849,1248,1344,1395,1306,1440,1307,1585,9625
03850,320,280,267,230,254,276,372,1999
03851,3967,3910,3937,3946,3987,3914,4040,27701
03852,624,696,655,639,579,646,558,4397
03853,542,632,737,732,907,868,602,5020
03854,935,974,980,930,990,941,968,6718
03855,2667,2653,2648,2644,2627,2614,2638,18491
03856,1526,1618,1625,1634,1671,1862,1680,11616
03857,8953,8937,8989,8968,9002,8986,9006,62841
03858,4787,4752,4717,4665,4642,4596,4603,32762
03860,4480,4294,4130,3964,3815,4111,4056,28850
03861,4388,4363,4357,4346,4334,4337,4330,30455
03862,4384,4361,4344,4328,4323,4316,4278,30334
03864,1668,1591,1543,1495,1747,1845,1696,11585
03865,7620,7601,7614,7614,7630,7667,7609,53355
03867,20866,20713,20521,19901,20066,20295,20758,143120
03868,5272,5315,5505,6185,5879,5827,5323,39306
03869,2465,2462,2466,2505,2506,2522,2469,17395
03870,5310,5306,5292,5301,5299,5282,5162,36952
03871,45,35,23,17,11,39,136,306
03872,3352,3604,3470,3545,3703,3834,3809,25317
03873,6061,5993,5926,5829,5634,5625,5711,40779
03874,8809,8836,8817,9037,8909,8876,8776,62060
03875,1349,1181,1093,1168,968,919,833,7511
03878,11821,11841,11827,11804,11816,11859,11824,82792
03882,1352,1368,1362,1377,1344,1461,1465,9729
03883,110,127,98,61,86,88,178,748
03884,3936,4036,4017,3998,3992,3944,3964,27887
03885,7214,7149,7172,7086,7238,7208,7261,50328
03886,2144,2180,2162,2059,1969,1970,2112,14596
03887,1946,2041,2004,1988,2086,2175,2154,14394
03890,262,323,345,350,278,283,327,2168
03894,6185,6238,6231,6252,6286,6302,6314,43808
03901,7507,7456,7408,7341,7291,7218,7246,51467
03902,2438,2306,2285,2049,2042,1962,2211,15293
03903,6318,6278,6234,6234,6224,6219,6211,43718
03904,7957,7963,8023,8285,8114,8054,7703,56099
03905,1657,1629,1550,1254,1424,1519,1780,10813
03906,4687,4660,4643,4596,4588,4568,4647,32389
03907,1205,1337,1141,1143,1183,1174,894,8077
03908,7332,7312,7276,7247,7230,7219,7233,50849
03909,9834,9870,9792,10094,10369,10342,9738,70039
03910,425,437,475,357,113,136,328,2271
03911,64,104,109,117,101,222,250,967
04001,2551,2520,2495,2470,2445,2237,2429,17147
04002,7422,7429,7407,7390,7362,7335,7351,51696
04003,315,468,468,527,674,656,330,3438
04005,23127,23093,23153,23336,23516,23525,23146,162896
04006,146,169,139,63,34,30,96,677
04008,2849,2810,2866,2761,2754,2716,2723,19479
04009,5300,5272,5227,5227,5212,5179,5151,36568
04010,1388,1283,1261,1336,1317,1358,1597,9540
04011,20497,20378,20329,20319,20376,20457,20278,142634
04015,3927,3885,3862,3809,3825,3707,3808,26823
04017,412,470,431,401,285,263,341,2603
04019,0,0,0,0,69,72,71,212
04020,1312,1314,1383,1488,1482,1546,1403,9928
04021,6232,6009,5977,5982,5847,5933,5820,41800
04022,1054,1178,1210,1049,1013,1053,1148,7705
04024,612,610,601,594,596,622,608,4243
04027,6118,6094,6077,6049,6024,5984,6031,42377
04029,1547,1651,1603,1559,1605,1609,1725,11299
04030,2666,2774,2626,2306,2053,2100,2208,16733
04032,8242,8127,8049,7971,7946,7899,7879,56113
04037,3793,3773,3826,3843,3838,3877,3834,26784
04038,17015,16834,16677,16540,16395,16217,16381,116059
04039,7630,7658,7539,7417,7287,7107,7422,52060
04040,3166,3173,3127,3068,3064,3040,3111,21749
04041,1836,1787,1711,1694,1808,1704,1613,12153
04042,4416,4377,4343,4316,4299,4290,4281,30322
04043,11161,11051,10972,10912,10869,10844,10810,76619
04046,7704,7662,7610,7575,7554,7526,7496,53127
04047,1846,1622,1658,1616,1494,1649,1892,11777
04048,2937,2944,3000,2959,2937,2930,2946,20653
04049,3717,3706,3639,3654,3649,3607,3659,25631
04050,207,229,239,238,310,329,230,1782
04051,1198,1063,1175,1088,1054,1052,1153,7783
04055,3828,3823,3788,3786,3761,3806,3793,26585
04056,346,345,250,195,167,128,257,1688
04057,47,48,41,23,17,9,56,241
04061,2938,2615,3259,3465,3707,3429,3369,22782
04062,17842,17459,17300,17164,17026,16851,17020,120662
04063,450,438,315,340,278,259,412,2492
04064,8277,8259,8364,8319,8392,8452,8212,58275
04066,618,556,463,377,393,344,539,3290
04068,1615,1728,1774,1694,1692,1591,1505,11599
04069,1714,1568,1492,1471,1439,1427,1465,10576
04071,4960,4844,4895,4989,5025,5168,4801,34682
04072,19008,18874,18757,18647,18561,18455,18482,130784
04073,16354,16468,16327,16085,16348,16294,16189,114065
04074,19459,19222,19096,18963,18809,18685,18760,132994
04076,2675,2681,2678,2680,2672,2659,2683,18728
04079,3909,3791,3849,3874,3721,3814,3871,26829
04083,4489,4349,4485,4751,4537,4648,4525,31784
04084,8099,8145,7880,7953,8359,8339,8088,56863
04085,1972,1859,2062,1948,1523,1513,1786,12663
04086,8731,8734,8728,8750,8819,8869,8787,61418
04087,2169,2367,1862,1934,1901,2067,2116,14416
04088,1301,1458,1537,1705,1964,2141,1516,11622
04090,9974,9869,9783,9697,9662,9643,9589,68217
04091,891,808,910,996,989,904,911,6409
04092,17969,17754,17662,17578,17501,17410,17515,123389
04093,8124,8106,8079,8056,8052,8035,8034,56486
04095,1185,1204,1337,1200,1187,1252,1274,8639
04096,8502,8467,8433,8402,8390,8383,8349,58926
04097,3723,3676,3646,3598,3578,3555,3574,25350
04101,17031,17073,16956,17339,17844,17646,17227,121116
04102,17833,17781,18118,17540,16610,16629,17335,121846
04103,30729,30591,30211,30354,30639,30857,30606,213987
04105,11556,11587,11424,11260,11191,11100,11158,79276
04106,25633,25565,25377,25257,25194,25048,25175,177249
04107,9117,9022,8983,8993,8990,9021,8980,63106
04108,952,927,913,900,1000,919,862,6473
04109,104,118,119,94,73,117,93,718
04110,1339,1445,1361,1297,1389,1259,1391,9481
04210,22943,22916,22960,23040,23104,23180,23045,161188
04216,380,350,360,439,487,515,640,3171
04217,2826,2859,2921,2928,3112,3096,3312,21054
04219,1601,1725,1477,1509,1511,1436,1472,10731
04220,3030,3170,3232,3101,2923,2744,3077,21277
04221,925,959,1169,1019,1176,1183,1098,7529
04222,3918,3902,3879,3867,3853,3821,3848,27088
04224,2828,2831,2954,3148,3061,2977,3040,20839
04226,211,207,159,154,157,146,190,1224
04227,32,62,57,39,48,38,79,355
04228,86,56,80,75,26,19,6,348
04231,313,318,291,263,195,171,236,1787
04234,186,147,131,229,242,105,168,1208
04236,4353,4349,4349,4346,4348,4344,4350,30439
04237,185,172,155,141,135,154,238,1180
04238,1641,1564,1643,1557,1334,1409,1416,10564
04239,4720,4812,4827,4840,4859,4883,4851,33792
04240,36277,36356,36410,36536,36588,36629,36592,255388
04250,4201,4163,4146,4150,4111,4055,4228,29054
04252,4672,4732,4790,4807,4912,5010,4799,33722
04253,2109,2028,2055,2092,2145,2162,2095,14686
04254,3040,3093,3082,3095,3161,3181,3181,21833
04255,676,728,910,877,915,970,802,5878
04256,2967,2990,2980,3024,3038,3060,3064,21123
04257,2614,2635,2648,2667,2701,2727,2681,18673
04258,2588,2585,2610,2603,2601,2583,2617,18187
04259,3112,2971,3111,3132,3299,3129,3264,22018
04260,5653,5619,5590,5556,5533,5489,5542,38982
04261,371,422,393,438,369,450,444,2887
04263,2108,2030,2010,2088,1972,2066,2326,14600
04265,1023,1151,993,996,829,990,918,6900
04267,51,84,59,61,84,56,37,432
04268,4964,4969,4984,4999,5023,5019,5023,34981
04270,6795,6438,6210,6162,5929,5890,5880,43304
04271,0,0,0,0,0,0,67,67
04274,5528,5492,5455,5398,5368,5346,5343,37930
04275,398,427,426,465,389,441,514,3060
04276,5749,5729,5770,5818,5873,5955,5841,40735
04280,6842,6976,6927,6784,6827,6645,6474,47475
04281,5134,5135,5141,5162,5174,5177,5116,36039
04282,5744,5725,5737,5729,5712,5684,5734,40065
04284,1040,1081,1022,1004,1002,976,1138,7263
04285,421,443,490,463,414,408,433,3072
04286,144,143,144,149,103,100,47,830
04287,3159,3167,3093,3185,3203,3216,3224,22247
04289,2112,1974,1808,1881,1972,2062,1815,13624
04290,1232,1305,1339,1407,1545,1553,1541,9922
04292,1157,1172,1103,1130,1059,874,948,7443
04294,4031,4059,4155,4075,4049,4094,3995,28458
04330,25666,25737,25827,26034,26092,26080,26086,181522
04342,1821,1838,1740,1641,1759,1872,1672,12343
04343,42,44,96,79,82,72,25,440
04344,2873,2805,2813,2831,2921,2871,2951,20065
04345,11242,11451,11455,11565,11663,11628,11646,80650
04346,1814,1792,1837,1772,1726,2061,1772,12774
04347,2385,2471,2439,2380,2538,2570,2355,17138
04348,3069,3065,2968,3084,3059,2977,2976,21198
04349,1083,1140,1158,1125,1224,1158,1158,8046
04350,3601,3589,3602,3607,3596,3574,3577,25146
04351,2539,2557,2567,2571,2573,2582,2571,17960
04352,1649,1633,1656,1617,1548,1429,1632,11164
04353,2239,2375,2336,2368,2357,2411,2300,16386
04354,1567,1572,1534,1592,1533,1517,1535,10850
04355,2547,2556,2567,2578,2581,2584,2600,18013
04357,3354,3351,3391,3393,3413,3426,3399,23727
04358,4228,4251,4248,4236,4261,4221,4276,29721
04359,566,506,530,455,356,396,388,3197
04360,482,517,549,622,560,625,560,3915
04363,2552,2568,2576,2567,2564,2546,2575,17948
04364,5940,5941,5950,5988,6025,6059,6025,41928
04401,44754,45011,44972,45024,45087,44907,44899,314654
04406,658,698,717,641,692,659,819,4884
04408,192,206,195,175,156,139,176,1239
04410,1241,1144,1114,1138,1158,1057,1290,8142
04411,1587,1471,1420,1460,1553,1359,1492,10342
04412,9284,9341,9391,9428,9452,9457,9482,65835
04413,219,194,161,168,164,186,196,1288
04414,1150,1074,1085,1352,1442,1433,1248,8784
04415,278,270,232,232,226,138,276,1652
04416,5425,5477,5507,5494,5493,5497,5468,38361
04417,267,271,258,297,366,392,370,2221
04418,1628,1643,1643,1632,1519,1566,1771,11402
04419,2785,2791,2794,2792,2775,2759,2794,19490
04421,1309,1345,1425,1503,1673,1693,1366,10314
04422,1397,1280,1275,1424,1494,1534,1409,9813
04424,728,649,740,797,801,909,823,5447
04426,4559,4553,4548,4583,4600,4689,4720,32252
04427,2826,2785,2810,2799,2807,2801,2858,19686
04428,2964,3320,3300,3306,3296,3106,3146,22438
04429,4744,4627,4596,4833,4890,4847,4717,33254
04430,1843,1912,1830,1718,1839,1917,1728,12787
04431,44,42,41,38,91,66,81,403
04434,1195,1309,1299,1274,1352,1290,1246,8965
04435,1118,1001,1012,993,1053,1120,1092,7389
04438,1049,1097,1202,1275,1346,1303,1124,8396
04441,1981,2144,2117,2104,2020,2008,1840,14214
04442,7,41,56,64,63,71,93,395
04443,2403,2470,2406,2350,2422,2574,2537,17162
04444,8880,8812,8800,8759,8699,8767,8824,61541
04448,1540,1624,1539,1514,1462,1342,1431,10452
04449,1601,1580,1434,1435,1338,1345,1489,10222
04450,1065,1122,1329,1111,1198,1162,1368,8355
04451,216,181,165,199,251,261,259,1532
04453,784,680,751,777,800,725,779,5296
04454,12,30,40,57,86,73,69,367
04455,922,961,1268,1262,1231,1182,923,7749
04456,2950,2931,2902,2864,2835,2793,2851,20126
04457,5840,5824,5859,5804,5738,5852,5948,40865
04459,880,847,828,1008,990,1167,773,6493
04460,1145,1214,1238,1373,1413,1395,1419,9197
04461,3012,3043,3054,3054,3056,3069,3070,21358
04462,4718,4770,4778,4831,4835,4965,4835,33732
04463,2986,2848,2805,2631,2700,2631,2847,19448
04464,621,632,648,675,622,648,684,4530
04468,9210,9380,9410,9544,9626,9540,9521,66231
04469,2640,2660,2666,2651,2637,2642,2702,18598
04471,635,655,608,507,485,497,609,3996
04472,2197,2122,2085,2108,2040,1979,2144,14675
04473,8171,7957,7849,7801,7741,7596,7660,54775
04474,3689,3714,3721,3736,3737,3722,3733,26052
04475,482,446,463,434,493,515,418,3251
04476,1237,1272,1153,1144,1086,1057,1259,8208
04478,318,312,296,363,333,316,316,2254
04479,1372,1322,1428,1416,1460,1421,1343,9762
04481,493,489,568,618,492,542,559,3761
04485,198,255,291,319,320,326,233,1942
04487,953,920,935,860,835,813,964,6280
04488,1395,1220,1237,1320,1239,1249,1202,8862
04489,349,326,351,282,213,207,197,1925
04490,248,260,242,252,220,264,273,1759
04491,141,125,111,94,120,129,140,860
04492,167,189,174,179,169,136,166,1180
04493,1836,1923,2050,1948,1927,1877,1967,13528
04495,538,568,508,420,364,389,407,3194
04496,3824,3787,3771,3770,3766,3761,3757,26436
04497,328,390,410,435,407,396,389,2755
04530,10888,10854,10937,10889,10968,11028,10818,76382
04535,740,663,650,663,616,576,709,4617
04537,1962,2020,2145,2090,2058,2020,2073,14368
04538,1934,1792,1957,1973,2041,2147,2080,13924
04539,1093,1145,1165,1209,1054,1255,1168,8089
04541,133,132,152,157,138,62,80,854
04543,1866,2046,2001,2050,2170,2241,2218,14592
04544,639,690,597,590,706,700,724,4646
04547,1112,1046,1057,1114,1199,1135,1152,7815
04548,1018,1114,1050,998,935,826,1042,6983
04551,863,934,894,868,784,824,806,5973
04553,1674,1804,1775,1847,1814,1728,1752,12394
04554,916,908,745,718,727,645,710,5369
04555,1719,1557,1702,1656,1699,1551,1643,11527
04556,1144,1102,1154,1141,1082,1088,1249,7960
04558,195,252,243,298,305,291,308,1892
04562,2029,1961,1983,2153,2228,2392,2216,14962
04563,1391,1481,1415,1423,1343,1291,1534,9878
04564,400,291,433,369,524,510,489,3016
04568,454,469,459,481,531,528,391,3313
04570,0,0,0,0,0,0,2,2
04571,511,385,360,431,352,404,323,2766
04572,5030,5013,5035,5042,5062,5082,5075,35339
04573,541,479,493,487,433,448,501,3382
04574,1515,1420,1447,1546,1468,1483,1510,10389
04575,42,63,54,57,109,134,85,544
04576,593,630,622,598,539,509,604,4095
04578,4547,4469,4518,4434,4487,4539,4450,31444
04579,3069,3064,3054,3065,3074,3073,3072,21471
04605,13555,13160,13064,13138,12651,12564,12974,91106
04606,1200,1094,1170,1175,1252,1164,1272,8327
04607,1299,1344,1218,1170,1115,1049,1182,8377
04609,5329,5296,5269,5255,5062,5038,5222,36471
04611,405,413,485,416,453,507,508,3187
04612,439,450,588,639,674,688,589,4067
04613,96,141,184,182,187,175,183,1148
04614,2549,2459,2440,2430,2527,2552,2579,17536
04616,839,794,858,870,981,967,824,6133
04617,781,779,812,864,904,921,811,5872
04619,3018,3038,3063,3091,3132,3167,3121,21630
04622,1338,1447,1414,1480,1391,1322,1412,9804
04623,1048,1092,1398,1335,1271,1019,1054,8217
04624,166,120,124,147,201,170,184,1112
04625,43,49,36,17,19,52,47,263
04626,432,493,468,498,560,603,507,3561
04627,1597,1581,1642,1581,1478,1738,1636,11253
04628,701,714,645,682,705,677,703,4827
04629,114,217,240,249,154,109,107,1190
04630,1544,1413,1381,1313,1267,1310,1398,9626
04631,1390,1365,1414,1421,1458,1406,1331,9785
04634,1830,1840,1850,1938,1873,2031,1923,13285
04635,43,42,79,80,73,57,61,435
04637,141,126,146,123,142,153,136,967
04640,2160,2232,2092,2066,1973,2036,2261,14820
04642,85,84,73,52,79,81,123,577
04643,967,1004,1022,970,1060,1079,1018,7120
04644,0,0,0,0,168,176,13,357
04645,59,63,61,68,93,78,73,495
04646,82,84,87,86,79,59,94,571
04648,516,458,495,447,511,584,580,3591
04649,1241,1269,1239,1301,1308,1362,1370,9090
04650,214,143,151,162,187,222,235,1314
04652,1816,1828,1943,1974,1815,1765,1690,12831
04653,415,474,484,439,439,505,490,3246
04654,3278,3278,3280,3329,3422,3484,3424,23495
04655,1103,1178,1185,1121,1161,1180,1119,8047
04657,291,304,289,335,337,353,363,2272
04658,1569,1455,1409,1305,1373,1325,1353,9789
04660,1154,1288,1268,1326,1349,1179,1309,8873
04662,538,650,529,420,442,393,488,3460
04664,998,1090,1083,1112,1210,1271,1238,8002
04666,1135,1134,1160,1230,1215,1281,1172,8327
04667,1520,1603,1612,1635,1546,1504,1638,11058
04668,1565,1697,1650,1695,1727,1734,1680,11748
04669,238,192,152,130,167,174,204,1257
04671,517,509,533,524,579,609,576,3847
04673,164,174,106,113,150,166,112,985
04674,439,636,692,630,662,585,484,4128
04675,219,401,377,373,295,347,253,2265
04676,1048,1055,1031,956,1076,983,1088,7237
04677,325,265,285,234,206,243,274,1832
04679,1886,1848,1976,1839,1848,1865,1767,13029
04680,1124,1070,1017,1098,1031,1043,1131,7514
04681,1138,1262,1312,1276,1192,1169,1043,8392
04683,84,86,60,62,61,58,104,515
04684,1605,1502,1666,1638,1736,1634,1466,11247
04685,434,392,302,311,386,413,332,2570
04686,93,88,77,93,90,78,114,633
04691,346,372,462,473,493,497,441,3084
04693,483,482,475,501,450,473,516,3380
04694,2246,2150,2205,2247,2207,2116,2376,15547
04730,9852,9823,9992,10003,10210,10048,9992,69920
04732,1817,1807,1823,1746,1804,1724,1670,12391
04733,265,303,314,261,259,165,221,1788
04734,793,891,863,812,751,753,800,5663
04735,559,587,618,623,622,759,617,4385
04736,9466,9547,9672,9718,9813,9850,9876,67942
04739,881,934,947,904,937,963,1112,6678
04740,1172,1156,1198,1286,1249,1204,1287,8552
04741,0,0,0,0,0,0,3,3
04742,3392,3420,3447,3463,3478,3505,3496,24201
04743,4625,4628,4650,4580,4608,4638,4676,32405
04745,938,889,1024,1038,1057,1104,1082,7132
04746,480,495,488,483,481,479,470,3376
04747,1406,1387,1456,1538,1534,1495,1337,10153
04750,2232,2353,2315,2536,2508,2661,2603,17208
04756,3287,3258,3346,3523,3563,3653,3344,23974
04757,2880,2827,2843,2749,2775,2796,2870,19740
04758,1432,1532,1487,1510,1617,1613,1498,10689
04760,694,750,665,704,725,678,795,5011
04761,488,478,451,447,441,563,529,3397
04762,610,639,625,591,576,543,602,4186
04763,808,716,677,676,748,675,726,5026
04764,48,48,48,50,41,46,66,347
04765,1208,1188,1264,1361,1407,1354,1262,9044
04766,396,401,454,417,366,395,386,2815
04768,373,445,450,427,384,397,400,2876
04769,9298,9378,9494,9568,9638,9677,9692,66745
04772,767,699,653,741,771,798,762,5191
04773,626,694,650,503,505,459,723,4160
04774,553,602,618,703,664,629,730,4499
04776,1016,898,902,880,844,858,925,6323
04777,404,420,419,451,420,467,422,3003
04779,263,251,284,307,297,415,398,2215
04780,793,817,734,826,856,793,808,5627
04781,568,509,487,507,509,567,560,3707
04783,459,470,380,340,326,384,426,2785
04785,2306,2538,2775,2883,2994,3190,2504,19190
04786,1958,1863,1869,1950,1980,1959,1970,13549
04787,648,638,680,656,621,482,544,4269
04841,7220,7233,7241,7273,7314,7372,7297,50950
04843,4835,4844,4839,4855,4883,4932,4851,34039
04847,1653,1656,1651,1560,1635,1596,1536,11287
04848,813,780,643,598,626,597,566,4623
04849,3701,3798,3761,3805,3621,3422,3684,25792
04851,53,61,47,42,41,65,75,384
04852,40,34,39,45,34,37,69,298
04853,471,435,410,392,456,468,354,2986
04854,1622,1645,1669,1663,1667,1570,1580,11416
04855,343,322,341,316,355,208,307,2192
04856,3352,3343,3338,3326,3344,3382,3330,23415
04858,1363,1428,1477,1441,1390,1555,1533,10187
04859,661,597,424,323,476,642,724,3847
04860,1622,1709,1850,1989,1788,1797,1591,12346
04861,2781,2768,2768,2781,2820,2854,2781,19553
04862,3810,3730,3576,3665,3732,3735,3592,25840
04863,1155,1222,1327,1199,1126,1117,1165,8311
04864,4699,4720,4715,4718,4718,4692,4751,33013
04901,26441,26339,26291,26254,26281,26294,26248,184148
04910,1945,1782,1825,1973,1926,1879,2041,13371
04911,2100,2086,2067,2092,1988,2028,2136,14497
04912,1018,1092,1066,1112,1131,1170,1048,7637
04915,8818,8690,8791,8807,8780,8934,8806,61626
04917,2826,2937,2914,2896,2908,2894,2849,20224
04918,322,220,257,286,270,288,349,1992
04920,1653,1639,1796,1727,1730,1698,1713,11956
04921,1529,1528,1543,1441,1546,1617,1593,10797
04922,1131,1213,1166,1203,1118,1296,1164,8291
04923,465,496,523,517,554,557,482,3594
04924,2277,2277,2199,2138,2169,2218,2275,15553
04925,140,133,107,82,81,63,75,681
04926,44,36,48,78,69,90,52,417
04927,3369,3389,3426,3453,3470,3485,3486,24078
04928,1944,2114,1954,2060,2138,2311,2198,14719
04929,934,863,935,829,863,753,837,6014
04930,4213,4254,4227,4330,4433,4458,4295,30210
04932,1333,1188,1203,1204,1185,1101,1181,8395
04933,103,68,78,65,70,0,65,449
04936,197,143,146,223,251,278,261,1499
04937,6468,6421,6464,6502,6527,6703,6645,45730
04938,9524,9695,9718,9658,9831,9910,9869,68205
04939,1249,1251,1227,1183,985,1065,1105,8065
04940,0,0,31,28,39,46,118,262
04941,1478,1446,1468,1498,1657,1699,1751,10997
04942,1299,1206,1143,1176,1178,1173,1326,8501
04943,1684,1687,1840,1798,1688,1920,1792,12409
04944,51,66,60,56,30,30,42,335
04945,949,997,1071,1122,1184,1209,1242,7774
04947,1514,1598,1656,1779,1799,1616,1852,11814
04949,825,825,721,763,747,787,913,5581
04950,4746,4748,4791,4804,4818,4830,4855,33592
04951,922,941,931,938,950,1007,906,6595
04952,1941,1833,1915,1881,1869,1926,1829,13194
04953,3154,3188,3185,3203,3205,3276,3228,22439
04955,1498,1471,1332,1379,1399,1497,1362,9938
04956,798,733,654,631,676,734,760,4986
04957,4186,4246,4265,4190,4161,4194,4265,29507
04958,2021,2034,2045,1837,1933,1894,1954,13718
04961,914,932,954,951,964,933,972,6620
04962,218,192,276,155,119,154,125,1239
04963,7302,7341,7372,7279,7224,7128,7238,50884
04964,111,152,172,157,158,189,221,1160
04965,2057,2126,2066,2128,2099,2145,1976,14597
04966,1754,1807,1758,1861,1864,1940,1682,12666
04967,4150,4149,4196,4213,4235,4256,4230,29429
04969,1288,1387,1293,1139,1155,1231,1362,8855
04970,1590,1552,1655,1602,1608,1536,1620,11163
04971,2077,2157,1960,2040,1922,1873,2005,14034
04973,1652,1707,1637,1645,1529,1472,1389,11031
04974,2632,2639,2639,2630,2634,2641,2611,18426
04975,132,137,131,121,151,0,48,720
04976,9722,9777,9769,9874,9993,10104,9903,69142
04978,784,760,775,868,936,744,799,5666
04979,962,1001,1053,1128,1105,1087,1064,7400
04981,2255,2233,2123,2105,2293,2146,2316,15471
04982,352,450,518,493,629,594,630,3666
04983,1795,1709,1643,1651,1605,1731,1752,11886
04984,628,646,599,613,568,619,523,4196
04985,65,67,75,66,72,65,114,524
04986,1616,1564,1636,1645,1667,1674,1721,11523
04987,1011,860,924,897,848,866,1030,6436
04988,2351,2496,2540,2373,2311,2145,2134,16350
04989,4095,4119,4061,4177,4235,4172,4215,29074
04992,449,296,346,324,156,67,103,1741
05001,9120,9019,9241,9376,9301,9368,9123,64548
05031,141,166,128,109,130,97,218,989
05032,2540,2380,2600,2935,3068,3086,2664,19273
05033,2731,2786,2729,2729,2742,2680,2744,19141
05034,358,317,250,213,184,191,310,1823
05035,616,644,524,496,512,481,638,3911
05036,1137,1026,1048,959,906,901,1037,7014
05037,391,476,514,628,561,533,560,3663
05038,1271,1330,1427,1351,1412,1378,1230,9399
05039,1047,1000,996,965,917,846,1110,6881
05040,561,517,573,565,505,522,471,3714
05041,460,470,383,531,720,725,354,3643
05042,527,487,475,511,622,625,605,3852
05043,802,695,714,859,888,939,937,5834
05045,1934,1985,2009,1905,2065,2067,1758,13723
05046,1155,1159,1118,1182,1088,1012,1139,7853
05048,2786,2644,2372,2453,2644,2557,2429,17885
05050,148,124,142,128,202,185,146,1075
05051,1620,1556,1512,1662,1629,1714,1549,11242
05052,138,226,202,216,187,201,348,1518
05053,420,409,417,331,378,435,332,2722
05055,3287,3342,3374,3396,3423,3433,3363,23618
05056,412,378,401,440,445,472,567,3115
05058,280,285,282,289,249,266,346,1997
05059,619,777,719,609,773,658,874,5029
05060,4258,4437,4602,4486,4223,4355,4415,30776
05061,1650,1549,1478,1376,1416,1371,1679,10519
05062,726,781,755,628,671,715,702,4978
05065,1072,1090,1044,1217,1173,1197,1064,7857
05067,258,259,267,261,244,214,258,1761
05068,3186,3131,3097,3135,3093,3154,3125,21921
05069,534,599,617,546,541,589,555,3981
05070,509,431,443,445,512,533,484,3357
05071,113,174,182,262,455,452,324,1962
05072,580,587,531,571,520,527,526,3842
05075,1164,1272,1187,1139,1072,1049,1113,7996
05076,342,387,381,435,515,545,412,3017
05077,1106,1136,1130,1115,1151,1136,1215,7989
05079,737,715,686,705,673,590,730,4836
05081,498,519,553,548,497,487,550,3652
05083,232,214,132,121,114,103,151,1067
05084,200,207,169,44,17,55,140,832
05086,668,766,763,748,819,776,793,5333
05089,4907,4954,5072,4974,4953,5026,4979,34865
05091,3369,3282,3454,3418,3257,3270,3288,23338
05101,4380,4408,4457,4553,4666,4942,4643,32049
05141,103,98,77,85,61,61,112,597
05142,723,672,745,840,797,777,680,5234
05143,4471,4518,4360,4187,4186,4140,4343,30205
05146,717,757,761,651,663,658,750,4957
05148,833,984,1092,1080,1125,1145,1140,7399
05149,2142,2246,2197,2028,2145,2243,2092,15093
05150,858,839,855,897,864,929,831,6073
05151,1336,1372,1216,1126,1332,1407,1553,9342
05152,362,382,409,457,457,450,448,2965
05153,734,832,842,803,706,653,687,5257
05154,527,600,667,764,757,643,661,4619
05155,773,790,662,557,605,609,828,4824
05156,9201,9283,9425,9529,9324,9275,9226,65263
05158,1130,1042,940,1186,1331,1348,1049,8026
05161,584,562,586,562,588,546,552,3980
05201,14429,14407,14445,14360,14524,14742,14851,101758
05250,3665,3674,3540,3557,3497,3534,3408,24875
05251,1306,1399,1395,1392,1439,1556,1350,9837
05252,262,245,264,286,248,290,274,1869
05253,749,778,727,668,596,414,685,4617
05254,282,336,322,305,420,396,273,2334
05255,4049,4003,4030,4051,3944,3990,4121,28188
05257,2649,2649,2633,2697,2796,2798,2718,18940
05260,434,323,325,458,279,416,459,2694
05261,2811,2927,3028,2835,2911,2705,2738,19955
05262,2475,2545,2528,2676,2663,2554,2547,17988
05301,16470,16752,16861,16819,16793,16692,16820,117207
05340,612,537,654,686,659,560,763,4471
05341,421,410,410,478,471,458,407,3055
05342,632,600,488,479,537,548,581,3865
05343,785,852,834,837,774,854,917,5853
05345,2383,2332,2246,2236,2256,2209,2119,15781
05346,5003,5124,5206,5002,4783,4784,5184,35086
05350,787,763,777,726,799,814,763,5429
05352,830,878,878,887,819,825,824,5941
05353,843,889,988,944,973,1061,1072,6770
05354,2140,2055,2027,2044,2138,2248,2210,14862
05355,734,608,610,617,599,669,813,4650
05356,969,927,925,862,893,900,717,6193
05358,194,201,158,206,225,214,148,1346
05359,526,469,534,538,569,597,594,3827
05360,252,239,212,240,238,231,251,1663
05361,1038,885,918,957,946,963,947,6654
05362,82,114,131,130,132,106,127,822
05363,2139,2212,2387,2715,2518,2334,2021,16326
05401,28849,28740,28257,27908,27970,27979,28185,197888
05403,18440,18279,18199,17998,17751,17317,17593,125577
05404,7209,7082,7116,7071,7035,7100,7240,49853
05405,4352,4333,4320,4259,4136,3968,4406,29774
05408,9592,9724,9921,10309,10302,10525,10114,70487
05439,1709,1644,1662,1697,1649,1595,1734,11690
05440,1616,1713,1623,1763,1785,1870,1998,12368
05441,940,1004,1133,1134,1076,1079,958,7324
05442,395,336,357,315,327,341,339,2410
05443,6758,6701,6611,6467,6503,6614,6656,46310
05444,1434,1505,1525,1637,1790,1756,1714,11361
05445,3844,3822,3810,3776,3756,3739,3754,26501
05446,15635,15810,15789,15736,15743,15654,15373,109740
05447,109,75,76,115,94,89,79,637
05448,966,944,1056,1129,1090,1167,1134,7486
05450,5195,5101,4916,4874,4808,4645,4977,34516
05452,20866,20591,20315,20010,19810,19623,19710,140925
05454,4823,4677,4676,4754,4845,4680,4447,32902
05455,1135,1066,1012,1133,1143,1058,1080,7627
05456,1342,1364,1305,1349,1467,1415,1277,9519
05457,1405,1448,1400,1334,1433,1652,1617,10289
05458,2288,2175,2228,2293,2221,2062,2044,15311
05459,2218,2331,2072,2450,2269,2390,2156,15886
05461,4610,4603,4565,4525,4505,4504,4542,31854
05462,1928,1875,1924,1965,1935,1957,1938,13522
05463,591,577,577,500,510,512,471,3738
05464,3384,3283,3093,2826,2747,2764,3008,21105
05465,5446,5401,5392,5349,5279,5295,5355,37517
05468,13307,13180,13249,13156,13065,12958,12942,91857
05471,878,876,813,745,658,641,896,5507
05472,1634,1596,1584,1577,1623,1594,1643,11251
05473,1440,1413,1451,1501,1474,1375,1413,10067
05474,876,909,939,896,871,863,803,6157
05476,3047,3203,3387,3388,3401,3433,3183,23042
05477,4505,4461,4492,4509,4486,4473,4397,31323
05478,14942,14798,14018,13868,13870,14025,14449,99970
05481,0,0,0,0,0,0,0,0
05482,7680,7628,7515,7387,7315,7195,7198,51918
05483,1464,1511,1514,1481,1455,1354,1303,10082
05485,92,40,42,16,62,57,93,402
05486,1574,1578,1612,1532,1645,1749,1654,11344
05487,1469,1488,1520,1537,1539,1589,1498,10640
05488,7718,7684,8372,7990,8003,7743,7690,55200
05489,3182,3190,3148,3129,3102,3080,3174,22005
05491,5799,5947,5980,5917,5854,5791,5909,41197
05492,713,687,731,727,795,805,682,5140
05494,1728,1741,1662,1702,1853,1863,1767,12316
05495,9918,9786,9664,9513,9351,9190,9341,66763
05602,11777,11869,11830,11711,11767,11532,11916,82402
05640,139,209,226,256,268,236,161,1495
05641,16739,17129,17147,17298,17622,17396,17169,120500
05647,1151,1169,1166,1096,1189,1087,1141,7999
05648,367,331,352,384,425,444,423,2726
05649,647,716,877,971,845,817,574,5447
05650,1156,1235,1143,1080,1048,1091,1123,7876
05651,1481,1587,1633,1609,1655,1698,1546,11209
05652,872,907,875,896,854,749,776,5929
05653,455,485,478,486,438,423,547,3312
05654,778,654,633,631,577,850,970,5093
05655,2979,2987,2906,2912,2880,2869,2868,20401
05656,3581,3578,3637,3593,3512,3476,3508,24885
05657,78,70,51,47,41,30,56,373
05658,1351,1379,1394,1505,1557,1796,1402,10384
05660,1817,1666,1766,1673,1607,1583,1660,11772
05661,5796,5773,5743,5716,5653,5595,5620,39896
05663,6754,6754,6987,6968,6771,6844,6773,47851
05664,166,140,0,0,0,0,80,386
05667,2216,2108,2198,2343,2287,2301,2166,15619
05669,660,680,609,644,537,392,634,4156
05672,4392,4407,4371,4345,4319,4298,4314,30446
05673,2497,2451,2365,2441,2443,2520,2574,17291
05674,1699,1615,1651,1548,1494,1464,1705,11176
05675,1178,1100,1073,1066,987,1076,1064,7544
05676,4790,5080,5053,4999,5091,5272,4984,35269
05677,2374,2184,2165,2157,2060,1914,2232,15086
05678,189,117,131,80,99,157,163,936
05679,3444,3375,3397,3350,3367,3294,3296,23523
05680,2146,2126,2127,2078,2074,2119,2168,14838
05681,415,372,398,325,402,344,458,2714
05682,1081,1086,1082,1229,1270,1312,1251,8311
05701,20160,20224,20112,20361,20404,20484,20802,142547
05730,272,261,245,282,240,206,302,1808
05732,1042,929,924,809,802,706,708,5920
05733,5802,5792,5814,5799,5894,6045,5895,41041
05734,1320,1271,1265,1227,1322,1378,1306,9089
05735,3980,4136,4113,4106,4049,4191,4402,28977
05736,658,734,898,788,892,1042,684,5696
05737,756,747,782,770,814,769,875,5513
05738,1163,1107,1187,1165,1136,1031,1072,7861
05739,1546,1499,1446,1510,1508,1464,1407,10380
05740,0,0,0,0,0,19,25,44
05742,574,548,623,643,693,797,597,4475
05743,4108,4128,4247,4291,4314,4383,4330,29801
05744,668,534,499,683,568,501,533,3986
05747,280,275,291,319,304,318,280,2067
05748,332,365,395,370,403,421,323,2609
05751,789,920,896,850,798,794,811,5858
05753,10443,10459,10459,10545,10484,10519,10491,73400
05757,855,812,787,826,770,742,832,5624
05758,725,813,857,842,736,744,784,5501
05759,1796,1766,1741,1671,1617,1811,1827,12229
05760,1318,1241,1114,1037,1037,1028,1123,7898
05761,994,1015,1016,1087,1108,1185,1000,7405
05762,513,589,617,626,580,534,542,4001
05763,2715,2888,2884,2718,2651,2525,2747,19128
05764,3370,3370,3382,3442,3448,3503,3452,23967
05765,1632,1641,1703,1789,1788,1846,1803,12202
05766,598,606,635,588,544,513,572,4056
05767,1053,1052,1095,1000,959,964,1143,7266
05769,1192,1167,1209,1160,1230,1181,1216,8355
05770,1038,1058,1085,1181,1059,1099,1136,7656
05772,656,632,722,652,640,547,713,4562
05773,2281,2195,2164,2123,2215,2290,2136,15404
05774,1012,1071,1165,1220,1449,1233,1129,8279
05775,495,540,602,606,633,658,623,4157
05776,630,595,620,640,729,806,714,4734
05777,3357,3424,3357,3457,3666,3650,3420,24331
05778,721,727,690,770,728,705,733,5074
05819,9655,9725,9725,9754,9639,9518,9444,67460
05820,544,632,692,624,651,653,662,4458
05821,1081,1102,1078,1154,1252,1375,1269,8311
05822,1615,1752,1739,1715,1750,1826,1873,12270
05824,1190,1071,1073,1073,1080,1033,1139,7659
05825,134,178,278,277,292,271,191,1621
05826,886,922,954,958,998,1013,983,6714
05827,357,354,358,298,286,247,309,2209
05828,1893,1939,1987,2011,2049,2139,1928,13946
05829,1754,1628,1903,1788,1763,1730,2003,12569
05830,1515,1694,1632,1648,1836,1829,1502,11656
05832,835,786,821,789,836,924,982,5973
05833,269,268,193,161,193,151,273,1508
05836,1193,1044,999,1166,1184,1159,1068,7813
05837,372,350,437,389,394,395,353,2690
05839,705,651,712,777,757,827,775,5204
05841,389,420,407,384,376,387,425,2788
05842,486,590,530,522,592,629,522,3871
05843,2480,2581,2731,2636,2570,2565,2556,18119
05845,1170,1101,1000,1037,1024,1151,1096,7579
05846,996,998,963,1008,954,1016,1252,7187
05847,905,801,810,845,915,935,879,6090
05850,218,125,184,185,157,283,231,1383
05851,6635,6767,6735,6589,6505,6376,6528,46135
05853,530,615,721,755,798,737,711,4867
05855,7209,7290,7105,7321,7204,7376,7170,50675
05857,1988,1687,1695,1596,1463,1479,1540,11448
05858,397,398,429,468,472,511,368,3043
05859,1911,2019,1948,2075,1954,1958,1819,13684
05860,2677,2595,2631,2596,2518,2380,2557,17954
05862,352,341,371,387,347,381,356,2535
05866,657,653,613,559,545,592,732,4351
05867,836,829,785,877,921,962,899,6109
05868,351,331,283,279,319,306,364,2233
05871,1403,1529,1572,1569,1625,1501,1638,10837
05872,824,792,746,683,664,663,789,5161
05873,740,701,660,583,569,543,675,4471
05874,492,527,506,541,581,538,505,3690
05875,559,525,516,496,479,387,454,3416
05901,19,18,19,15,5,3,20,99
05902,232,165,152,180,163,151,188,1231
05903,990,1041,1117,1088,1070,1007,868,7181
05904,188,250,222,229,253,244,267,1653
05905,726,774,752,753,721,770,827,5323
05906,1259,1302,1216,1264,1335,1315,1178,8869
05907,143,147,165,160,174,179,177,1145
06001,18617,18645,18597,18577,18410,18172,18385,129403
06002,20687,20679,20626,20562,20470,20406,20486,143916
06010,60437,60554,60548,60525,60478,60436,60448,423426
06013,9540,9499,9451,9395,9317,9228,9326,65756
06016,6732,6601,6651,6296,6332,6245,6226,45083
06018,2689,2637,2735,2782,2690,2652,2865,19050
06019,10289,10309,10284,10249,10149,10058,10129,71467
06020,0,0,0,0,0,0,0,0
06021,400,379,342,300,345,280,314,2360
06022,30,27,50,55,94,81,163,500
06023,1278,1292,1078,1131,1004,1073,1296,8152
06024,587,712,682,650,768,846,647,4892
06026,5194,5023,4962,4896,4929,4972,5117,35093
06027,1456,1464,1421,1553,1481,1442,1492,10309
06029,15733,15659,15631,15593,15466,15394,15547,109023
06031,1384,1330,1469,1268,1273,1262,1287,9273
06032,17623,17506,17875,17790,17880,17630,17675,123979
06033,28659,28760,28702,28469,28563,28314,28762,200229
06035,7956,8002,8247,8111,7697,7408,7513,54934
06037,19251,19194,19274,19048,18970,18621,18565,132923
06039,1784,1707,1595,1766,1970,1952,1942,12716
06040,35616,36062,36197,35918,35974,35096,35306,250169
06042,22457,22125,22073,22278,22104,22801,22942,156780
06043,4950,4959,4963,4971,4990,5006,4986,34825
06051,30138,30415,30382,30431,30568,29938,30519,212391
06052,8231,7754,7603,7777,7661,7767,7858,54651
06053,34531,34830,35122,34915,34893,35350,34863,244504
06057,6241,6219,6413,6458,6704,6727,6707,45469
06058,1535,1638,1562,1588,1554,1610,1787,11274
06059,0,0,0,0,0,0,0,0
06060,2326,2339,2271,2346,2532,2723,2581,17118
06061,98,123,128,221,220,174,169,1133
06062,17772,17791,17791,17767,17726,17670,17715,124232
06063,3124,3110,3126,3233,3185,3193,3285,22256
06065,802,876,923,922,1015,990,882,6410
06066,29206,29162,29162,29179,29188,29199,29219,204315
06067,19920,19839,19838,19743,19631,19533,19709,138213
06068,1682,1741,1779,1751,1582,1647,1612,11794
06069,2444,2536,2535,2440,2478,2607,2535,17575
06070,14996,14782,14755,15043,15116,15023,15104,104819
06071,11533,11606,11590,11599,11598,11517,11645,81088
06073,5975,5925,5959,6082,5838,5776,5651,41206
06074,25793,25806,25795,25756,25684,25577,25705,180116
06076,12620,12626,12734,12846,12771,12821,12659,89077
06078,12370,12494,12550,12524,12395,12317,12413,87063
06081,1339,1302,1400,1370,1415,1345,1381,9552
06082,44515,44587,44713,44699,44699,44747,44654,312614
06084,14985,15019,15065,15059,15063,14931,15067,105189
06085,7551,7661,7236,7169,7020,7148,7276,51061
06088,4661,4786,4702,4985,4864,4779,4936,33713
06089,3514,3216,3236,3097,2733,2602,2813,21211
06090,1077,1113,1000,1045,1212,1209,1232,7888
06091,152,164,208,157,178,185,140,1184
06092,4166,4544,4290,4081,4271,4528,4203,30083
06093,3248,3163,3214,3207,3297,3196,3322,22647
06095,29166,29268,29232,29130,29088,28989,29079,203952
06096,12537,12564,12554,12531,12500,12466,12498,87650
06098,12666,12853,12796,12643,12255,12201,12426,87840
06103,1490,1480,1289,1295,1325,1159,1410,9448
06105,19165,19325,20230,20855,20759,20035,19392,139761
06106,38010,39201,38323,38225,37516,38318,39902,269495
06107,18855,19305,19243,18818,18551,18275,18786,131833
06108,25272,24645,24660,24349,24173,24003,24307,171409
06109,26396,26510,26579,26590,26670,26641,26668,186054
06110,12110,12081,12283,12360,12690,12663,12650,86837
06111,30590,30638,30652,30606,30520,30441,30562,214009
06112,22891,23260,23252,23298,22578,22410,22879,160568
06114,28131,27874,27909,28151,28656,28264,27449,196434
06117,16788,16629,17143,17868,17951,18465,17267,122111
06118,25605,26492,26551,26892,26998,27169,26956,186663
06119,15921,15529,15807,15299,14965,15190,15474,108185
06120,14120,13301,13119,12358,13092,13172,12887,92049
06160,0,0,0,0,0,0,0,0
06226,19667,19765,20222,19792,19578,19631,20114,138769
06231,3772,3647,3582,3805,4054,4129,4083,27072
06232,3211,3217,3181,3095,3185,3143,3297,22329
06234,8304,8294,8273,8242,8194,8148,8244,57699
06235,2265,2151,2224,2368,2324,2389,2257,15978
06237,5456,5460,5472,5476,5464,5449,5492,38269
06238,12446,12450,12434,12435,12445,12402,12428,87040
06239,10868,10686,10601,10223,10941,10939,11183,75441
06241,6830,7317,7229,7605,6861,6958,6650,49450
06242,1374,1503,1442,1405,1448,1380,1408,9960
06243,0,0,0,0,0,0,60,60
06247,2772,2815,2917,2833,2732,2700,2841,19610
06248,5808,5964,6045,5833,5595,5491,5603,40339
06249,7259,7295,7314,7322,7289,7268,7308,51055
06250,4851,4862,5034,5215,5908,5659,4821,36350
06254,1965,1931,1993,1950,1984,1958,1922,13703
06255,4619,4783,4987,4741,4852,4585,4744,33311
06256,2445,2354,2138,2378,2523,2407,2154,16399
06259,4394,4378,4438,4436,4473,4431,4498,31048
06260,9382,9437,9489,9524,9516,9561,9510,66419
06262,750,512,502,513,567,701,586,4131
06263,278,107,97,108,202,212,345,1349
06264,77,79,85,83,154,148,166,792
06266,355,290,333,534,693,761,495,3461
06268,10800,11136,11509,11063,11044,11335,11481,78368
06269,10113,9972,9559,9880,9009,8881,9844,67258
06277,3911,4059,3888,3999,3913,4036,4140,27946
06278,4405,4388,4396,4385,4386,4405,4454,30819
06279,5927,5961,5994,6018,6042,6070,6041,42053
06280,3122,3256,3029,3046,2899,2967,3162,21481
06281,6827,6667,6598,6983,7092,7029,6930,48126
06282,1117,1251,1357,1131,985,1017,1096,7954
06320,27270,27484,27614,27663,27675,27652,27617,192975
06330,3261,3305,3360,3366,3395,3386,3282,23355
06331,5078,5097,5110,5119,5111,5109,5137,35761
06332,417,553,445,310,260,252,258,2495
06333,6906,6682,6634,6390,6485,6472,6607,46176
06334,2538,2594,2615,2608,2592,2611,2592,18150
06335,6722,6761,6787,6832,6608,6862,6729,47301
06336,85,26,30,39,32,15,84,311
06339,8222,8214,8267,8203,8373,8076,8302,57657
06340,31467,31424,31760,31769,31594,31442,31242,220698
06350,59,60,59,84,19,0,67,348
06351,16171,16252,16303,16304,16262,16185,16301,113778
06353,37,35,36,0,252,291,162,813
06354,6333,5996,6142,6089,5973,6308,6141,42982
06355,12310,12534,12417,12466,12499,12732,12985,87943
06357,12023,12194,12484,12729,12683,12608,12552,87273
06359,5318,5340,5312,5307,5309,5303,5313,37202
06360,37153,37341,37351,37427,37295,36714,37541,260822
06365,4716,4729,4735,4751,4736,4729,4720,33116
06370,7418,7633,7805,7484,7306,7551,7429,52626
06371,9668,9738,9763,9893,9843,9805,9952,68662
06373,358,469,542,406,290,162,345,2572
06374,7601,7875,8342,8568,8497,8199,8373,57455
06375,3820,4024,4138,4119,4276,4004,3660,28041
06376,263,281,191,122,116,105,57,1135
06377,2818,2710,2620,2787,2878,3164,2962,19939
06378,5350,5237,5199,5299,5366,5342,5399,37192
06379,9135,9301,9316,9119,9196,9203,9038,64308
06380,2858,2876,2917,2850,2909,3255,2862,20527
06382,11844,11727,11574,11911,11795,11663,11947,82461
06384,2887,2887,2735,2768,2777,2577,2672,19303
06385,15666,15582,15517,15540,15395,15345,15893,108938
06387,320,252,198,171,387,316,213,1857
06389,30,37,96,118,99,93,41,514
06390,303,339,296,291,307,280,236,2052
06401,18934,19035,19128,19163,19188,19193,19237,133878
06403,6075,6008,5990,5975,5946,5926,6033,41953
06405,27901,27905,27871,27825,27952,28004,27860,195318
06409,547,576,498,605,728,673,693,4320
06410,29189,29189,29233,29231,29132,29077,29161,204212
06412,4290,4263,4223,4154,4090,3984,3994,28998
06413,13055,13130,13152,13205,13207,13245,13235,92229
06414,113,108,110,321,431,278,214,1575
06415,16938,16784,16849,16755,16532,16374,16857,117089
06416,14049,14086,14077,14076,14059,13951,14005,98303
06417,4552,4571,4611,4615,4636,4652,4629,32266
06418,12771,12796,12837,12841,12858,12845,12914,89862
06419,6464,6490,6516,6501,6512,6499,6525,45507
06420,4259,4275,4185,4182,4161,4144,4182,29388
06422,7322,7349,7371,7380,7368,7342,7388,51520
06423,5050,5211,5010,5174,5087,5240,5097,35869
06424,12824,12851,12782,12603,12456,12535,12808,88859
06426,3071,3116,3075,3129,3228,3324,3245,22188
06437,22382,22392,22405,22377,22353,22272,22375,156556
06438,2656,2896,2731,3025,2764,2664,2550,19286
06441,5328,5139,5427,5103,5330,5398,5438,37163
06442,2976,2942,3070,2934,2726,2700,2745,20093
06443,18247,18259,18284,18289,18264,18243,18269,127855
06444,214,204,155,134,191,18,370,1286
06447,6426,6439,6428,6398,6382,6335,6404,44812
06450,35907,36705,36973,37026,36756,36565,36493,256425
06451,24434,23852,23754,23703,23918,24043,24419,168123
06455,3323,3325,3346,3288,3480,3406,3148,23316
06456,260,259,242,240,280,318,295,1894
06457,46933,47218,47424,47539,47530,47510,47648,331802
06460,38233,38204,38145,38090,37953,37958,38207,266790
06461,15197,15002,14894,14804,14873,14774,14552,104096
06467,365,110,135,124,45,79,157,1015
06468,19784,19807,19744,19631,19529,19398,19479,137372
06469,3132,3204,3417,3319,3535,3358,3209,23174
06470,16612,16640,16672,16554,16237,16263,16003,114981
06471,7733,7833,7980,7983,7663,7760,7720,54672
06472,6760,6690,6602,6600,6816,6691,6853,47012
06473,24298,24184,24225,24193,24200,24176,24388,169664
06475,10174,10213,10222,10258,10268,10307,10242,71684
06477,13941,13946,13947,13934,13919,13884,13956,97527
06478,12916,12874,12831,12736,12602,12384,12683,89026
06479,9550,9881,10464,10247,10585,10665,10431,71823
06480,9404,9447,9483,9487,9500,9470,9508,66299
06481,1080,1102,1080,1133,946,1012,1277,7630
06482,11378,11372,11288,11218,11306,10972,11557,79091
06483,16540,16545,16551,16535,16487,16442,16540,115640
06484,40979,40783,40472,40006,39641,39310,39559,280750
06488,19727,19790,19876,19864,19841,19778,19904,138780
06489,33408,33312,32644,32745,32217,31969,32067,228362
06492,45054,45154,45193,45145,45168,45052,45241,316007
06498,6919,6945,6952,6956,6980,6937,6963,48652
06510,2759,2819,2571,2577,2496,2365,2737,18324
06511,51073,51147,52652,53062,54837,54974,53600,371345
06512,28890,29113,28618,28922,29016,28539,29861,202959
06513,40851,40635,40660,40765,38749,39012,38978,279650
06514,27475,27394,27039,27072,26917,26508,26265,188670
06515,18809,18714,18462,18034,17780,17947,17141,126887
06516,54972,55189,55290,55349,55386,55249,55564,386999
06517,14568,14665,15246,14859,14683,15211,14853,104085
06518,19407,19431,19288,19503,19135,18803,19848,135415
06519,16654,17074,16533,15997,16045,15357,16428,114088
06524,5521,5533,5546,5555,5524,5513,5563,38755
06525,8925,8939,8969,8981,8990,8992,8990,62786
06604,30164,30464,30095,29972,28764,28660,30313,208432
06605,23801,23461,23211,23497,23603,23888,23397,164858
06606,47671,49350,49027,47916,48725,47707,46236,336632
06607,8432,7824,8120,7379,7533,7286,7843,54417
06608,14033,13849,14124,14348,13772,13309,13671,97106
06610,22921,22392,22103,22475,22049,22562,22735,157237
06611,36477,36571,36444,36251,36008,35752,36091,253594
06612,7591,7619,7593,7550,7501,7452,7453,52759
06614,34601,34334,34063,33760,33295,32834,32929,235816
06615,17699,17982,18029,17934,18145,18282,18453,126524
06702,3057,3002,3039,2948,3431,3875,3654,23006
06704,25537,26014,26009,25682,24832,24013,25139,177226
06705,27195,27207,27515,27318,26838,26918,27122,190113
06706,14637,14994,14454,15012,14738,14729,14324,102888
06708,28310,28182,28809,29238,29875,30208,29418,204040
06710,10521,10178,10081,9852,10371,10354,10715,72072
06712,9720,9678,9615,9520,9450,9335,9376,66694
06716,16707,16717,16724,16688,16638,16532,16680,116686
06750,1256,1485,1522,1392,1251,1385,1446,9737
06751,3454,3492,3508,3527,3528,3532,3577,24618
06752,1668,1679,1747,1729,1704,1790,1735,12052
06754,1654,1692,1648,1850,1846,1835,1699,12224
06755,872,910,936,936,1133,1160,1133,7080
06756,2753,2798,2810,2779,2803,2891,2853,19687
06757,2188,2189,2087,2117,2162,2317,2258,15318
06758,372,304,369,404,435,381,354,2619
06759,5608,5621,5683,5822,6081,5804,5720,40339
06762,7602,7593,7571,7550,7522,7459,7561,52858
06763,1976,2006,1916,1971,2029,2030,2033,13961
06770,31674,31831,31919,31887,31907,31859,31975,223052
06776,26596,26662,26814,26948,26750,26734,26889,187393
06777,1454,1400,1398,1476,1616,1649,1733,10726
06778,1495,1405,1341,1326,1363,1409,1378,9717
06779,8230,8330,8427,8287,8377,8329,8324,58304
06782,2486,2234,2172,2240,2379,2336,2376,16223
06783,2260,2271,2273,2293,2313,2315,2228,15953
06784,3690,3685,3650,3681,3803,3805,3689,26003
06785,678,714,864,847,809,665,686,5263
06786,9440,9770,9913,9908,9814,9882,9867,68594
06787,7892,7736,7793,7831,7865,7862,7975,54954
06790,35268,35582,35826,36017,36152,36405,36482,251732
06791,5541,5584,5605,5748,5752,5729,5666,39625
06793,1277,1214,1055,1000,1111,1144,1140,7941
06794,1090,1305,1495,1472,1188,1134,1065,8749
06795,13765,13792,13832,14122,14084,14177,14144,97916
06796,1039,895,998,1026,984,954,1009,6905
06798,9723,9791,9851,9918,9934,9928,9984,69129
06801,19384,19250,19096,18911,18673,18459,18581,132354
06804,17080,17032,16834,16598,16515,16370,16466,116895
06807,6942,7005,6623,6685,6854,6650,7150,47909
06810,51085,51877,50969,49777,49146,48349,49482,350685
06811,32680,31461,31734,32182,31914,31755,31400,223126
06812,14075,14117,14079,14010,13932,13847,13881,97941
06820,21519,21392,21190,20925,20758,20580,20732,147096
06824,34795,34931,35030,34864,34374,34159,33900,242053
06825,21958,21773,21326,20712,20648,20430,21123,147970
06830,25342,25037,25066,24690,24315,24561,24027,173038
06831,14574,14905,15119,14699,14526,14225,14792,102840
06840,20248,20219,20073,19938,19794,19642,19738,139652
06850,18286,18871,19633,19950,20120,19432,18078,134370
06851,27101,27957,27994,28204,28616,27971,26703,194546
06853,3779,3642,3700,3735,3975,3787,3646,26264
06854,30520,29319,28332,27246,25788,26577,29100,196882
06855,7984,7694,7254,7071,7047,7245,7892,52187
06856,6,6,5,4,2,1,3,27
06870,7662,7386,7071,7179,7268,7143,7316,51025
06877,25152,25152,25104,24982,24747,24589,24677,174403
06878,8019,8317,8437,8627,8571,8528,8043,58542
06880,27909,27659,27313,27025,26790,26448,26647,189791
06883,10347,10373,10319,10261,10203,10142,10179,71824
06890,4199,4192,4222,4445,4429,4422,4306,30215
06896,9249,9284,9188,9056,9049,8938,9110,63874
06897,18634,18659,18657,18491,18343,17973,18071,128828
06901,7527,7277,7825,7213,7435,6566,6828,50671
06902,67879,67046,66495,66657,65817,66134,63406,463434
06903,14620,14955,14748,14550,14480,14327,14499,102179
06905,19866,19097,19033,19067,18356,18198,19649,133266
06906,8432,8887,8559,8537,8499,8403,9088,60405
06907,8965,9114,8566,7824,8185,8072,9016,59742
07001,18136,18295,17479,16895,16598,16566,16305,120274
07002,65772,65378,64763,63819,63164,62485,63031,448412
07003,47989,47840,47624,47442,47309,47148,47312,332664
07004,7462,7556,7417,7420,7347,7367,7440,52009
07005,15539,15315,15215,15097,15353,15608,15269,107396
07006,25419,25271,25250,25012,24976,24891,24812,175631
07008,23966,23965,23770,23487,23135,22623,22844,163790
07009,12545,12529,12499,12450,12432,12346,12411,87212
07010,24661,24493,24532,24110,23618,23469,23594,168477
07011,41329,41669,41226,40293,39904,39186,39710,283317
07012,11507,11459,11818,11927,12588,13079,11703,84081
07013,26284,26338,25911,26026,25317,24981,27051,181908
07014,5439,5155,5097,5278,4816,4829,5184,35798
07016,23531,23328,23150,22846,22659,22499,22625,160638
07017,35945,36084,35320,34813,34983,35019,35945,248109
07018,28741,28636,29353,29656,29536,29597,28322,203841
07020,11998,11935,11969,11706,11425,11078,11513,81624
07021,2145,2135,2122,2119,2129,2075,2091,14816
07022,14314,14233,14126,13988,13888,13748,13835,98132
07023,7530,7479,7475,7390,7313,7264,7318,51769
07024,36625,36347,36020,35607,35431,35213,35353,250596
07026,31511,31319,31066,30797,30570,30400,30555,216218
07027,4315,4306,4323,4239,4295,4202,4226,29906
07028,7699,7659,7685,7648,7607,7606,7618,53522
07029,17760,17206,16987,16496,15980,16010,16026,116465
07030,53136,52452,51979,50929,49898,48515,50005,356914
07031,15788,15734,15587,15492,15407,15340,15392,108740
07032,41993,41866,41538,41123,40744,40406,40684,288354
07033,8129,8104,8045,7977,7907,7852,7914,55928
07034,9631,9745,9648,9763,9773,9963,9360,67883
07035,10787,10786,10592,10609,10598,10673,10607,74652
07036,43111,42894,42527,42231,41851,41598,41970,296182
07039,29691,29674,29617,29437,29269,28982,29358,206028
07040,24419,24303,24233,24021,23897,23809,23876,168558
07041,7445,7328,7463,7199,7090,6871,6868,50264
07042,25698,25598,25500,25479,25661,25554,25599,179089
07043,12976,12890,12932,12861,12918,12836,12138,89551
07044,13834,13901,13966,13775,13626,13565,13584,96251
07045,10741,10130,9560,9742,10066,9813,10127,70179
07046,4287,4292,4267,4218,4206,4214,4194,29678
07047,62791,62570,62114,61434,60772,60115,60773,430569
07050,30421,30084,30202,30062,30002,30074,30074,210919
07052,47037,47000,46661,46386,46153,45920,46182,325339
07054,29555,29706,29642,29101,28729,28657,29305,204695
07055,70574,70618,70702,70215,69727,69290,69816,490942
07057,11618,11584,11487,11432,11410,11336,11335,80202
07058,5428,5857,6166,6163,6091,6046,5372,41123
07059,15948,15867,15729,15574,15412,15229,15311,109070
07060,45676,45931,45781,44793,44219,44610,44998,316008
07062,13011,12804,12580,12571,12712,11772,12949,88399
07063,13877,13944,13960,14552,14606,14817,13538,99294
07064,3896,3634,3836,3469,3571,3356,3723,25485
07065,28897,28644,27994,27701,27369,27127,27346,195078
07066,15295,15144,15056,14882,14768,14659,14756,104560
07067,18130,18161,17966,17792,17794,17731,18036,125610
07068,5875,5853,5835,5813,5812,5750,5819,40757
07069,6197,6105,6078,6130,6015,5900,6157,42582
07070,18480,18434,18297,18201,18084,18016,18061,127573
07071,21582,21318,21207,20841,20621,20370,20554,146493
07072,6238,6225,6189,6155,6161,6092,6127,43187
07073,9236,9076,9298,9091,8909,8875,8913,63398
07074,2756,2753,2741,2729,2711,2715,2708,19113
07075,8109,7938,8249,8071,7892,7607,7626,55492
07076,24016,23922,23757,23561,23370,23195,23480,165301
07077,2405,2530,2341,2561,2662,2553,2766,17818
07078,12766,12855,12737,12912,12966,13157,13250,90643
07079,16305,16466,16476,16435,16472,16380,16316,114850
07080,23916,23871,23686,23543,23397,23237,23377,165027
07081,17318,17101,16729,16249,16030,15606,15808,114841
07082,4774,5095,5341,5107,4783,5070,5384,35554
07083,54362,54413,53811,53503,52899,52846,53053,374887
07086,13671,13215,13113,12829,12764,12574,12554,90720
07087,69065,68790,68338,67566,66924,66322,66515,473520
07088,3441,3221,3504,3412,3581,3393,3606,24158
07090,30470,30584,30735,30599,30382,30154,30338,213262
07092,6835,6832,6765,6763,6714,6695,6730,47334
07093,64035,63455,62908,61919,60982,60038,60884,434221
07094,18737,18170,17614,17106,16809,16125,16264,120825
07095,19701,20176,20688,20722,20596,20664,19844,142391
07102,13084,13222,13222,12922,12777,12005,12579,89811
07103,31924,31363,31737,30432,30773,30562,32698,219489
07104,50096,50998,51475,50813,50519,51482,50478,355861
07105,53832,53080,51155,50466,49344,48639,46983,353499
07106,32658,30824,30723,30675,31643,32366,31298,220187
07107,38577,38795,37842,37788,37269,36076,37650,263997
07108,20980,21365,22230,24053,24235,25016,24386,162265
07109,36125,36105,36121,35973,35778,35688,35897,251687
07110,28485,28549,28509,28384,28311,28119,28351,198708
07111,54303,54320,54268,54144,54205,54428,53942,379610
07112,25476,26006,26043,25935,25543,25652,26417,181072
07114,13615,14251,14434,14352,14517,13850,14748,99767
07201,26446,26177,24948,24719,24704,24625,26263,177882
07202,41590,41029,42171,42177,41910,40874,40849,290600
07203,21507,21466,21348,21212,21103,21016,21085,148737
07204,13560,13555,13465,13384,13310,13214,13297,93785
07205,21800,21779,21676,21538,21413,21328,21398,150932
07206,28421,28248,27642,26860,26005,25518,26636,189330
07208,31548,32277,32173,32132,32176,32763,31219,224288
07302,41026,39964,38811,37472,37055,35910,36352,266590
07304,42798,42935,41821,40750,39886,39346,41233,288769
07305,63568,63440,62698,63033,62432,61392,60104,436667
07306,55039,55296,55376,53767,52437,52027,52669,376611
07307,45018,44400,43911,43283,43626,44114,43812,308164
07310,13728,13156,12523,12644,12397,11849,12838,89135
07311,389,326,384,435,324,361,522,2741
07401,6767,6717,6666,6595,6549,6420,6494,46208
07403,7881,7918,7808,7693,7654,7620,7603,54177
07405,17713,17723,17908,17809,17778,17672,17701,124304
07407,20135,19959,19921,19685,19461,19311,19403,137875
07410,33205,33164,32962,32659,32479,32286,32457,229212
07416,5561,5717,5818,5952,5778,5834,5781,40441
07417,10810,10799,10726,10655,10596,10545,10580,74711
07418,2051,1885,1861,2065,2022,2213,2249,14346
07419,8750,8562,8740,8800,9422,9636,9160,63070
07420,5152,5044,4740,4517,4591,4379,4942,33365
07421,7281,7317,7363,7072,6935,7180,7439,50587
07422,6379,6223,6331,6308,6276,6450,6616,44583
07423,4139,4132,4125,4109,4085,4065,4078,28733
07424,26851,26818,26639,26416,26236,25770,26222,184952
07430,26434,26368,26242,26042,25840,25635,25890,182451
07432,7283,7269,7229,7180,7131,7083,7128,50303
07435,2743,2599,2282,2267,2177,1853,2405,16326
07436,13041,13003,12914,12830,12763,12701,12754,90006
07438,11510,11192,11277,11566,11720,11544,11559,80368
07439,2488,2498,2415,2399,2407,2422,2456,17085
07440,4493,4739,4769,4862,5043,4938,4494,33338
07442,11163,11179,11162,11126,11074,11015,11097,77816
07444,11011,10811,10808,10675,10426,10455,11046,75232
07446,14952,14889,14650,14570,14528,14519,14484,102592
07450,25448,25387,25287,25175,25063,24954,24985,176299
07452,11887,11859,11784,11699,11631,11578,11601,82039
07456,12178,12360,12320,12273,12234,12197,12211,85773
07457,4206,4154,3906,3798,3659,3454,3559,26736
07458,11590,11564,11480,11420,11351,11275,11360,80040
07460,3521,3579,3574,3543,3338,3143,3457,24155
07461,19065,19305,19811,19416,19774,19552,19563,136486
07462,6766,7121,6741,7130,7111,7091,6885,48845
07463,9922,9902,9808,9704,9678,9602,9615,68231
07465,6818,6615,6503,6625,6471,6589,6244,45865
07470,54992,55216,55003,54849,54641,54479,54717,383897
07480,16565,16839,16906,16881,16667,16533,16122,116513
07481,17119,17045,16877,16807,16729,16620,16716,117913
07495,0,0,0,0,0,0,0,0
07501,32325,33024,33225,31509,31448,31680,33543,226754
07502,16798,16219,15162,14685,14229,14456,15406,106955
07503,18573,19620,20084,19960,20027,19762,18723,136749
07504,11649,11416,12881,12866,12866,12935,12882,87495
07505,2808,2544,2369,2376,1750,1543,2256,15646
07506,18950,18989,18944,18868,18753,18656,18791,131951
07508,22736,22737,22790,22671,22595,22407,22600,158536
07512,10900,10931,10872,10833,10784,10679,10804,75803
07513,12510,11915,11348,11903,11601,11533,11508,82318
07514,20406,19509,19095,18738,19321,18398,18289,133756
07522,18957,19697,19266,20869,21910,21994,20883,143576
07524,12868,13043,12911,13014,12503,13614,12709,90662
07601,44271,44035,43903,43466,43126,42857,43010,304668
07603,8348,8329,8277,8231,8200,8164,8187,57736
07604,12124,12100,11989,11896,11830,11792,11842,83573
07605,9137,9129,9135,9060,8998,8979,8950,63388
07606,2669,2651,2582,2371,2282,2146,2310,17011
07607,9726,9694,9651,9609,9547,9531,9555,67313
07608,86,85,56,92,80,93,67,559
07620,1529,1559,1710,1861,2006,2072,1849,12586
07621,27513,27339,27157,26911,26606,26498,26761,188785
07624,8643,8582,8519,8449,8397,8354,8373,59317
07626,8745,8729,8669,8530,8393,8245,8537,59848
07627,5007,5004,4929,4904,4909,4865,4881,34499
07628,17788,17820,17706,17600,17505,17433,17433,123285
07630,7621,7586,7517,7443,7471,7367,7379,52384
07631,28081,27919,27342,27211,27153,26870,27119,191695
07632,5508,5442,5439,5409,5349,5404,5309,37860
07640,4790,4764,4736,4704,4715,4662,4664,33035
07641,3446,3451,3419,3406,3382,3376,3382,23862
07642,10454,10420,10349,10293,10230,10181,10207,72134
07643,10868,10856,10773,10723,10635,10612,10626,75093
07644,24654,24590,24428,24278,24176,24078,24136,170340
07645,8285,8199,8000,7910,7809,7725,7832,55760
07646,16682,16640,16524,16433,16362,16297,16341,115279
07647,5389,5339,5233,5176,5151,5034,5152,36474
07648,5828,5823,5769,5756,5729,5710,5730,40345
07649,8160,8146,8080,8036,7997,7966,7978,56363
07650,20481,20268,20010,19750,19500,19311,19601,138921
07652,26795,26760,26612,26454,26301,26197,26342,185461
07656,8854,8852,8795,8719,8737,8658,8669,61284
07657,11294,11256,11191,11112,11081,10984,11032,77950
07660,12976,12969,12875,12819,12761,12710,12729,89839
07661,11586,11566,11483,11398,11340,11273,11340,79986
07662,5634,5624,5644,5622,5534,5530,5530,39118
07663,13980,13954,13841,13741,13734,13570,13659,96479
07666,40668,40569,40261,39994,39781,39636,39776,280685
07670,14821,14788,14672,14664,14789,14757,14573,103064
07675,27082,26975,26753,26540,26368,26225,26339,186282
07676,9295,9254,9203,9106,9056,9008,9075,63997
07677,5844,5818,5785,5768,5750,5707,5730,40402
07701,23768,23861,23828,23778,23669,23339,23813,166056
07702,4000,3923,3899,3838,3822,3773,3809,27064
07703,81,124,328,387,436,554,690,2600
07704,6033,6075,6093,6108,6102,6108,6133,42652
07711,1529,1449,1312,1364,1489,1596,1533,10272
07712,38490,38955,38611,39099,39365,39118,39158,272796
07716,8821,8687,8822,8901,8664,8584,8574,61053
07717,1846,1809,1810,1941,1972,2079,1901,13358
07718,7354,7037,6625,6143,5947,5691,6263,45060
07719,20876,21158,21669,21769,22437,22252,21538,151699
07720,4272,4297,4290,4298,4335,4356,4298,30146
07721,3169,3033,3111,2998,2942,2912,2974,21139
07722,10079,10121,10154,10146,10173,10200,10209,71082
07723,1004,888,1035,1160,1245,1225,1020,7577
07724,21611,21736,21749,21758,21720,21958,21710,152242
07726,44122,43825,43324,42520,41943,41816,42508,300058
07727,8151,7550,7612,6851,6450,6261,7050,49925
07728,55905,55979,56039,56270,56369,55763,56257,392582
07730,17353,17212,17283,17374,17365,17403,17396,121386
07731,38193,38637,38217,38382,38140,38453,38304,268326
07732,4920,4967,5006,5112,5163,5297,5189,35654
07733,16713,16695,16657,16583,16530,16711,16849,116738
07734,12851,13166,13213,13217,13310,13403,13269,92429
07735,18727,19557,20038,19800,20289,20306,19569,138286
07737,3725,4032,3997,3966,4071,4239,4264,28294
07738,6236,6309,6336,6363,6299,6219,6095,43857
07739,5922,5937,5920,5939,5970,5979,5938,41605
07740,31034,31048,30882,30879,31012,31017,31038,216910
07746,18766,19471,19613,19724,19616,19322,18666,135178
07747,31426,31288,30709,30332,30444,30612,30770,215581
07748,27075,27430,27583,27398,28158,28625,28030,194299
07750,3239,3258,3278,3280,3298,3315,3279,22947
07751,19720,19271,19077,19014,18883,18736,19736,134437
07753,37634,37551,37820,37041,36740,36745,37554,261085
07755,6032,6151,6417,6618,6650,6638,6363,44869
07756,3069,3015,3134,3242,3235,3501,3342,22538
07757,5738,5735,5619,5575,5519,5423,5356,38965
07758,4586,4512,4945,5631,5404,5385,4967,35430
07760,8945,9146,8984,9141,9318,9308,9283,64125
07762,8107,8137,8176,8401,8525,8689,8403,58438
07764,7947,7974,8391,8317,8238,8102,8097,57066
07801,26070,26195,26138,26118,25878,25675,25386,181460
07803,3634,3649,3657,3663,3669,3665,3651,25588
07820,42,41,36,0,0,0,39,158
07821,9470,9350,9488,9590,9420,9632,9193,66143
07822,597,648,732,808,857,862,887,5391
07823,7729,7489,7594,7546,7813,7956,7571,53698
07825,9341,9277,9432,9641,9720,9796,9555,66762
07826,5933,6213,6060,6385,6143,5971,6180,42885
07827,4137,4232,4236,4297,4343,4315,4244,29804
07828,14957,14504,14459,14184,14078,13377,14150,99709
07830,6945,7040,6674,6480,6916,6959,6503,47517
07832,3877,4021,3875,3718,3510,3624,3903,26528
07833,116,95,100,80,108,129,157,785
07834,17971,17909,17882,17742,17630,17533,17722,124389
07836,12270,12983,13011,13390,12882,12964,12568,90068
07838,3546,3896,3885,3907,3741,3434,3568,25977
07840,29947,29395,29132,29527,29658,29883,29849,207391
07842,71,33,143,116,134,165,130,792
07843,11984,12009,11899,12241,12326,12525,12241,85225
07846,58,95,83,93,95,108,89,621
07847,1574,1315,1293,1303,1186,1253,1670,9594
07848,4762,4775,4689,4675,4926,4984,5026,33837
07849,9242,8965,9166,9101,8926,8927,9054,63381
07850,6178,6597,7008,7361,7293,7225,6436,48098
07851,84,101,106,74,132,124,119,740
07852,4227,4075,4076,3863,4257,3993,3609,28100
07853,13171,13058,13420,12876,12952,13143,13325,91945
07856,4292,4082,3722,3557,3542,3460,3944,26599
07857,3276,3353,3304,3303,3319,3307,3244,23106
07860,25873,26010,26539,26490,26585,26755,26288,184540
07863,4061,4262,4311,4366,4260,4330,4332,29922
07865,1918,2126,2004,2102,2316,2245,2189,14900
07866,21668,21827,21737,21588,21859,21858,22098,152635
07869,25746,25760,25668,25385,25403,25368,25291,178621
07870,8,8,0,0,89,86,26,217
07871,20493,20774,20883,20858,21013,20973,21165,146159
07874,8443,8549,8773,8568,8550,8570,8905,60358
07876,10382,10346,10171,10159,10322,10526,10619,72525
07878,854,892,979,918,1232,1266,934,7075
07880,280,87,97,73,70,95,192,894
07881,6,4,9,6,5,17,16,63
07882,14731,14513,14498,14545,14201,14193,14492,101173
07885,10262,10701,10315,10174,9883,10099,10078,71512
07901,23276,23122,22963,22874,22712,22606,22806,160359
07920,26949,26966,26955,26397,26310,26345,26747,186669
07921,7770,7915,7930,7945,7855,7891,7621,54927
07922,12330,12345,12383,12200,12126,12178,12246,85808
07924,7743,7751,7717,7658,7572,7557,7534,53532
07926,73,64,78,97,102,14,120,548
07927,3723,3455,3670,3466,3599,3567,3403,24883
07928,19355,19316,19335,19140,19137,19013,19144,134440
07930,8285,8410,8399,8385,8320,8141,8559,58499
07931,3628,3372,3348,3545,3593,3326,3296,24108
07932,10129,9938,10577,10601,10459,10462,9868,72034
07933,3309,3391,3378,3465,3563,3740,3251,24097
07934,1588,1618,1620,1547,1493,1517,1501,10884
07935,289,353,407,486,399,377,313,2624
07936,11232,11248,11256,11236,11222,11215,11157,78566
07939,236,225,340,314,294,293,228,1930
07940,17311,17302,16888,16915,16779,16577,17278,119050
07945,9200,9401,9608,9711,9722,9650,9539,66831
07946,3136,2961,3010,3109,3300,3241,3144,21901
07950,19329,19285,19485,19719,19129,18320,19564,134831
07960,44519,44554,43932,43760,43712,43971,43747,308195
07961,0,0,0,0,0,0,4,4
07970,164,205,132,137,240,246,117,1241
07974,12110,12096,12173,12054,12085,11801,11768,84087
07976,596,609,558,652,752,800,754,4721
07977,597,609,545,611,627,671,669,4329
07979,510,440,518,608,611,508,589,3784
07980,2317,2418,2381,2175,1877,1743,2307,15218
07981,9135,9263,9187,9246,9045,8936,8865,63677
08001,1044,1261,1125,1064,864,770,844,6972
08002,22238,22199,22187,22025,22250,22150,22274,155323
08003,30060,30246,30574,30845,30888,31074,30629,214316
08004,12366,12511,12439,12412,12339,12081,12350,86498
08005,23166,22946,22624,22428,22118,21793,22448,157523
08006,430,482,499,563,526,531,518,3549
08007,5178,5331,5371,5416,5413,5422,5250,37381
08008,6693,6586,6833,6926,7134,7600,6975,48747
08009,13120,12819,12529,12470,12581,12520,12854,88893
08010,11452,11496,11491,11517,11517,11463,11539,80475
08011,87,70,97,80,71,15,33,453
08012,41059,40352,40616,39703,39281,38750,38992,278753
08014,731,775,738,594,414,337,504,4093
08015,20188,20225,20398,20645,20820,20836,20763,143875
08016,33486,33382,33148,33162,33089,33010,33540,232817
08019,1072,1012,1020,1031,891,822,925,6773
08020,2634,2499,2467,2505,2465,2452,2201,17223
08021,44241,44377,44669,45145,45041,45517,44833,313823
08022,8957,8926,8955,8962,8780,8482,8783,61845
08023,438,494,498,464,483,354,451,3182
08026,2157,2236,2324,2273,2309,2316,2274,15889
08027,4870,4869,4844,4860,4881,4865,4888,34077
08028,20610,20157,19908,20121,20145,19748,20078,140767
08029,4203,4487,4575,4859,4970,4767,4784,32645
08030,13311,13330,13271,13193,13279,13190,13410,92984
08031,11503,11507,11538,11558,11585,11591,11584,80866
08033,16303,16204,16060,15845,15978,16076,16261,112727
08034,18832,18558,18400,18187,17725,17695,18151,127548
08035,7650,7614,7582,7567,7584,7563,7566,53126
08036,5842,5730,5836,5794,5519,5452,5917,40090
08037,23861,24099,24002,23669,24173,24285,24308,168397
08038,57,85,75,107,140,188,124,776
08039,110,106,125,55,58,63,137,654
08041,1099,1178,1229,1229,1235,1243,1002,8215
08042,118,121,70,83,151,179,203,925
08043,29329,29375,29227,29261,29225,29080,29131,204628
08045,2836,2907,2907,2934,2928,2930,2909,20351
08046,31442,31441,31718,31731,31760,31908,31587,221587
08048,12419,12443,12460,12516,12471,12398,12495,87202
08049,5772,5737,5567,5613,5381,5334,5350,38754
08050,24793,24935,25066,24629,24374,24205,24285,172287
08051,10515,11041,11336,10924,10917,10678,10758,76169
08052,19003,19085,19117,19197,19273,19225,19172,134072
08053,45578,45664,45669,45663,45555,45395,45538,319062
08054,41849,41870,41813,41848,41865,41888,41864,292997
08055,27396,27398,27353,27280,27253,27226,27179,191085
08056,4596,4713,4640,4437,4372,4355,4736,31849
08057,20899,20861,20821,20827,20819,20910,21090,146227
08059,5576,5552,5536,5684,5679,5723,5612,39362
08060,24330,24519,24501,24648,24955,25112,24713,172778
08061,3072,2996,2911,2876,2733,2369,2672,19629
08062,16035,15993,15810,15762,15645,15584,15756,110585
08063,3083,3066,3132,3120,3151,3149,3102,21803
08064,153,145,173,171,200,252,311,1405
08065,7306,7356,7372,7401,7411,7407,7398,51651
08066,8450,8384,8337,8484,8612,8990,8437,59694
08067,1704,1673,1789,1833,1916,1763,1635,12313
08068,7061,7118,6918,6943,7031,7211,6727,49009
08069,12752,12842,12970,12994,13064,13089,13076,90787
08070,12557,12648,12822,12953,12955,13104,13059,90098
08071,9635,9663,9727,9685,9595,9759,9551,67615
08072,278,271,266,162,152,212,225,1566
08073,366,331,300,262,252,152,203,1866
08074,16,22,20,15,11,0,58,142
08075,29044,29231,29316,29311,29156,28866,28894,203818
08077,19260,19164,19020,18748,18505,18301,18307,131305
08078,8365,8360,8385,8436,8437,8432,8385,58800
08079,10372,10383,10588,10812,10918,11227,10987,75287
08080,36675,36078,35583,35672,36201,36554,37433,254196
08081,48709,48699,49132,50784,50544,50624,50589,349081
08083,9621,9658,9788,9559,9521,9589,9455,67191
08084,7007,7007,6997,7015,7048,7080,7040,49194
08085,20116,19811,19263,19033,18855,18297,18737,134112
08086,7989,7553,7712,7378,7425,7175,7699,52931
08087,24535,24454,24430,24104,24029,23829,24104,169485
08088,24158,24284,24327,24380,24402,24543,24664,170758
08089,4458,4584,4599,4332,4408,4495,4253,31129
08090,8445,8526,8774,8924,8746,8803,8358,60576
08091,5411,5380,5360,5361,5371,5351,5357,37591
08092,3469,3310,3193,3446,3491,3423,3673,24005
08093,9478,9579,9815,10576,10432,10439,9741,70060
08094,40426,40046,40075,39747,39604,38941,39940,278779
08095,220,193,145,180,117,138,236,1229
08096,35599,35943,35212,35116,35155,35311,36116,248452
08097,3155,3233,3235,3197,3154,3203,3293,22470
08098,9514,9492,9213,9129,8963,8884,9090,64285
08102,7601,7554,7942,7382,7380,7530,7565,52954
08103,14443,14936,14349,14646,15029,14720,15190,103313
08104,23827,23659,24016,24364,24420,24619,23851,168756
08105,28559,29081,29300,29369,29577,29856,29077,204819
08106,9764,9802,9843,9907,9925,9972,9874,69087
08107,12887,13046,13600,13910,13955,14118,13675,95191
08108,18333,18272,17932,17826,17664,17511,18045,125583
08109,22827,22999,23047,22814,22720,22742,22407,159556
08110,18278,18192,18205,18502,18322,18150,19008,128657
08201,9951,10207,10187,10234,10172,10185,10007,70943
08202,1499,1686,1953,2018,2166,2310,1444,13076
08203,9239,9347,9420,9480,9622,9832,9454,66394
08204,18718,18932,18468,18543,18296,18218,18557,129732
08205,28705,28532,28253,27385,26823,26390,28626,194714
08210,17134,17288,18100,17570,17188,16863,17167,121310
08212,214,240,200,170,161,120,294,1399
08215,13466,13597,13633,13962,13857,14012,13442,95969
08217,24,24,22,72,14,14,70,240
08221,7009,7036,7071,7099,7109,7126,7092,49542
08223,4088,3957,4013,3851,3996,3934,4125,27964
08224,537,477,516,669,689,715,573,4176
08225,8578,8637,8658,8649,8670,8575,8659,60426
08226,11430,11470,11520,11640,11790,12010,11701,81561
08230,5581,5657,5375,5633,5739,5853,5599,39437
08232,19667,19327,19355,19238,19015,19051,19292,134945
08234,42728,43042,42802,42491,42343,41382,42532,297320
08240,2301,2531,2701,3233,3737,4101,2371,20975
08241,984,978,1088,1010,980,1122,1103,7265
08242,2869,3009,2682,3003,2913,3134,3216,20826
08243,1905,1788,1824,1861,1994,1976,2114,13462
08244,10858,10959,10930,11001,10898,10997,10849,76492
08246,119,193,177,158,198,186,92,1123
08247,941,884,790,760,819,848,925,5967
08248,181,191,106,36,118,183,158,973
08251,9524,9323,9737,9708,10234,10210,10364,69100
08260,13129,13161,13325,13690,13770,13880,13661,94616
08270,8712,8654,8792,8778,8329,8248,8492,60005
08302,45964,46444,46620,47895,48348,48016,46872,330159
08310,1478,1587,2041,2055,1970,1773,1670,12574
08311,2161,2096,2094,2155,2217,2072,2057,14852
08312,8160,8068,7896,7787,8003,7993,7875,55782
08314,2511,2349,3251,2986,2807,2933,2511,19348
08316,327,365,391,324,430,461,400,2698
08317,1376,1464,1453,1446,1480,1395,1344,9958
08318,12069,12150,12171,12223,12050,12138,12702,85503
08319,1208,1251,1216,1275,1333,1266,1253,8802
08320,1275,1316,1304,0,0,0,1256,5151
08321,107,119,124,101,148,161,247,1007
08322,10680,10543,10338,10204,10049,10088,10524,72426
08323,712,960,953,1005,924,878,804,6236
08324,365,371,450,670,830,946,526,4158
08326,1452,1575,1843,1586,1728,1783,1761,11728
08327,3638,3538,2235,2180,2328,2006,3070,18995
08328,1291,1458,1684,1697,1753,1522,1347,10752
08329,100,105,72,192,213,188,221,1091
08330,28584,28650,28501,28371,28046,27506,28167,197825
08332,36771,37044,37452,36592,36316,36264,36768,257207
08340,875,713,732,716,818,911,979,5744
08341,2305,2141,1940,2205,2114,2000,2239,14944
08343,5293,5551,5755,5267,5507,5781,5030,38184
08344,5297,5155,5243,5854,5600,5667,5847,38663
08345,568,763,686,819,734,711,805,5086
08346,643,844,983,1252,929,1153,843,6647
08348,278,201,233,521,378,421,275,2307
08349,2082,2368,2627,2713,2501,2503,2347,17141
08350,1142,1155,890,853,651,722,825,6238
08352,599,508,568,591,567,541,448,3822
08353,349,492,579,593,629,665,516,3823
08360,43559,43376,44226,43402,43373,41871,43355,303162
08361,18046,18431,17299,18006,18053,19144,17352,126331
08401,39306,39547,39521,39591,39680,39836,39554,277035
08402,6250,6304,6343,6385,6459,6578,6354,44673
08403,1093,1090,1048,1066,1060,1184,997,7538
08406,10505,10593,10632,10681,10785,10958,10650,74804
08501,6273,6388,6406,6404,6366,6435,6582,44854
08502,11711,11834,11587,11628,11057,10964,11317,80098
08505,17961,17920,17637,17223,17087,16875,17736,122439
08510,5918,5173,4731,4911,5056,4560,5231,35580
08511,928,719,775,956,1188,1169,826,6561
08512,11024,11078,10569,10438,10139,10133,10105,73486
08514,5500,5131,5073,4530,4406,4283,4477,33400
08515,6352,6221,7135,7100,6907,6769,4637,45121
08518,5221,5299,5123,5217,5204,5259,4986,36309
08520,27065,27100,27653,27468,27486,27383,27869,192024
08525,4965,4874,4916,4782,4403,4565,4767,33272
08527,55825,55459,55285,54867,54268,53374,54392,383470
08528,173,146,157,245,234,371,315,1641
08530,7328,7633,7349,7568,8293,8519,8071,54761
08533,6178,6441,6501,6789,6983,6985,6945,46822
08534,13361,13274,13328,13312,13037,12550,12929,91791
08535,4660,5384,5828,5657,5411,5846,5385,38171
08536,20180,20258,19889,19944,19968,19961,20073,140273
08540,48341,46888,48300,47316,47204,47934,47115,333098
08542,5752,5373,4740,4756,4755,4314,5189,34879
08550,19349,19282,19510,19357,19258,19064,19445,135265
08551,5257,4830,5019,5212,5756,5921,5532,37527
08553,618,615,554,543,546,584,682,4142
08554,3913,3790,4007,4023,4087,4042,3818,27680
08555,744,798,739,812,828,772,877,5570
08558,7106,6752,6680,6495,6629,6577,6629,46868
08559,5051,5445,5272,5226,5323,5505,4982,36804
08560,3669,3707,3788,3249,2969,3213,3656,24251
08561,119,16,16,0,0,127,226,504
08562,4733,4983,5313,5713,5924,6155,5371,38192
08608,805,676,813,921,637,689,983,5524
08609,13237,13582,14392,14884,13908,13579,13546,97128
08610,29911,29507,29127,29222,30255,30205,30468,208695
08611,25906,26395,26987,26477,27125,27959,28038,188887
08618,40498,40234,39195,38057,37681,37869,38229,271763
08619,22088,21970,22639,23175,22363,21769,22723,156727
08620,12655,13402,12409,12638,12832,13272,14693,91901
08628,9414,9536,9361,9579,9441,9918,9054,66303
08629,13615,13080,12730,12450,12634,13136,12331,89976
08638,22794,22903,23176,23466,23258,22158,22832,160587
08640,8246,8206,7892,7381,6581,6381,7716,52403
08641,4748,4624,4485,4134,4114,3688,3553,29346
08648,32137,32315,32359,32300,32168,31313,32263,224855
08690,19347,19716,18676,18766,19514,19228,18567,133814
08691,15887,15695,15251,15431,15283,14929,15104,107580
08701,97907,96575,93473,92586,91423,89949,92843,654756
08720,953,883,955,1031,926,1110,843,6701
08721,20931,20486,20802,20789,20377,20214,20512,144111
08722,11153,11128,11127,11105,11067,11032,11045,77657
08723,32064,31587,31648,31769,31603,31790,31641,222102
08724,41858,42477,43100,42866,43005,42987,42352,298645
08730,4745,4769,4772,4782,4787,4790,4774,33419
08731,19944,20092,19776,19868,19460,19252,20009,138401
08732,1480,1505,1560,1553,1426,1318,1484,10326
08733,2710,2701,2765,2787,2802,2937,2752,19454
08734,8329,8013,8113,7907,8188,8332,7651,56533
08735,3439,3265,3019,3283,3563,3454,3114,23137
08736,12618,12567,12213,12372,12024,12083,12578,86455
08738,932,910,930,964,980,1051,1042,6809
08740,2060,2105,2072,1961,1908,1683,2010,13799
08741,2574,2536,2758,2591,2569,2505,2488,18021
08742,24365,24249,24330,24377,24429,24629,24405,170784
08750,3349,3444,3731,3596,3541,3609,3528,24798
08751,4304,4221,4300,4248,4417,4273,4212,29975
08752,2309,2367,2199,1897,2238,2497,2074,15581
08753,63222,63357,63764,63891,63218,63003,63678,444133
08755,25491,25607,25845,25737,25987,26066,25302,180035
08757,33565,33937,33638,33041,32955,32844,33217,233197
08758,7619,7510,7649,7512,7339,7066,7043,51738
08759,32940,32646,32508,33033,33064,33361,33263,230815
08801,9104,8961,8926,8662,8597,8809,8551,61610
08802,4127,4093,3887,3603,3819,3884,4067,27480
08804,2358,2450,2463,2679,2622,2836,2771,18179
08805,12163,12268,12437,12340,12193,12025,12254,85680
08807,38998,38865,38242,38241,38236,38079,37972,268633
08808,33,7,44,52,148,136,86,506
08809,5913,5958,6366,6471,6630,6795,6421,44554
08810,8640,8638,8905,9163,9108,8994,8401,61849
08812,14430,14473,14435,14330,14327,14238,14296,100529
08816,47103,47056,46670,46550,46298,46074,46298,326049
08817,44730,44374,44807,44646,45510,45474,44621,314162
08820,40426,40934,39679,39878,38759,38447,39590,277713
08821,362,265,160,289,424,409,354,2263
08822,30669,30975,31020,30430,30228,30249,30354,213925
08823,9628,9430,9401,9096,8649,8534,9016,63754
08824,12788,12720,12721,12175,11778,11581,12115,85878
08825,4591,4340,4413,4528,4591,4263,4707,31433
08826,5553,5529,5575,5771,5664,5533,5838,39463
08827,4171,4280,4107,4185,4468,4653,4629,30493
08828,2314,2350,2390,2360,2235,2142,2178,15969
08829,3632,3651,3692,3694,3684,3679,3725,25757
08830,19009,18502,18021,18559,18584,18479,18459,129613
08831,49399,48737,47706,46818,45793,44633,45620,328706
08832,2354,2270,2317,2580,2793,3002,2863,18179
08833,8105,8958,8890,9039,8844,9029,8796,61661
08835,10448,10454,10426,10400,10358,10369,10344,72799
08836,3827,3835,3868,3767,3685,3886,3845,26713
08837,16728,16557,16601,16030,15880,15938,15847,113581
08840,16411,16502,16592,16535,16391,16438,16558,115427
08844,39653,39600,39365,38907,38425,38231,38367,272548
08846,13811,13831,13766,13703,13661,13666,13635,96073
08848,8354,8154,8359,8371,8536,8738,8435,58947
08850,8804,8723,8484,8274,8289,8263,8281,59118
08852,17906,18177,17242,17233,17217,16967,17220,121962
08853,5247,5294,5344,5542,5522,5298,5247,37494
08854,57432,57348,57600,56874,56202,55477,55961,396894
08857,40628,40369,40466,40271,39970,39129,39898,280731
08858,144,30,102,170,133,174,144,897
08859,21806,21418,21184,21594,21646,22499,21526,151673
08861,54390,54546,54176,53415,53143,52235,53099,375004
08863,12739,12492,12362,12342,12129,12403,12320,86787
08865,29263,29479,29610,29824,29922,29731,29840,207669
08867,5147,5275,5398,5436,4939,4407,5042,35644
08869,7539,7328,7318,7058,6968,6849,6881,49941
08872,20293,20416,20639,20041,19723,19517,18811,139440
08873,53094,52629,51722,51048,50554,49365,49921,358333
08876,22369,22348,22341,22268,22026,22561,22179,156092
08879,23343,23419,22885,22974,22279,21411,23537,159848
08880,4613,4612,4585,4584,4653,4555,4563,32165
08882,16244,16274,16177,16079,15992,15938,16008,112712
08884,8418,8413,8359,8309,8283,8218,8257,58257
08886,7111,6918,6826,7071,7042,7274,7077,49319
08887,1124,1144,1022,1079,957,875,1106,7307
08889,9928,9757,9831,9934,10055,9602,10063,69170
08890,0,0,0,0,0,0,17,17
08901,57585,57280,56016,55476,55189,54537,55223,391306
08902,41755,41825,42245,41774,41153,40737,41153,290642
08904,14245,14263,14224,14136,14074,13999,13982,98923
10001,23332,23537,22767,21966,20579,21097,21102,154380
10002,78096,80736,79894,82191,80323,81335,81410,563985
10003,56767,57112,57068,57310,56614,55190,56024,396085
10004,3044,3221,3024,2807,2780,2604,3089,20569
10005,8710,8131,7570,6822,5724,4935,7135,49027
10006,3277,3110,2950,2507,2696,2722,3011,20273
10007,6740,6876,6748,6525,6188,5892,6988,45957
10009,59799,60865,61806,62810,62397,62335,61347,431359
10010,32854,31447,30708,30670,29396,28954,31834,215863
10011,50404,52349,52941,52167,51853,51064,50984,361762
10012,24536,24163,24846,26145,24703,24342,24090,172825
10013,28211,27415,26937,26065,26090,25942,27700,188360
10014,31464,30727,31835,30597,30893,31685,31959,219160
10016,50444,50641,50112,51196,52624,53754,54183,362954
10017,16533,16472,16278,16129,16137,15603,16575,113727
10018,9684,9168,8062,7021,6147,5290,5229,50601
10019,39505,38830,38752,38394,40351,40778,42870,279480
10020,0,0,0,0,0,0,0,0
10021,45261,43573,42142,40862,42646,41546,43631,299661
10022,30262,30607,29699,29618,29317,28847,31924,210274
10023,60307,60586,60762,61315,60447,60035,60998,424450
10024,58516,58391,59249,59164,58991,60239,59283,413833
10025,94717,96068,97373,97390,96449,95330,94600,671927
10026,38540,38310,38372,37871,36797,36026,34003,259919
10027,64120,64413,63057,62617,61018,58834,59707,433766
10028,48205,46883,46169,44295,45799,45345,45141,321837
10029,79411,79251,77857,77454,79031,78451,76003,547458
10030,30358,29209,29530,28472,29364,29186,26999,203118
10031,60778,59244,58912,59092,59708,58736,56438,412908
10032,63189,62685,59069,59374,61650,62798,57331,426096
10033,59353,59844,60520,58710,57073,58027,53926,407453
10034,43951,43405,42672,41510,41200,40925,38908,292571
10035,34187,33920,34760,33488,34709,35290,33969,240323
10036,25987,25799,24127,23132,22413,22371,24711,168540
10037,20112,18777,18041,17377,17099,17489,17416,126311
10038,22300,21464,20997,20082,20042,19530,20300,144715
10039,27471,26697,25952,26577,25372,25257,24527,181853
10040,45033,44378,45278,44825,43650,43753,41905,308822
10044,11731,11783,12050,12346,12311,11399,11661,83281
10065,30001,30237,31761,32797,32807,32193,32270,222066
10069,5231,5526,5523,5118,5359,5214,5199,37170
10075,23353,25756,24377,24849,24148,26082,26121,174686
10103,0,0,0,0,0,0,3,3
10110,0,0,1,2,3,4,0,10
10111,0,0,0,0,0,0,0,0
10112,0,0,0,0,0,0,0,0
10115,0,0,0,0,0,0,0,0
10119,0,0,0,0,0,0,92,92
10128,63006,61927,62447,60121,59443,58793,60453,426190
10152,0,0,0,0,0,0,0,0
10153,0,0,0,0,0,0,0,0
10154,0,0,0,0,0,0,0,0
10162,1253,1289,1252,1327,1590,1608,1685,10004
10165,0,0,0,0,0,0,2,2
10167,0,0,0,0,0,0,0,0
10168,0,0,0,0,0,0,0,0
10169,0,0,0,0,0,0,0,0
10170,0,0,0,0,0,0,2,2
10171,0,0,0,0,0,0,0,0
10172,0,0,0,0,0,0,0,0
10173,0,0,0,0,0,0,2,2
10174,0,0,0,0,0,0,0,0
10177,0,0,0,0,0,0,0,0
10199,0,0,0,0,0,0,9,9
10271,0,0,0,0,0,0,0,0
10278,0,0,0,0,0,0,0,0
10279,0,0,0,0,0,0,0,0
10280,9845,9552,8817,8685,7610,7741,7853,60103
10282,5635,5730,5903,6217,5507,5027,4783,38802
10301,39519,39209,39367,38885,38851,39367,39706,274904
10302,17758,18286,18043,16811,17090,17128,19088,124204
10303,24562,23933,24348,24537,24933,26274,26337,174924
10304,42054,42244,41864,43084,41845,40934,42193,294218
10305,41533,41795,41471,42006,41309,40085,41749,289948
10306,55031,54939,54888,55902,55692,55710,55909,388071
10307,15275,15098,15006,14829,14418,14363,14096,103085
10308,30347,29766,29805,28939,28782,29014,27357,204010
10309,33459,33185,33382,32646,31943,30706,32519,227840
10310,24250,24394,24719,25227,24454,24473,24962,172479
10311,0,0,0,0,0,0,0,0
10312,60951,62032,61105,60081,61136,60318,59304,424927
10314,88585,87600,87524,87276,87921,87662,85510,612078
10451,48289,48188,47818,47069,45931,43550,45713,326558
10452,75288,75559,75252,74931,74520,75150,75371,526071
10453,80516,80081,79002,79793,79143,79376,78309,556220
10454,38938,39012,38751,38089,37850,38523,37337,268500
10455,42779,41609,39951,38576,38114,37699,39665,278393
10456,92712,91868,91737,87723,87796,86121,86547,624504
10457,74010,73763,71015,70282,69411,69144,70496,498121
10458,81698,79974,76276,74859,74911,73436,79492,540646
10459,47972,47778,48269,47977,47000,45261,47308,331565
10460,60266,59512,58676,56084,56011,55462,57311,403322
10461,50255,51820,52435,51730,51599,51767,50502,360108
10462,78725,78504,76114,77369,75709,75407,75784,537612
10463,71657,71981,71238,70420,69371,68345,67970,490982
10464,4300,4723,4532,4248,3974,4255,4534,30566
10465,44950,45839,46360,44862,43897,42688,42230,310826
10466,71645,71138,69657,70609,71631,72997,67813,495490
10467,103045,101134,99251,98754,96319,93833,97060,689396
10468,75537,73637,72683,71822,73205,73738,76103,516725
10469,71664,72732,72241,71843,71580,71245,66631,497936
10470,14574,14868,14880,14850,15647,14952,15293,105064
10471,21601,21727,21935,22030,21792,22222,22922,154229
10472,68972,68654,69659,68898,67915,66041,66358,476497
10473,61818,59352,59948,58660,58403,57444,58519,414144
10474,12793,12686,12223,12519,12723,12466,12281,87691
10475,44749,43913,44582,43231,41625,41377,40931,300408
10501,1226,1226,1073,1217,1207,1206,1219,8374
10502,5513,5519,5396,5346,5361,5289,5487,37911
10503,137,168,172,158,263,222,108,1228
10504,7903,7910,7885,7960,8215,7907,7987,55767
10505,905,868,785,638,694,629,851,5370
10506,5963,5453,5303,5448,5158,5340,5790,38455
10507,6859,7004,7039,6801,7006,7287,6408,48404
10509,19419,19218,19605,20209,20148,19931,19507,138037
10510,10423,10428,10391,10166,10671,10336,9988,72403
10511,2263,2236,2349,2260,2354,2427,2246,16135
10512,25076,24845,25467,24778,24960,25079,25590,175795
10514,12688,12741,12915,13256,12604,12469,11946,88619
10516,5486,5474,5327,5223,5205,5214,5289,37218
10517,584,608,756,622,679,474,539,4262
10518,1478,1502,1505,1390,1561,1424,1268,10128
10519,137,207,181,166,126,109,316,1242
10520,12797,12996,13107,13113,13159,13267,12810,91249
10522,11058,11055,11001,10948,10889,10831,10875,76657
10523,9058,8752,8563,8029,7789,7687,7444,57322
10524,4268,4252,4402,4488,4482,4460,4421,30773
10526,1522,1662,1714,1571,1738,1979,1809,11995
10527,836,877,1156,1145,1221,1144,908,7287
10528,13066,12451,12720,12692,13209,13358,12280,89776
10530,12800,13011,12431,11891,11947,11796,12604,86480
10532,5019,4945,4906,5074,5071,5028,4931,34974
10533,7590,7487,7484,7662,7406,7419,7322,52370
10535,685,717,573,796,800,748,555,4874
10536,10775,11022,10725,10719,10840,10204,10739,75024
10537,1541,1842,1952,2242,2239,2463,2416,14695
10538,16718,16841,16803,16673,16699,16972,16597,117303
10541,26371,26850,26355,26643,26647,26328,26339,185533
10543,20643,20516,20250,20157,20040,19922,20135,141663
10545,131,129,135,126,114,111,141,887
10546,1433,1265,1149,1092,1275,1244,1277,8735
10547,7461,7045,6913,7421,7937,8171,7647,52595
10548,3398,3156,3214,3089,2910,3174,3487,22428
10549,16557,16353,16165,15798,15560,15475,16638,112546
10550,37679,37543,37421,36804,36938,36523,37144,260052
10552,19620,19607,20339,20815,20259,20116,19786,140542
10553,10606,10850,10032,9895,10141,10507,10170,72201
10560,4930,4810,4742,4786,4812,4819,4737,33636
10562,31745,31453,31453,31502,31239,31348,31796,220536
10566,23977,23928,23875,23702,23568,23392,23570,166012
10567,20652,20741,20197,20241,20083,19743,19929,141586
10570,12966,12889,12592,12735,12623,12501,12680,88986
10573,38958,38817,38656,38429,38237,38017,38352,269466
10576,4878,4803,4842,4948,4996,5261,5116,34844
10577,6508,6486,6269,5823,5391,4623,6552,41652
10578,843,714,589,534,665,773,681,4799
10579,9438,9192,9264,8969,9071,8741,8675,63350
10580,17270,17358,17322,17241,17342,17210,17208,120951
10583,40054,39996,39510,39601,39210,38204,38982,275557
10588,2748,2723,2518,2389,2090,1883,2282,16633
10589,9229,9102,9376,9158,8403,8348,8475,62091
10590,6937,7111,7026,6926,6632,6601,6767,48000
10591,23394,23185,23037,22890,22722,22548,22540,160316
10594,5076,5172,5201,5020,5114,5083,5117,35783
10595,8237,8369,8577,8407,8016,8071,8195,57872
10596,1727,1657,1629,1270,1152,799,1729,9963
10597,1154,1058,1128,1233,1138,954,968,7633
10598,29489,30030,29699,29234,28624,28717,28647,204440
10601,11519,11787,11524,10623,10113,10160,11376,77102
10603,17429,17223,17924,18142,17914,18138,17045,123815
10604,11153,11808,11397,11863,11607,11737,11250,80815
10605,17470,18118,17671,18337,18368,18778,18126,126868
10606,18312,17489,17293,16632,16410,15657,16499,118292
10607,6806,6307,6727,7098,6854,6903,6824,47519
10701,58841,59884,59628,61167,62396,62939,63393,428248
10703,21039,20856,20894,20390,20261,20367,20301,144108
10704,32125,31321,31198,30516,30432,29807,30165,215564
10705,41008,40392,39817,39924,38654,38142,38777,276714
10706,8776,8713,8734,8555,8549,8698,8679,60704
10707,10253,10653,10525,10479,10461,10330,10097,72798
10708,22632,22178,22497,21809,21464,21309,21225,153114
10709,9090,9357,9347,9303,9605,9586,9292,65580
10710,27602,27628,27388,26432,25811,25472,25120,185453
10801,42154,41577,41265,41093,40674,40120,40827,287710
10803,12560,12560,12523,12439,12470,12392,12435,87379
10804,14634,14795,14850,15096,15069,15019,14146,103609
10805,18503,18799,18898,18138,17758,17828,18414,128338
10901,23959,23235,23195,22875,23337,23007,23465,163073
10910,27,23,24,26,0,0,21,121
10911,0,0,0,0,0,0,2,2
10913,5626,5302,5657,5175,5277,5245,5532,37814
10914,455,366,421,224,310,287,414,2477
10915,14,104,168,158,158,216,119,937
10916,4265,4238,4374,4446,4468,4518,4540,30849
10917,2134,2030,1959,1808,1790,2134,1968,13823
10918,12264,12258,11700,12043,11766,11480,11647,83158
10919,1331,1405,1647,1346,1312,1149,1040,9230
10920,8877,8946,8682,8744,8648,8385,8554,60836
10921,3856,3861,4138,3926,4094,3926,4135,27936
10922,1568,1347,1406,1355,1165,998,1559,9398
10923,8796,8473,8705,8797,8736,8587,8732,60826
10924,13388,13255,13153,13141,12913,13091,13120,92061
10925,4061,4330,4300,4446,4302,4370,4539,30348
10926,3108,3370,3256,3354,2958,3009,3203,22258
10927,12120,12094,12060,11952,11843,11711,11910,83690
10928,4004,4066,4029,4033,4035,4009,4175,28351
10930,8784,9021,8938,9050,9029,8937,8958,62717
10931,887,926,908,950,988,1024,1023,6706
10932,106,100,33,106,142,71,60,618
10933,927,809,797,819,553,216,473,4594
10940,49194,48651,48512,47833,48209,48800,48418,339617
10941,13242,13301,13572,13959,14006,13585,13779,95444
10950,49712,49065,48838,47611,47742,46739,47226,336933
10952,41631,41891,41619,40193,39271,38285,38917,281807
10953,190,102,123,162,133,152,252,1114
10954,23226,23809,23678,23550,22908,23125,23045,163341
10956,31450,31039,31090,30909,31426,31335,31521,218770
10958,3121,2899,2929,3030,3187,3538,3291,21995
10960,15357,15253,15637,15476,15545,15261,15093,107622
10962,5581,5809,5677,6166,5995,5915,5950,41093
10963,4263,4361,4219,4260,3889,3669,4298,28959
10964,1367,1557,1711,1791,1598,1651,1472,11147
10965,15149,15320,14878,14794,14799,14710,14791,104441
10968,2249,2344,2301,2302,2194,2099,2353,15842
10969,1403,1717,1665,1674,1534,1522,1267,10782
10970,9773,9873,9716,9670,9164,9795,9993,67984
10973,2322,2603,2646,2789,2462,2286,2126,17234
10974,3208,3199,3166,3149,3141,3125,3152,22140
10975,291,297,328,238,305,455,281,2195
10976,2699,2264,2266,2134,2179,2087,2258,15887
10977,63319,62280,60650,60293,59133,57800,59048,422523
10979,283,301,201,174,137,192,234,1522
10980,13997,13860,13746,13440,13620,13330,13383,95376
10983,5674,5649,5727,5537,5522,5528,5532,39169
10984,3020,2880,3117,3317,3485,3282,2842,21943
10985,38,34,14,13,90,115,58,362
10986,1696,1836,1887,2103,1923,2013,1974,13432
10987,3280,3318,3279,3364,3320,3196,3395,23152
10988,711,869,947,819,983,902,896,6127
10989,10333,10033,10113,9868,9757,9934,9293,69331
10990,19678,19647,20029,20139,20526,20598,20631,141248
10992,9197,9048,9324,9839,9716,10460,9621,67205
10993,4996,5326,5069,4678,4559,4587,4769,33984
10994,7652,7490,6931,7206,6963,6861,7085,50188
10996,6612,6830,6892,7013,7286,7570,6756,48959
10998,2824,2736,2699,2759,2818,3082,3122,20040
11001,27650,27551,27156,27001,27104,26905,26883,190250
11003,45480,45406,44907,43739,44016,43910,41356,308814
11004,14722,13778,14045,14500,14178,14050,14016,99289
11005,1926,1947,2123,2055,1963,1797,1806,13617
11010,24539,24791,25054,24394,23800,23790,23821,170189
11020,6285,6378,6120,6370,6139,5975,5914,43181
11021,17856,17378,17478,17467,17449,17544,17729,122901
11023,9825,9953,9955,9870,9400,8954,9027,66984
11024,7790,7667,7789,7555,7784,7853,8002,54440
11030,17642,17505,17295,17372,17854,17914,17962,123544
11040,41381,41434,40799,40231,40005,40296,40782,284928
11042,549,549,542,544,541,534,520,3779
11050,30450,30845,30583,30666,30397,30197,30171,213309
11096,7701,8331,7884,8276,8091,8443,8344,57070
11101,26505,25880,25317,25537,24405,23798,25484,176926
11102,33750,35271,35027,34529,33742,33432,34133,239884
11103,38861,39231,38257,37745,36724,36508,38780,266106
11104,26102,26718,26555,25729,26321,26230,27232,184887
11105,37297,37194,36816,36190,37438,38103,36688,259726
11106,39409,38812,38633,36869,36958,36305,38875,265861
11109,4964,4702,4337,3524,3272,2916,3523,27238
11201,60061,58350,56488,54668,52242,51356,51128,384293
11203,75920,75887,77011,79572,80202,80337,76174,545103
11204,79332,80486,80349,80963,80341,78690,78134,558295
11205,44818,43224,43320,43002,40125,38997,40366,293852
11206,86486,84806,83180,81525,80086,79674,81677,577434
11207,93251,94657,93465,92491,92054,89676,93386,648980
11208,95715,93847,92262,93107,93998,93447,94469,656845
11209,67822,70803,72582,72623,72434,71704,68853,496821
11210,68435,67432,67042,65302,64041,64508,62008,458768
11211,99964,97772,94681,93271,90510,90522,90117,656837
11212,86469,88668,87751,84520,81267,80311,84500,593486
11213,65434,64603,62756,62059,61495,62231,63767,442345
11214,91728,91295,88297,83156,81428,78326,88630,602860
11215,69965,70818,70156,68891,67195,65477,63488,475990
11216,55816,53747,54440,53783,53662,53065,54316,378829
11217,38670,38511,38567,38787,38398,38992,35881,267806
11218,74831,75691,75132,74758,74571,76811,75220,527014
11219,96287,97670,98719,96971,95069,94083,92221,671020
11220,101006,102325,101715,103089,100476,99540,99598,707749
11221,84034,83372,83773,81321,80254,77041,78895,568690
11222,35695,35163,34580,34186,33718,33482,36934,243758
11223,79730,79385,76651,74606,74700,73208,78731,537011
11224,43444,43001,42698,42535,44047,45092,47621,308438
11225,60323,60180,59613,59182,60179,58987,56829,415293
11226,101787,99026,98299,98325,99285,99422,101572,697716
11228,46164,47190,46059,43929,43396,42585,41788,311111
11229,82914,81732,81351,81030,79268,77021,80018,563334
11230,88933,88589,87064,84219,84707,85757,86408,605677
11231,36302,35263,34605,34137,34393,35109,33336,243145
11232,29387,29216,29452,28824,28703,27925,28265,201772
11233,72159,71589,69637,68599,67661,66315,67053,483013
11234,95546,95912,95610,94259,95390,94891,87757,659365
11235,78237,76668,75622,74630,72447,71129,79132,527865
11236,100049,98276,97714,97217,97084,94643,93877,678860
11237,53678,54182,55258,55478,53031,52123,49896,373646
11238,53992,52999,51959,51895,52033,50840,49262,362980
11239,12468,12924,12943,12879,12850,12802,13393,90259
11351,0,0,0,0,0,0,0,0
11354,58551,56908,56433,56258,55543,53050,54878,391621
11355,82028,82790,83799,83221,83938,82505,85871,584152
11356,24405,24631,23800,23037,22947,21721,23438,163979
11357,39259,39737,40588,40872,40705,40516,39150,280827
11358,37461,37486,37634,38317,39143,38668,37546,266255
11359,0,0,0,0,0,0,0,0
11360,19309,19605,19916,19865,20688,20953,18884,139220
11361,29322,30207,30352,30597,29197,28926,28606,207207
11362,18198,18139,17897,17865,18220,17492,17823,125634
11363,7577,7662,7625,7354,7442,7052,6988,51700
11364,35068,34949,34902,34751,35106,35372,34555,244703
11365,44617,45041,43138,41924,41520,41283,42252,299775
11366,14042,13192,13146,13499,13593,14160,13532,95164
11367,42663,42667,41582,41022,39424,38835,41047,287240
11368,112982,112709,110385,107962,104486,103401,109931,761856
11369,37823,39001,39862,40761,40160,39677,38615,275899
11370,34445,35507,36271,37244,37755,38370,39688,259280
11371,0,0,0,0,0,0,0,0
11372,64109,64754,63202,63320,62857,63520,66636,448398
11373,96616,98554,100713,99159,97430,96474,100820,689766
11374,43158,43399,41792,42297,42484,42888,43600,299618
11375,71159,70723,69652,69757,69745,69266,68733,489035
11377,90883,90615,88939,86316,87284,87143,89830,621010
11378,33270,31756,30854,32268,32187,33672,34981,228988
11379,36082,35476,35725,35822,35680,34529,34821,248135
11385,103372,102209,100132,99379,99508,99295,98592,702487
11411,19300,19208,19177,18722,19357,20426,18556,134746
11412,37802,37832,37690,37176,36660,36932,34882,258974
11413,42699,42560,41689,40385,39291,39922,38912,285458
11414,28247,28700,28742,28094,28769,28480,26148,197180
11415,19308,19403,19020,19145,19464,18677,19341,134358
11416,27144,26625,25973,25950,24977,23852,24861,179382
11417,31742,32415,31556,31004,30325,29928,28967,215937
11418,39908,39308,36751,36828,36821,36005,36256,261877
11419,51642,49306,48370,49193,48119,48138,47211,341979
11420,50549,50820,50162,48449,48226,47243,44354,339803
11421,43341,43024,42745,42588,41872,40975,39127,293672
11422,33408,33245,32589,33280,33116,31739,30425,227802
11423,31823,31982,32053,31625,31425,30890,29987,219785
11424,0,0,0,0,0,0,0,0
11425,0,0,0,0,0,0,0,0
11426,19991,19842,19348,19575,18847,19165,17590,134358
11427,22941,23568,23460,24877,24601,24385,23593,167425
11428,19736,19744,20461,20307,19784,19764,19168,138964
11429,26739,26362,27506,28311,28571,29167,25105,191761
11430,179,186,171,140,101,53,184,1014
11432,64686,63533,62395,61687,58705,56900,60809,428715
11433,34703,34111,37927,32821,30851,30076,32687,233176
11434,66279,65892,65255,62809,61853,61183,59129,442400
11435,57627,55323,54523,53542,52288,52358,53687,379348
11436,20136,19425,18609,17636,17316,16956,17949,128027
11451,0,0,0,0,0,0,0,0
11501,19262,19241,19155,18991,18982,18981,19148,133760
11507,7330,7430,7224,6998,7215,7751,7406,51354
11509,2329,2174,2232,2022,2159,2250,2653,15819
11510,33734,33473,33430,32553,33152,32234,33048,231624
11514,4543,4913,5197,5273,5332,5395,4673,35326
11516,7724,7742,7513,7477,7486,7479,7556,52977
11518,10192,10278,10065,10243,10307,10610,10549,72244
11520,43697,43795,43632,43472,43246,43168,43341,304351
11530,28463,28663,28155,28019,27982,27835,27273,196390
11542,27676,27849,27691,27585,27530,27459,27633,193423
11545,12694,12426,12653,13005,13070,11962,12065,87875
11547,837,741,797,718,655,566,793,5107
11548,2858,2407,2328,2338,2347,2301,2780,17359
11549,2920,2864,2337,2429,2567,2740,2922,18779
11550,57679,57352,57224,56773,56347,56045,56435,397855
11552,24417,23672,22949,22565,22872,22975,23616,163066
11553,26160,26158,26506,26231,26430,26032,26034,183551
11554,37228,37836,37513,37687,38126,37390,38132,263912
11556,14,14,0,0,0,0,17,45
11557,6972,6590,7364,7538,7214,8047,7823,51548
11558,8323,8449,8646,8688,8456,8485,8370,59417
11559,8709,8403,8402,8188,8020,7931,8176,57829
11560,6354,6284,6334,6534,6628,6501,6464,45099
11561,37544,37458,37599,37894,37881,37370,37280,263026
11563,22551,22985,22984,23177,22953,22453,22666,159769
11565,8640,8677,8820,8752,8779,8909,8690,61267
11566,34232,33356,33791,33582,33980,34081,35321,238343
11568,4578,4356,4240,4000,3858,3802,4555,29389
11569,1229,1342,1284,1309,1225,1459,1398,9246
11570,27463,27819,27896,27235,26870,26917,26646,190846
11572,29295,28763,28901,28627,29540,29210,30574,204910
11575,16564,16386,16674,16200,16408,15677,16272,114181
11576,12663,12471,12325,12524,12060,12190,12366,86599
11577,12888,12444,12788,12541,12511,12230,12337,87739
11579,5128,5052,5336,5369,5265,5290,5055,36495
11580,43219,42765,41525,41129,40500,40441,40113,289692
11581,21406,21579,20956,21134,20553,20129,20844,146601
11590,47134,46938,45972,45656,44977,43599,45768,320044
11596,10683,10636,10638,10582,10517,10412,10480,73948
11598,13478,12874,12927,13167,12972,12896,13328,91642
11691,64946,63989,62577,61091,61442,59376,60035,433456
11692,19403,18955,17970,17674,16870,17070,18540,126482
11693,12021,11194,11338,11335,11415,11407,11916,80626
11694,21219,20773,21507,21725,21281,20792,20408,147705
11697,3928,4006,4078,4223,4344,4381,4079,29039
11701,28139,27031,27423,27536,26349,27198,27109,190785
11702,13906,13979,14512,14706,15255,15372,14498,102228
11703,16508,16378,16249,15954,16075,15852,16415,113431
11704,40257,39479,40685,40617,40968,41127,40222,283355
11705,7499,7529,7571,7726,7859,7976,8030,54190
11706,67959,67001,65865,65821,66314,65982,62543,461485
11709,6745,6724,6724,6701,6690,6689,6669,46942
11710,33525,34530,35151,35345,34467,34735,34496,242249
11713,9176,9170,9530,9328,9648,10122,10401,67375
11714,21438,22849,23313,23799,23447,23873,22658,161377
11715,4463,4528,4335,4441,4417,4610,4752,31546
11716,9998,10643,11134,11336,10953,10951,10700,75715
11717,61568,61420,59449,57375,57011,56154,60745,413722
11718,3092,3102,3117,3105,3122,3121,3103,21762
11719,3787,3141,3372,3290,2940,2816,3589,22935
11720,28823,29167,29374,29931,29603,30407,29189,206494
11721,5995,6255,6482,6369,6503,6577,6292,44473
11722,35668,35855,37181,38241,38140,37919,35177,258181
11724,3243,2943,2853,2846,2616,3013,3220,20734
11725,29444,28997,28646,28602,29199,28927,29150,202965
11726,21688,21826,21102,20233,19600,19091,19857,143397
11727,30282,29902,29987,29056,28126,28496,29030,204879
11729,27311,27602,27409,27562,28149,27948,28032,194013
11730,14168,14066,14204,13921,14126,13643,14712,98840
11731,29743,29543,28969,29173,29959,30562,30184,208133
11732,3856,3715,3671,3469,3443,3188,3430,24772
11733,17136,17366,17065,17788,18236,18259,18949,124799
11735,33596,33195,32499,32502,32221,32226,32098,228337
11738,17067,17311,17643,18131,18559,17956,17638,124305
11739,1119,1297,1421,1467,1473,1556,1223,9556
11740,8953,9346,9507,9459,9478,9262,9454,65459
11741,27243,28443,28651,27688,27747,27551,27655,194978
11742,13132,13164,13229,13404,12979,12724,13261,91893
11743,42531,42848,43533,43611,42887,42639,42230,300279
11746,70005,69761,68580,67412,67290,66584,67094,476726
11747,19061,19194,19793,20214,19806,19676,19803,137547
11749,3349,3370,3346,3431,3406,3389,3345,23636
11751,14313,14462,14679,14293,14152,14393,14961,101253
11752,9456,9521,9351,9367,9184,9649,9531,66059
11753,12015,11753,11657,11748,11786,11777,12014,82750
11754,18357,19293,19201,19110,19368,19162,18958,133449
11755,12430,12400,12329,12222,12263,12082,12387,86113
11756,42654,42163,42321,42817,43510,43478,42791,299734
11757,44701,45682,44923,45565,45623,45298,45700,317492
11758,54929,55594,55900,55009,54795,54699,53804,384730
11762,22951,22943,23053,22431,22326,22221,22360,158285
11763,28654,29793,29217,29495,30422,29448,28506,205535
11764,13030,12389,12969,12846,13280,13420,13200,91134
11765,750,753,745,654,586,536,737,4761
11766,12478,12723,12718,11887,11976,11781,12635,86198
11767,15347,15145,15259,15341,15081,14572,14530,105275
11768,21375,21532,21687,21735,21808,21859,21902,151898
11769,8686,8592,8716,8592,8673,9022,9506,61787
11770,65,95,102,199,235,238,137,1071
11771,9458,9577,9344,8981,9449,9228,10007,66044
11772,45243,45420,45262,45265,45435,44623,44837,316085
11776,26327,26171,25675,25969,26308,24059,24235,178744
11777,8958,9129,9448,9351,9453,9496,8968,64803
11778,12354,12339,12747,12605,12354,12455,12709,87563
11779,38084,37939,38733,39094,39176,39237,38421,270684
11780,15609,15551,15099,14676,14733,14826,15524,106018
11782,15346,15491,15045,15132,15200,14948,15814,106976
11783,21823,21598,21170,21145,21131,21115,21288,149270
11784,26230,26455,26312,26158,25611,25194,24655,180615
11786,6017,6180,6550,6378,6273,6280,6344,44022
11787,36040,35813,36357,36606,35969,36425,35772,252982
11788,16007,16199,16167,16598,16333,16672,16821,114797
11789,8202,8221,7659,7935,7506,7707,7895,55125
11790,18365,18840,18627,18073,17672,18210,18511,128298
11791,25404,25291,25213,25639,25240,25816,25076,177679
11792,8807,8964,8941,9303,9309,9602,8523,63449
11793,31642,32164,32710,32348,31898,32178,32298,225238
11794,2983,3081,3317,3080,3150,2909,3165,21685
11795,25301,25074,25536,25821,25709,25811,26030,179282
11796,4065,3961,4012,3939,3758,3611,4056,27402
11797,8665,8574,8645,8796,8789,9001,9041,61511
11798,14242,15599,15362,14920,15025,15031,15347,105526
11801,40713,40274,39805,39653,38777,38257,39553,277032
11803,28231,28390,28445,28448,28133,28038,28127,197812
11804,4688,4757,5000,4921,4973,5081,5010,34430
11901,29688,30680,30631,29579,27934,26622,27172,202306
11930,1244,1459,1565,1201,1255,1193,1343,9260
11931,34,34,36,51,21,46,151,373
11932,914,890,1008,933,895,832,1398,6870
11933,7386,6238,6358,6391,7530,6540,6844,47287
11934,8079,8043,7929,7425,7751,7810,7263,54300
11935,3186,3218,3263,3271,3332,3604,3304,23178
11937,15757,15526,15446,15794,15511,15729,15398,109161
11939,911,915,932,1012,1197,1340,926,7233
11940,5186,5352,4982,5019,4933,4923,5210,35605
11941,2053,2043,1929,1799,1822,1712,1986,13344
11942,4501,4253,4092,4501,4597,4842,4603,31389
11944,4208,4268,4338,4277,4286,4088,4299,29764
11946,13693,13569,13312,13297,13997,14381,14068,96317
11947,105,114,138,114,150,121,416,1158
11948,1191,1340,1315,1164,995,735,1123,7863
11949,15092,14724,14340,14241,13539,13852,14573,100361
11950,16324,16777,16969,17712,16394,15752,16268,116196
11951,13959,13364,13401,14048,13110,13639,13680,95201
11952,4831,4591,4518,4659,4411,4612,4637,32259
11953,13305,12647,12688,12302,12258,12581,13553,89334
11954,3510,3495,3471,3471,3559,3296,3326,24128
11955,3294,3168,2780,2789,2814,2981,3285,21111
11956,250,310,298,329,313,288,349,2137
11957,717,706,713,714,661,650,743,4904
11958,531,441,366,262,441,454,635,3130
11959,815,856,877,766,677,656,939,5586
11960,490,597,744,878,878,963,1084,5634
11961,12850,12164,12041,11906,11811,11982,12834,85588
11962,491,415,452,469,447,214,494,2982
11963,6710,6913,6811,6602,6737,6516,6622,46911
11964,2263,2162,2048,1846,1960,1633,1858,13770
11965,581,650,621,631,664,824,534,4505
11967,26107,26845,27115,26488,26818,27031,26583,186987
11968,10702,10821,10718,11245,11658,12103,11593,78840
11970,111,284,466,505,600,846,522,3334
11971,6327,6348,6376,6317,6057,5851,5818,43094
11972,1355,1054,1295,1112,900,817,1321,7854
11973,41,46,40,33,26,19,9,214
11975,308,386,359,359,330,351,408,2501
11976,2344,2350,2301,1934,1870,1804,1565,14168
11977,2148,2456,2570,2271,2568,2559,2467,17039
11978,3122,3124,2963,3233,3150,3208,3255,22055
11980,5620,5273,4856,4756,4878,4994,4990,35367
12007,0,17,33,97,88,84,60,379
12008,570,606,480,485,544,520,497,3702
12009,8073,7560,7264,7327,7469,7073,7164,51930
12010,28787,28793,28926,28802,28711,29192,28937,202148
12015,3013,2823,2789,2804,3062,3317,3010,20818
12017,340,323,332,310,310,386,435,2436
12018,7466,7383,7919,7608,7353,7571,7930,53230
12019,14336,14584,14893,14841,15125,14821,14740,103340
12020,33044,32574,31729,31403,30796,30403,31192,221141
12022,819,860,944,1002,964,929,929,6447
12023,2133,2123,2120,2071,2262,2219,2196,15124
12024,23,92,94,102,103,59,31,504
12025,5456,5271,5471,5464,5635,5470,5505,38272
12027,3901,3762,3731,3816,3610,3885,3882,26587
12028,924,951,1024,970,1437,1318,1172,7796
12029,1114,1122,1105,1127,1196,1253,1113,8030
12031,184,153,114,139,139,130,175,1034
12032,818,824,836,795,811,774,836,5694
12033,7885,8002,7886,7824,8226,8020,7851,55694
12035,793,859,798,727,732,564,802,5275
12036,284,196,202,220,164,236,228,1530
12037,4288,4185,4416,4288,4344,4580,4015,30116
12040,146,146,132,97,81,72,113,787
12041,453,499,500,352,359,414,481,3058
12042,159,179,158,236,370,417,271,1790
12043,8435,8444,8396,8390,8443,8595,8509,59212
12045,343,329,325,326,539,444,584,2890
12046,966,855,772,907,891,973,817,6181
12047,20363,19837,20086,20102,19590,19571,19664,139213
12051,6432,6709,7030,7081,7291,7414,7070,49027
12052,1560,1524,1477,1451,1297,1384,1568,10261
12053,4828,4559,4605,4223,3825,4059,4587,30686
12054,17177,17318,17139,16810,16934,17123,16918,119419
12056,2400,2471,2319,2446,2538,2283,2310,16767
12057,2115,2056,2130,2189,2059,2225,1835,14609
12058,1668,1956,1586,1276,1218,1287,1445,10436
12059,1611,1658,1698,1555,1495,1627,1632,11276
12060,1396,1373,1324,1503,1372,1327,1507,9802
12061,9969,9929,9747,9537,9774,8997,9050,67003
12062,1736,1701,1677,1481,1555,1502,1776,11428
12063,495,334,479,425,441,395,444,3013
12064,410,339,392,336,481,534,563,3055
12065,43206,42725,42249,42069,41720,41038,41776,294783
12066,1876,2094,2120,2212,2795,2888,2143,16128
12067,1531,1594,1551,1574,1514,1539,1506,10809
12068,2993,2985,3006,3068,3229,3240,3201,21722
12069,179,174,147,180,284,315,256,1535
12070,1578,1683,1607,1521,1619,1670,1410,11088
12071,364,247,255,209,230,232,270,1807
12072,2843,2624,2697,2797,2778,2675,2890,19304
12074,2694,2762,2849,3109,2896,2980,2963,20253
12075,2886,3155,3120,3034,2862,2987,3418,21462
12076,1506,1568,1582,1518,1458,1449,1500,10581
12077,6579,6450,6481,6580,6148,5643,6246,44127
12078,23554,23737,24072,23696,23634,23887,23773,166353
12083,3673,3594,3639,3736,3670,3742,3795,25849
12084,4740,4834,4281,4429,4361,4546,4271,31462
12085,520,601,507,523,492,475,479,3597
12086,1587,1723,1503,1410,1560,1399,1865,11047
12087,1084,1019,886,804,1037,1124,1073,7027
12089,128,125,140,80,78,38,69,658
12090,6262,6273,6175,6127,5894,6068,6262,43061
12092,721,735,884,904,896,1132,1304,6576
12093,1743,1752,1812,1798,1755,1766,1666,12292
12094,2481,2656,2550,2285,1841,1746,2268,15827
12095,12370,12351,12166,12515,12504,12324,12606,86836
12106,2432,2213,2380,2309,2321,2186,2193,16034
12108,307,411,445,370,290,342,416,2581
12110,22471,22550,21837,21244,21331,22017,21908,153358
12115,225,215,304,237,242,212,189,1624
12116,1901,1974,1949,1923,1765,1679,1920,13111
12117,3492,3566,3426,3519,3405,3244,3256,23908
12118,14195,14045,14569,14204,14632,14578,13897,100120
12120,535,614,700,723,813,805,613,4803
12121,1854,1781,1739,2031,1976,2033,1916,13330
12122,4562,4586,4372,4498,4491,4673,4582,31764
12123,5159,5187,5293,5502,5103,5273,5124,36641
12124,615,623,718,767,627,593,606,4549
12125,1491,1492,1434,1451,1427,1294,1373,9962
12130,970,988,1025,1157,1254,1287,987,7668
12131,135,141,114,117,89,73,115,784
12132,319,317,235,246,196,243,338,1894
12134,3714,3656,3736,3610,3631,3746,3516,25609
12136,716,847,682,652,663,763,804,5127
12137,1904,1825,1901,1813,1549,1783,1679,12454
12138,3327,3442,3247,3199,3286,3237,3168,22906
12139,278,286,226,141,151,121,295,1498
12140,1464,1510,1461,1721,1777,1690,1702,11325
12143,4790,5035,5104,5026,5067,5079,5137,35238
12144,19622,20267,20244,20447,19941,20404,20555,141480
12147,591,516,603,565,472,449,499,3695
12148,4449,4629,4428,4322,4384,4524,4569,31305
12149,2425,2440,2415,2478,2480,2529,2474,17241
12150,890,774,842,779,736,732,914,5667
12151,660,762,684,594,559,572,708,4539
12153,1038,914,786,1005,1189,976,814,6722
12154,2639,2823,2961,2838,2658,2730,2818,19467
12155,1980,1962,1934,1938,2150,2069,1977,14010
12156,1132,1175,955,933,796,862,848,6701
12157,3951,3993,4272,4631,4638,4305,4061,29851
12158,7090,6915,6775,6531,6354,6434,6309,46408
12159,7968,8009,7878,7973,7882,7960,7896,55566
12160,946,907,1058,1095,953,947,944,6850
12161,77,91,87,159,302,310,160,1186
12164,417,374,370,353,313,338,365,2530
12165,156,131,188,173,160,164,175,1147
12166,1250,1347,1314,1368,1353,1370,1363,9365
12167,2946,2878,2561,2577,2580,2498,2438,18478
12168,2054,1910,1937,1748,1929,2138,1952,13668
12169,219,401,346,270,246,210,306,1998
12170,4915,5089,4894,5311,5073,5274,4945,35501
12172,294,328,310,387,249,219,405,2192
12173,1816,1735,1731,1592,1710,1753,1753,12090
12174,322,299,251,272,255,405,345,2149
12175,573,636,770,861,895,1010,797,5542
12176,294,426,385,391,419,416,198,2529
12177,420,463,596,560,505,438,518,3500
12180,53168,52928,53218,53812,54011,53951,53606,374694
12182,14955,15162,14937,14260,14534,14451,14733,103032
12183,2613,2629,2612,2609,2603,2587,2620,18273
12184,6800,6893,6851,6867,6897,6702,7148,48158
12185,2404,2009,2180,2236,2485,2815,2037,16166
12186,6407,6382,6266,6346,6331,6238,6277,44247
12187,391,432,522,413,420,377,697,3252
12188,10944,11193,11138,11249,11126,11202,10980,77832
12189,17749,17915,17675,17860,17365,17074,17568,123206
12190,1028,1081,856,718,663,706,674,5726
12192,2018,1845,2089,2145,1875,1643,1722,13337
12193,1945,1919,1915,1784,1753,1908,2016,13240
12194,138,156,155,152,147,158,207,1113
12195,170,157,175,170,194,252,154,1272
12196,3522,3390,3214,3392,3373,3265,3031,23187
12197,2265,2290,2560,2662,2431,2414,2233,16855
12198,8307,7844,7723,7994,7700,7580,7903,55051
12202,9076,8928,9066,9024,9079,9161,9628,63962
12203,30625,30518,30926,30505,30078,29441,29952,212045
12204,7196,7336,7277,7102,7205,7422,7349,50887
12205,27196,27382,27395,27097,27575,27666,26977,191288
12206,15591,15316,15757,16885,17170,17596,16395,114710
12207,1417,1609,1506,1879,1792,1874,1948,12025
12208,21898,22043,21417,21327,21398,21387,20702,150172
12209,11742,12381,11844,10913,10830,10005,10121,77836
12210,9005,8428,9147,9079,8992,9725,10158,64534
12211,11401,11053,11503,12054,11840,11733,11303,80887
12222,6217,6124,5966,5983,5995,5948,6489,42722
12302,27560,27582,27809,27723,27672,27378,27582,193306
12303,29130,29200,29906,30276,30294,29785,29857,208448
12304,23964,23803,22537,21708,21600,21023,21482,156117
12305,4883,4931,4923,5389,5090,4612,5716,35544
12306,25098,25561,25494,25785,26371,26698,25636,180643
12307,6615,6962,6951,7619,7018,6380,7692,49237
12308,14575,14261,15187,14401,14749,16054,15335,104562
12309,29912,29946,29992,29419,29656,29199,29343,207467
12401,34661,34729,34752,34844,35043,35777,35040,244846
12404,3576,3519,3835,3435,3127,3397,3385,24274
12405,559,651,558,502,451,370,780,3871
12406,945,789,729,707,635,602,823,5230
12407,164,162,137,179,165,140,173,1120
12409,700,693,673,537,500,528,804,4435
12410,504,594,696,672,558,449,397,3870
12411,355,511,475,487,436,398,497,3159
12412,520,532,574,372,522,630,673,3823
12413,2910,2627,2645,2802,2912,2857,2948,19701
12414,10193,10454,10463,10706,10498,10451,10510,73275
12416,168,127,62,254,339,346,277,1573
12417,614,757,762,757,652,543,581,4666
12418,439,482,408,388,319,387,537,2960
12419,641,554,446,548,451,549,722,3911
12420,424,497,569,413,506,545,363,3317
12421,324,349,411,489,528,511,470,3082
12422,353,359,244,252,276,215,339,2038
12423,1109,1028,1016,1095,1224,1285,1097,7854
12424,225,280,246,257,295,291,250,1844
12427,593,653,620,632,531,435,576,4040
12428,6860,6620,6709,6612,6541,6631,6602,46575
12429,334,149,128,273,360,300,281,1825
12430,1036,1069,1034,973,1110,1177,1194,7593
12431,1272,1416,1338,1379,1466,1305,1381,9557
12432,615,593,530,387,491,365,492,3473
12433,543,486,493,404,441,487,483,3337
12434,550,576,515,551,595,675,751,4213
12435,366,354,274,279,280,328,326,2207
12436,233,348,500,478,491,611,417,3078
12438,52,75,55,51,34,33,59,359
12439,333,345,303,222,154,102,305,1764
12440,2127,2209,2008,1999,2157,2001,1980,14481
12441,30,33,34,33,76,67,114,387
12442,667,630,881,885,801,924,953,5741
12443,3674,3620,3710,3743,3643,3889,3825,26104
12444,380,423,386,401,523,579,497,3189
12446,4837,4928,4633,4723,5004,4612,5061,33798
12448,465,429,514,414,488,509,388,3207
12449,3315,3106,3301,3398,3262,3294,3367,23043
12450,170,121,89,204,347,300,183,1414
12451,1861,1762,1986,1878,1960,1602,1674,12723
12452,248,164,237,294,291,317,213,1764
12453,302,202,417,298,390,280,366,2255
12454,301,271,292,227,202,228,297,1818
12455,1877,2090,1978,2128,2077,2039,1988,14177
12456,716,701,690,707,797,800,639,5050
12457,802,865,743,873,1000,836,763,5882
12458,2991,2993,3281,3730,3400,3344,3232,22971
12459,157,151,205,180,136,154,161,1144
12460,344,275,434,306,278,264,277,2178
12461,1811,1822,2088,1976,1949,1946,1634,13226
12463,1398,1074,1006,1042,1049,1169,1484,8222
12464,808,745,963,935,808,890,1020,6169
12465,296,204,238,194,154,218,266,1570
12466,2260,2169,2180,2150,2365,2498,2471,16093
12468,1133,1060,1077,1052,1018,1074,1036,7450
12469,776,755,707,660,683,552,677,4810
12470,474,525,537,743,826,1038,536,4679
12471,495,556,672,667,694,557,215,3856
12472,1419,1685,1646,1749,1645,1774,1572,11490
12473,1126,1199,1363,1271,959,890,861,7669
12474,1250,1357,1467,1497,1464,1408,1162,9605
12475,165,217,240,316,424,382,354,2098
12477,18722,18996,18797,18860,18695,18867,18787,131724
12480,798,807,594,460,580,484,634,4357
12481,1361,1282,1119,1177,1058,960,1356,8313
12482,547,722,729,743,702,787,680,4910
12483,243,336,385,421,405,524,259,2573
12484,2703,2800,2884,3160,3203,2865,2733,20348
12485,1164,1097,822,712,731,664,865,6055
12486,1584,1388,1461,1410,1595,1598,1523,10559
12487,3299,3326,3243,3230,3153,2779,3268,22298
12489,1101,1138,943,844,877,883,1292,7078
12490,31,0,0,67,58,58,110,324
12491,1561,1642,1799,1766,1937,1721,1675,12101
12492,299,364,348,359,336,320,271,2297
12493,310,321,313,198,263,297,495,2197
12494,660,740,662,930,942,1002,764,5700
12495,334,361,294,248,158,268,265,1928
12496,1621,1622,1632,1687,1765,1736,1634,11697
12498,4836,4929,4800,5158,5197,5288,4851,35059
12501,2700,2583,2710,2593,2476,2604,2457,18123
12502,1169,1147,1114,1074,1005,1312,1164,7985
12503,645,783,874,801,781,791,775,5450
12504,1443,1483,1260,1249,1224,1262,1395,9316
12507,253,260,200,197,153,220,167,1450
12508,19604,19614,19742,19917,20459,20140,19880,139356
12512,35,69,129,127,186,205,127,878
12513,511,563,596,541,561,607,651,4030
12514,3184,3213,3273,2835,2690,2804,2938,20937
12515,1307,1351,1284,1242,1209,1295,1549,9237
12516,1913,2198,2168,2109,2023,1578,1833,13822
12517,656,670,631,633,691,588,509,4378
12518,6310,5495,5889,6139,5856,6050,5870,41609
12520,2984,3027,3042,3068,3110,3107,3109,21447
12521,1180,1268,1470,1533,1525,1429,1644,10049
12522,4828,4989,5159,4929,5081,5358,5172,35516
12523,1519,1700,1725,1788,1751,1850,1798,12131
12524,16193,16323,15984,15556,14758,15137,15598,109549
12525,2872,2864,2882,2991,2967,3264,3311,21151
12526,3690,3932,3763,3716,3579,3494,3686,25860
12527,270,93,134,143,337,332,147,1456
12528,13139,13018,13066,13119,12875,12813,13344,91374
12529,2778,2644,2515,2561,2714,3033,2859,19104
12530,107,72,55,8,10,107,124,483
12531,3862,3786,3492,3502,3217,2853,3601,24313
12533,25774,25963,25936,25942,26083,25452,25307,180457
12534,18078,17575,17846,18098,18560,18218,17867,126242
12538,13985,13760,13900,13708,13885,14336,14578,98152
12540,7677,7794,7634,7704,8221,7606,7802,54438
12542,5746,5739,6088,6222,6234,6345,5913,42287
12543,3199,3129,3035,3027,2974,2996,3001,21361
12545,4740,4708,4764,4655,4640,4797,4763,33067
12546,2934,2938,2960,3009,2992,3001,3039,20873
12547,2873,2980,2947,2694,2698,2513,2891,19596
12548,1419,1417,1352,1380,1601,1534,1494,10197
12549,11156,11036,11138,10517,10113,9924,10201,74085
12550,54612,54979,54903,54565,55405,55070,54447,383981
12553,26029,26371,25395,25228,25156,24655,24438,177272
12561,18618,18746,18423,18261,18087,17965,18308,128408
12563,8155,8466,8106,7694,7748,8037,8084,56290
12564,6867,7152,7224,7485,7567,7649,7338,51282
12565,1379,1409,1450,1478,1338,1297,1487,9838
12566,10434,10150,10596,11185,11004,10843,10753,74965
12567,3162,3086,2928,2701,2667,2643,2854,20041
12569,10100,10027,9990,9521,9526,9489,9826,68479
12570,7825,7438,7533,7693,7375,7940,7699,53503
12571,9931,9865,10191,10332,10486,10363,9918,71086
12572,8925,9089,8859,9046,9085,9315,9123,63442
12574,181,219,352,457,365,308,329,2211
12575,1884,1995,1970,1975,2127,1967,2258,14176
12577,1696,1286,1526,1298,1364,1371,2029,10570
12578,2123,2247,2372,2713,2737,2654,2411,17257
12580,4287,4514,4539,4489,4872,4574,4402,31677
12581,2145,1979,1936,2159,2325,2351,2246,15141
12582,6272,5887,6165,6245,6201,6107,6191,43068
12583,2467,2514,2524,2443,2471,2508,2451,17378
12585,901,773,901,953,686,755,885,5854
12586,12729,12744,12035,12705,12520,13140,12540,88413
12589,17463,17840,18005,18031,17873,17529,17228,123969
12590,34400,34957,35148,34962,34368,34203,35102,243140
12592,1150,1212,1196,1282,1524,1322,1486,9172
12594,4380,4294,4180,4427,4287,4221,4275,30064
12601,42555,43209,42608,42522,43400,43883,43398,301575
12603,42943,43015,43411,43802,43043,42604,42810,301628
12604,644,578,660,774,746,722,586,4710
12701,11061,10981,10917,10792,10740,10887,11324,76702
12719,1305,1257,1275,1263,1275,1326,1207,8908
12720,254,187,187,231,77,69,172,1177
12721,6516,6238,5743,5818,5973,5851,6627,42766
12722,101,238,199,150,113,142,158,1101
12723,1921,1918,2090,2196,2195,2141,1826,14287
12724,328,323,368,330,264,275,245,2133
12725,183,208,194,189,237,230,277,1518
12726,1256,1228,1312,1175,986,899,1162,8018
12729,2253,2143,2183,2155,1863,2059,1874,14530
12732,784,788,787,619,551,620,786,4935
12733,1879,1934,1666,1447,1335,1391,1446,11098
12734,1032,976,728,754,840,690,867,5887
12736,96,157,201,161,170,162,118,1065
12737,2074,1969,2062,2169,2181,1983,1910,14348
12738,406,549,650,725,515,568,320,3733
12740,1673,1628,1867,1603,1719,1537,1886,11913
12741,220,247,304,360,352,334,351,2168
12742,73,124,290,321,430,401,181,1820
12743,266,246,252,376,296,385,389,2210
12745,181,197,192,127,161,107,178,1143
12746,1271,1388,1376,1326,1101,925,937,8324
12747,1552,1399,1722,1523,1633,2012,1714,11555
12748,1524,1665,1825,1734,1964,2400,2076,13188
12749,314,321,337,189,206,147,300,1814
12750,276,320,118,72,109,104,187,1186
12751,1121,1286,1154,1083,932,1063,1054,7693
12752,235,221,150,139,228,263,242,1478
12754,6560,6594,6952,7728,7672,7931,7221,50658
12758,4320,4592,4529,4303,4074,4028,4042,29888
12759,1482,1702,1910,2033,2016,1970,1649,12762
12760,403,428,505,657,645,725,482,3845
12762,413,298,395,244,503,523,512,2888
12763,586,671,709,726,785,800,942,5219
12764,1555,1669,1607,1688,1722,1804,1802,11847
12765,1230,1263,1033,806,777,858,885,6852
12766,364,478,482,477,436,314,437,2988
12767,86,42,140,108,126,110,126,738
12768,697,704,758,708,971,1090,1131,6059
12769,188,142,82,142,123,137,253,1067
12770,166,186,245,260,300,230,296,1683
12771,14061,14164,14041,14263,14639,14960,14511,100639
12775,2354,2327,2180,2195,2434,2220,2297,16007
12776,2327,2172,2123,2095,2105,1982,2180,14984
12777,857,856,757,827,876,905,764,5842
12778,634,319,211,230,612,582,633,3221
12779,2274,2369,2109,1907,2310,2213,2460,15642
12780,2064,2068,2152,2066,2217,1968,2312,14847
12781,281,229,346,374,366,260,307,2163
12783,2044,2357,2425,2247,1825,1905,1668,14471
12784,38,63,51,100,68,61,94,475
12785,939,916,1095,1056,933,955,1024,6918
12786,450,365,292,664,611,466,665,3513
12787,244,455,490,432,429,397,452,2899
12788,3038,2937,2885,3548,3285,3119,2908,21720
12789,2059,1713,1855,1887,1745,1662,1838,12759
12790,4397,4800,4671,4517,4601,4464,4518,31968
12791,869,672,646,762,750,827,737,5263
12792,227,361,300,348,392,382,335,2345
12801,14422,14496,14574,14652,14696,14748,14707,102295
12803,8386,8128,8093,7983,7852,7583,7567,55592
12804,26477,26465,26477,26308,26265,26066,26540,184598
12808,399,412,414,381,298,294,306,2504
12809,3385,3450,3461,3512,3576,3441,3528,24353
12810,728,724,654,563,584,619,627,4499
12811,68,67,92,182,236,214,127,986
12812,81,58,130,140,152,186,150,897
12814,1222,1282,1477,1571,1846,1907,1574,10879
12815,1084,1103,1056,958,976,895,871,6943
12816,4306,4417,4329,4518,4522,4427,4610,31129
12817,2281,2330,2358,2198,1984,1883,2274,15308
12819,330,309,316,350,463,385,403,2556
12821,2940,2816,2178,2160,2250,2373,2750,17467
12822,6382,6277,6287,6197,6139,6000,6200,43482
12823,386,369,351,187,160,118,238,1809
12824,1165,1114,991,929,819,790,894,6702
12827,3754,3800,3705,3877,3951,4014,3877,26978
12828,8762,9363,9291,9664,9817,10205,9448,66550
12831,17438,17727,17614,17644,17212,17529,17416,122580
12832,6798,6618,6624,6603,6716,6844,7106,47309
12833,4182,4183,4111,4172,4160,4155,4401,29364
12834,6287,6104,6243,6566,6527,6628,6594,44949
12835,2257,2344,2353,2381,2446,2468,2603,16852
12836,605,682,670,689,574,647,574,4441
12837,1018,941,1032,1004,979,819,857,6650
12838,523,559,601,562,450,509,608,3812
12839,13525,13740,13784,13537,13299,13087,13588,94560
12841,106,100,89,118,128,136,77,754
12842,933,730,956,1134,1235,1138,1166,7292
12843,451,539,372,456,533,546,600,3497
12844,238,263,206,263,166,123,199,1458
12845,4725,4792,4864,4955,5033,5094,4842,34305
12846,3273,3265,3289,3295,3333,3358,3298,23111
12847,425,389,418,551,628,656,605,3672
12849,265,623,564,570,503,537,385,3447
12850,3221,3143,3137,3019,2917,2845,2835,21117
12851,227,257,221,191,208,206,366,1676
12852,474,447,493,471,516,504,436,3341
12853,1347,1228,1351,1443,1457,1406,1770,10002
12855,198,196,172,130,157,203,259,1315
12856,131,70,66,73,48,117,187,692
12857,608,602,533,497,486,467,498,3691
12858,66,39,56,51,76,67,59,414
12859,2212,2297,2368,2339,2448,2579,2220,16463
12860,578,794,815,980,1188,1372,748,6475
12861,771,742,698,658,785,541,609,4804
12862,5,5,5,0,0,0,17,32
12863,554,690,655,644,598,526,533,4200
12864,18,37,28,71,60,56,36,306
12865,3769,3833,3876,3596,3538,3621,3663,25896
12866,38422,37050,37268,36864,36752,36312,36915,259583
12870,1044,836,1122,1423,1505,1656,1509,9095
12871,4249,4284,4282,4235,4269,4047,4084,29450
12872,44,41,76,69,77,76,31,414
12873,716,695,598,670,684,717,736,4816
12874,159,142,139,167,155,154,142,1058
12878,716,774,832,881,838,966,719,5726
12883,4971,5010,5020,5025,5045,5055,5025,35151
12884,373,293,293,347,397,445,486,2634
12885,4531,4574,4595,4627,4568,4447,4602,31944
12886,216,201,244,242,313,237,269,1722
12887,4788,4863,5695,5567,5600,5556,4972,37041
12901,33544,33155,32843,33137,33238,33314,33439,232670
12903,1019,1222,1086,1118,1104,990,1217,7756
12910,2181,2167,2046,2273,2234,2247,2148,15296
12911,27,43,49,23,35,33,36,246
12912,2280,2124,1982,2140,2423,2351,1998,15298
12913,1219,1330,1280,1228,1113,988,1157,8315
12914,1109,1033,1053,932,778,826,1044,6775
12916,2206,2044,2225,2225,2252,2159,2135,15246
12917,1190,1139,1198,1187,1225,1204,1403,8546
12918,2252,2145,2389,2320,2457,2341,2381,16285
12919,3046,2936,2903,2883,2808,2957,3037,20570
12920,2631,2720,2813,2797,2826,2774,2842,19403
12921,2555,2394,2328,2441,2262,2319,2410,16709
12922,42,37,36,40,32,37,65,289
12923,595,637,635,604,622,651,632,4376
12924,106,135,114,133,145,159,158,950
12926,2024,2015,1954,1754,1866,1827,2208,13648
12927,214,232,228,230,192,192,224,1512
12928,1859,1882,1843,2083,2064,2073,2028,13832
12929,3999,3864,3778,3930,4037,4041,3938,27587
12930,774,815,875,830,888,905,634,5721
12932,1327,1374,1357,1308,1407,1373,1236,9382
12933,21,12,12,13,12,0,17,87
12934,1030,1077,1066,1117,1216,1088,1074,7668
12935,1373,1571,1676,1583,1578,1517,1748,11046
12936,568,543,517,708,572,549,599,4056
12937,1688,1655,1723,1599,1386,1449,1572,11072
12939,248,219,227,204,203,182,205,1488
12941,1538,1487,1530,1374,1298,1175,1428,9830
12942,872,839,791,724,664,580,646,5116
12943,230,188,207,216,265,306,459,1871
12944,4417,4305,4386,3959,3998,3991,4080,29136
12945,532,467,476,442,424,424,638,3403
12946,5159,5287,5124,5370,5337,5449,5492,37218
12950,801,987,956,978,872,861,929,6384
12952,578,576,402,422,342,456,546,3322
12953,15517,15664,15679,15780,16001,16069,15836,110546
12955,426,469,465,389,392,359,381,2881
12956,1228,1340,1260,1142,1157,1531,1259,8917
12957,1755,1898,1702,1703,1677,1689,1726,12150
12958,2071,1944,1843,1703,1825,2046,1929,13361
12959,1324,1370,1532,1659,1542,1406,1369,10202
12960,1335,1554,1443,1388,1263,911,1148,9042
12961,361,339,298,255,198,79,180,1710
12962,5553,5656,6009,5977,5941,6472,5499,41107
12964,190,140,113,147,172,156,161,1079
12965,560,500,454,418,408,373,516,3229
12966,3164,3189,3352,3537,3395,3344,2915,22896
12967,1178,1191,1361,1216,1065,1086,1223,8320
12969,429,421,391,521,500,578,423,3263
12970,952,963,972,976,1047,1051,963,6924
12972,5702,6112,6448,6316,6680,6573,6364,44195
12973,191,189,219,232,206,142,187,1366
12974,1444,1206,1393,1410,1513,1701,1599,10266
12975,290,355,281,384,260,257,265,2092
12976,184,179,163,111,96,107,260,1100
12977,1750,1720,1733,1803,1875,1932,1753,12566
12978,375,288,315,325,335,352,403,2393
12979,2187,2241,2433,2472,2661,2593,2304,16891
12980,1309,1358,1122,1236,1188,1234,1304,8751
12981,2366,2376,2612,2497,2333,2309,2253,16746
12983,7520,7702,7958,7881,7842,7738,7494,54135
12985,1278,1343,1315,1069,1001,881,1072,7959
12986,6157,6181,6176,6120,6117,6100,6120,42971
12987,243,259,244,291,227,190,201,1655
12989,953,923,957,1069,1174,1222,1010,7308
12992,4831,5103,4697,4612,4534,4363,4778,32918
12993,1508,1527,1619,1691,1640,1721,1623,11329
12996,2030,1947,1905,1720,1772,1958,2086,13418
12997,1336,1331,1296,1205,1145,1157,1239,8709
12998,371,345,391,583,690,596,526,3502
13020,60,132,145,154,170,167,150,978
13021,38756,39135,39326,39208,39017,39125,39506,274073
13024,1707,1644,1649,1666,1704,1729,1733,11832
13026,1800,1831,1799,1707,1723,1733,1914,12507
13027,32208,31295,31724,31466,31318,30759,31637,220407
13028,1610,1426,1452,1400,1443,1143,1350,9824
13029,7379,7385,7506,7205,7202,6912,7109,50698
13030,3830,4069,3792,3259,3863,3739,3892,26444
13031,15710,15681,15345,15120,15188,15117,15551,107712
13032,12329,12811,13230,13724,13694,13387,12790,91965
13033,3747,3792,3939,4432,4470,4483,3556,28419
13034,1925,1896,1857,1885,1794,1806,1989,13152
13035,8621,8605,8543,8422,8490,8423,8617,59721
13036,8869,8476,8465,8643,8816,8340,8680,60289
13037,8948,8758,8549,8611,8580,8916,8897,61259
13039,17707,17878,17759,17821,17361,17402,17537,123465
13040,2624,2502,2482,2415,2341,2318,2758,17440
13041,11610,11024,11023,10919,10725,10865,10705,76871
13042,2643,2856,2799,2149,1981,2228,2356,17012
13044,2172,2374,2352,2482,2546,2702,2512,17140
13045,29609,29816,30009,30031,30052,30517,30112,210146
13051,149,173,129,13,26,43,153,686
13052,1514,1698,1745,1666,1651,1555,1679,11508
13053,4538,4434,4283,3997,3887,4153,5015,30307
13054,1866,1699,1536,1388,1293,1338,1582,10702
13057,14422,14539,14547,15196,15235,15042,14992,103973
13060,2939,2808,2461,2418,2277,2542,2806,18251
13061,1101,1110,1193,1213,1286,1175,1040,8118
13062,234,261,303,277,304,77,173,1629
13063,2038,1974,1901,2000,1995,1906,1898,13712
13064,39,20,26,11,10,34,64,204
13066,12280,12115,11809,11550,11821,11949,12390,83914
13068,5833,5830,5697,5693,5245,5120,5368,38786
13069,24927,25314,25297,24791,24968,24328,24931,174556
13071,865,914,989,889,840,831,1023,6351
13072,619,733,832,1008,1121,1191,1123,6627
13073,6337,6405,6520,6382,6390,6429,6423,44886
13074,4329,4284,4467,4519,4648,4994,4488,31729
13076,2343,2512,2451,2465,2427,2481,2393,17072
13077,6961,6895,6673,6530,6525,6466,6735,46785
13078,10149,10397,10273,10314,10505,10334,9866,71838
13080,3618,3773,3997,3924,3962,3831,3631,26736
13081,992,1030,1062,1175,1207,1141,1169,7776
13082,4826,4511,4735,4535,4224,4276,4871,31978
13083,1704,1637,1704,1662,1726,1631,1809,11873
13084,3945,3976,4303,4428,4246,4467,4409,29774
13087,152,203,177,189,294,240,168,1423
13088,22317,22457,22012,21912,21475,21475,22156,153804
13090,30250,30630,30295,30191,30257,30033,30124,211780
13092,2705,2640,2527,2889,2992,2980,2606,19339
13101,2263,2367,2648,2605,2615,2814,2508,17820
13102,28,9,27,308,340,258,85,1055
13103,367,489,575,434,334,271,326,2796
13104,15773,16000,16266,16201,15951,16260,15567,112018
13108,6125,6450,6460,6385,6424,6253,6175,44272
13110,2290,2257,2313,2348,2324,2315,2338,16185
13111,1543,1623,1496,1842,1485,1415,1700,11104
13112,2003,1950,2200,1944,1900,1840,1973,13810
13113,297,264,238,292,262,212,287,1852
13114,6815,6772,6761,6695,6495,6568,6356,46462
13115,119,192,172,107,166,205,224,1185
13116,3521,3514,3492,3470,3463,3426,3457,24343
13117,274,269,143,161,177,182,188,1394
13118,6156,6247,6288,6207,6164,6172,6382,43616
13120,2167,1929,2162,2189,2024,2069,2328,14868
13122,1446,1325,1136,1052,869,822,1174,7824
13123,527,229,184,94,84,83,314,1515
13124,64,78,109,104,119,110,124,708
13126,36566,36772,37190,37440,37483,37711,37205,260367
13131,3830,3493,3682,3839,3707,3610,3895,26056
13132,3370,3347,3420,3441,3789,3958,4244,25569
13134,199,97,39,33,37,25,119,549
13135,6655,7065,6990,6932,6715,7055,6617,48029
13136,414,485,464,454,486,480,534,3317
13138,0,0,21,30,29,30,61,171
13140,4536,4362,4353,4178,4159,4254,4488,30330
13141,604,583,616,541,456,524,596,3920
13142,5996,6058,6141,6312,6430,6552,6451,43940
13143,2869,2894,2870,2992,3262,3482,2873,21242
13144,1904,1964,1839,1714,1527,1530,1531,12009
13145,2047,2028,1909,1837,1872,1846,1926,13465
13146,2077,2082,2036,2242,2398,2328,2443,15606
13147,1328,1286,1372,1638,1599,1545,1281,10049
13148,10532,10808,10647,10716,10772,10917,10750,75142
13152,8290,8150,8178,8175,8207,8187,7941,57128
13153,329,201,174,208,267,255,399,1833
13155,638,742,643,692,686,745,663,4809
13156,2232,2152,2162,2207,2296,2137,2000,15186
13157,602,729,718,726,770,834,695,5074
13158,1522,1573,1676,1737,1891,1954,1855,12208
13159,5255,5370,5357,5384,5605,5426,5184,37581
13160,1958,2128,2167,1960,2086,2080,2027,14406
13162,441,519,637,530,629,434,385,3575
13163,417,419,342,334,303,256,339,2410
13164,2404,2494,2448,2559,2604,2499,2338,17346
13165,10881,10753,10919,10776,10729,10495,10741,75294
13166,5534,5534,5565,5529,5706,5503,5610,38981
13167,3024,3096,3056,3202,3179,3441,3342,22340
13202,5840,5878,5745,5352,5209,5385,5438,38847
13203,16564,16406,16437,16230,15513,15873,16029,113052
13204,19503,19896,19984,20375,20777,20295,19931,140761
13205,18377,18729,18788,18790,19511,18349,19201,131745
13206,16142,16428,15997,16415,15650,15633,16443,112708
13207,13153,13110,13352,13573,13543,13661,13897,94289
13208,22553,22353,22490,22401,22475,22812,22854,157938
13209,13095,13492,13047,13305,13149,13714,13243,93045
13210,27822,27737,27905,27440,28368,28618,27606,195496
13211,6616,6515,6819,6931,6711,6641,6517,46750
13212,20645,20417,20348,20535,20638,20575,20356,143514
13214,9357,9032,8938,8690,8289,8009,8793,61108
13215,15541,15646,15409,15582,15599,15433,15245,108455
13219,14928,14955,15318,15166,15095,15100,15363,105925
13224,8560,8628,8767,9079,8868,9443,8891,62236
13290,0,0,0,0,0,0,0,0
13301,79,84,71,223,194,159,98,908
13302,1726,1795,1551,1637,1546,1526,1610,11391
13303,1115,1160,1213,1099,1045,997,1153,7782
13304,1679,1691,1600,1505,1387,1388,1684,10934
13305,547,469,387,371,346,232,293,2645
13308,2697,2695,2973,3415,3710,3764,3625,22879
13309,5806,5755,5940,5920,6143,6197,5889,41650
13310,573,481,555,598,559,795,624,4185
13312,421,492,408,320,300,334,331,2606
13313,511,525,555,486,512,615,526,3730
13314,484,664,606,549,532,456,443,3734
13315,1489,1400,1450,1464,1536,1662,1419,10420
13316,6490,6687,6655,6897,6746,6708,6460,46643
13317,3966,3917,3787,3747,3744,3795,3784,26740
13318,1271,1175,1190,1244,1244,1180,1325,8629
13319,793,913,1164,1131,1181,1079,1079,7340
13320,2163,2139,2064,2035,2076,2088,2018,14583
13321,1144,1247,1175,1020,980,1122,1049,7737
13322,797,775,919,1052,1103,1242,1076,6964
13323,11151,11087,11238,11452,11348,11260,11323,78859
13324,2093,2215,2331,2291,2249,2368,2149,15696
13325,992,962,942,1011,985,921,866,6679
13326,5372,5615,5545,5456,5515,5647,5561,38711
13327,1926,1983,1973,1822,1952,2097,2056,13809
13328,1421,1389,1328,1267,1301,1175,1267,9148
13329,4331,4227,3837,3853,3899,3965,3889,28001
13331,156,202,148,164,254,253,189,1366
13332,2752,2583,2672,2572,2573,2765,2460,18377
13333,46,61,56,59,49,43,62,376
13334,1163,1270,1498,1257,1239,1312,1374,9113
13335,1570,1606,1650,1721,1617,1704,1590,11458
13337,658,602,634,753,680,613,790,4730
13338,1088,1083,1032,1033,1087,1143,1206,7672
13339,6307,6625,6784,6781,6900,7137,6941,47475
13340,8049,7594,7788,7981,7878,7966,8205,55461
13341,149,142,172,149,116,113,102,943
13342,213,188,188,199,230,226,165,1409
13343,1936,1868,1830,1622,1560,1472,1658,11946
13345,184,198,280,252,244,198,177,1533
13346,6304,6284,6457,6648,6843,6683,6735,45954
13348,1364,1162,1188,1179,1129,1169,1469,8660
13350,9985,10034,10080,10113,10094,10078,10093,70477
13352,168,146,293,253,271,171,65,1367
13353,36,38,31,37,40,50,86,318
13354,3467,3351,3294,3235,3295,3291,3342,23275
13355,884,861,802,860,825,784,905,5921
13357,10969,11261,11280,11199,11201,11238,11096,78244
13360,354,458,487,525,566,517,333,3240
13361,880,969,955,1012,993,983,824,6616
13362,197,102,208,148,128,132,60,975
13363,2080,2244,2375,2470,2475,2795,2315,16754
13364,94,92,110,162,338,348,243,1387
13365,8715,8809,9134,8978,8837,8706,8906,62085
13367,8609,8618,8565,8806,8545,8415,8830,60388
13368,1259,1307,1307,1402,1287,1306,1118,8986
13402,1676,1721,1576,1587,1540,1606,1534,11240
13403,7330,7588,7579,7605,7641,7691,7372,52806
13404,183,187,237,242,300,231,236,1616
13406,730,698,674,757,725,860,725,5169
13407,5155,5195,5280,5338,5474,5479,5453,37374
13408,4096,3898,3834,3712,3604,3537,4280,26961
13409,2447,2538,2611,2801,2827,2978,2374,18576
13410,209,239,255,274,265,257,241,1740
13411,3353,3432,3453,3732,3889,3774,3264,24897
13413,16370,16514,16227,15769,16067,16095,16135,113177
13415,88,66,41,55,59,63,77,449
13416,2320,2273,2385,2223,2186,2107,2271,15765
13417,3341,3172,2925,3329,3169,3412,3305,22653
13418,339,290,220,184,361,343,255,1992
13420,1213,1198,1278,1271,1215,1029,1266,8470
13421,13602,13978,14106,14501,14191,14283,14125,98786
13424,2421,2537,2663,2641,2722,2685,2725,18394
13425,2306,2325,2348,2374,2278,2234,1970,15835
13428,1889,1810,1530,1649,1499,1391,1635,11403
13431,1874,1921,1995,2136,2169,2068,2069,14232
13433,2003,2035,2000,1879,1934,1797,1820,13468
13435,270,193,217,203,213,238,286,1620
13436,95,88,64,70,77,106,108,608
13437,437,464,435,413,493,506,460,3208
13438,3598,3852,3821,4072,4161,4136,3789,27429
13439,3612,3804,3655,3693,3831,3729,3950,26274
13440,42257,42154,42221,42059,42329,42538,42986,296544
13441,55,38,31,18,12,35,51,240
13450,77,76,104,150,159,142,104,812
13452,4498,4546,4645,4665,4809,4697,4629,32489
13454,705,733,688,708,654,648,826,4962
13456,4138,4341,4246,4162,4081,3935,4164,29067
13459,2382,2346,2069,2061,2296,2167,2222,15543
13460,4230,4280,4213,4194,4297,4236,4429,29879
13461,3063,3073,3072,3081,3071,3120,3083,21563
13464,1370,1206,1093,1048,978,1077,1189,7961
13468,453,416,475,480,534,524,451,3333
13469,1162,1095,1163,971,742,611,847,6591
13470,679,644,695,687,606,620,725,4656
13471,3509,3545,3442,3676,3639,3466,3540,24817
13472,137,228,260,213,375,276,310,1799
13473,549,534,639,665,666,678,766,4497
13475,43,44,41,33,28,3,28,220
13476,3212,3336,2931,2825,2957,2914,3032,21207
13477,1724,1505,1802,1662,1601,1776,1452,11522
13478,2843,2786,2750,2872,2886,2776,3083,19996
13480,3449,3406,3419,3500,3609,3572,3532,24487
13483,238,219,212,195,156,220,256,1496
13484,259,252,89,165,296,217,176,1454
13485,1088,1029,994,936,922,856,1132,6957
13486,729,729,547,573,567,625,815,4585
13488,149,121,70,103,98,173,98,812
13489,628,644,598,561,501,505,658,4095
13490,1694,1558,1446,1399,1347,1485,1361,10290
13491,3508,3641,3741,3798,3474,3527,3641,25330
13492,11516,11658,11710,11644,11530,11381,11596,81035
13493,1775,1939,2034,1990,2194,2189,2070,14191
13494,238,268,361,371,346,348,314,2246
13495,2263,2233,2304,2168,2202,2193,2144,15507
13501,38376,38455,38464,37763,37480,37228,38546,266312
13502,32370,32425,32415,33615,34183,34192,33257,232457
13601,38466,38624,38348,38646,38411,38257,38158,268910
13602,3982,3745,3633,3269,3104,2942,3881,24556
13603,10005,10612,10727,10734,10386,9854,9760,72078
13605,4760,4949,4907,5000,4740,4744,4777,33877
13606,2991,3033,3101,3118,3049,2812,2716,20820
13607,1670,1697,1810,1886,1993,1860,1822,12738
13608,1519,1483,1502,1549,1562,1601,1719,10935
13612,2685,2934,2904,2771,2877,2901,2852,19924
13613,2168,2397,2385,2791,2669,2587,2726,17723
13614,256,250,412,373,354,310,357,2312
13615,1094,1104,1114,981,1052,1151,1271,7767
13616,2144,2117,2184,1819,1787,1937,1880,13868
13617,11483,11064,11243,11486,11118,11186,11299,78879
13618,1787,1752,1795,1829,1817,1717,1711,12408
13619,10863,10654,10706,10767,10687,11263,10901,75841
13620,2182,2088,2101,2309,2298,2201,2197,15376
13621,462,447,561,613,690,724,650,4147
13622,2681,2808,2980,2855,2971,2679,2432,19406
13623,22,43,48,101,106,107,49,476
13624,5764,5656,5636,5409,5395,5693,5457,39010
13625,2010,2037,1920,1895,1843,1883,1868,13456
13626,2232,2282,2147,2042,1897,1845,2267,14712
13628,234,184,211,204,266,272,220,1591
13630,1547,1496,1318,1373,1582,1510,1525,10351
13633,334,377,352,288,344,375,345,2415
13634,4675,4681,4879,5017,4500,4108,3984,31844
13635,1085,955,831,837,850,848,1092,6498
13636,293,278,286,216,270,292,282,1917
13637,4363,4182,3945,4270,4343,4194,4491,29788
13638,301,232,260,196,252,411,378,2030
13639,201,215,199,189,201,223,243,1471
13640,435,378,288,241,214,188,271,2015
13641,59,70,49,69,64,79,91,481
13642,9922,9874,9849,9976,10309,10231,10088,70249
13643,0,0,72,80,84,85,19,340
13646,2423,2515,2681,2758,2735,2978,2211,18301
13647,91,67,68,64,66,30,69,455
13648,2261,2140,2094,2166,2470,2619,2424,16174
13650,1612,1404,1433,1222,1202,1246,1391,9510
13651,159,194,185,137,212,243,127,1257
13652,1785,1849,1864,1678,1634,1476,1815,12101
13654,3032,2994,3000,2680,2311,2256,2461,18734
13655,3429,3394,3414,3400,3443,3356,3512,23948
13656,2840,3083,2895,2807,2758,2734,2861,19978
13658,2137,2084,1979,2112,1995,2026,2357,14690
13659,527,494,568,624,561,523,593,3890
13660,1781,1996,2019,2429,2243,2303,1891,14662
13661,1438,1686,1676,1769,1897,1891,1646,12003
13662,16517,16661,16692,16941,16631,16513,16582,116537
13664,357,446,439,522,577,580,399,3320
13665,881,1257,1413,1402,1560,1344,882,8739
13666,211,288,361,294,367,412,266,2199
13667,3025,2837,3017,2870,2950,3249,3181,21129
13668,3470,3267,3484,3470,3433,3367,3329,23820
13669,16103,16128,16436,16562,17146,17287,16452,116114
13670,410,505,490,465,484,488,430,3272
13672,900,943,826,744,608,595,602,5218
13673,2168,2245,2228,2229,2271,2418,2249,15808
13674,141,106,118,151,143,182,126,967
13675,92,102,89,33,26,44,160,546
13676,17060,17140,16728,16444,16339,16200,16646,116557
13677,85,273,240,153,196,188,93,1228
13678,263,262,163,153,214,248,211,1514
13679,1969,1809,1810,1872,1694,1757,1853,12764
13680,1470,1518,1301,1236,1317,1080,1244,9166
13681,735,836,823,791,828,769,897,5679
13682,978,961,896,737,739,716,877,5904
13684,1188,1235,1116,1098,1003,987,1131,7758
13685,2299,2368,2306,2163,2192,2261,2272,15861
13687,481,582,543,525,547,548,479,3705
13690,741,732,935,892,907,946,846,5999
13691,2953,3000,2948,3051,3123,3058,3176,21309
13692,43,71,78,45,77,107,27,448
13693,511,502,534,547,434,572,503,3603
13694,1437,1519,1581,1372,1365,1305,1507,10086
13695,141,134,78,58,64,75,134,684
13696,30,71,63,47,42,41,87,381
13697,2068,2046,2009,2106,2368,2267,2281,15145
13730,2799,3002,3185,3073,3009,3102,2805,20975
13731,1024,1067,1066,1012,919,926,1162,7176
13732,7862,7905,8101,8190,8116,8365,8153,56692
13733,4939,5013,5332,5348,5239,5369,5216,36456
13734,2140,2475,2703,2425,2128,2417,2287,16575
13736,2062,2077,2252,2527,2417,2445,2338,16118
13739,826,860,911,898,916,969,953,6333
13740,499,489,475,472,470,474,554,3433
13743,3746,3725,3794,3846,3926,3742,3806,26585
13744,1175,1139,1284,1332,1357,1372,1137,8796
13746,1987,2191,2216,2263,2212,2307,2539,15715
13748,3795,3849,3907,4021,3855,3832,3800,27059
13750,840,922,858,946,922,872,1092,6452
13751,167,168,156,144,160,147,189,1131
13752,809,646,729,788,643,796,782,5193
13753,5597,5668,5710,5737,5818,5809,5848,40187
13754,3337,3586,3561,3846,3708,3854,3310,25202
13755,1212,1313,1287,1342,1621,1580,1228,9583
13756,447,501,498,493,516,580,613,3648
13757,1106,1139,1098,1109,980,1111,1045,7588
13760,44320,44690,44585,44363,44489,44383,44264,311094
13774,334,288,317,327,275,72,201,1814
13775,1626,1617,1841,1877,1710,1710,1631,12012
13776,448,556,551,522,499,545,513,3634
13777,436,416,664,627,644,664,727,4178
13778,5926,5766,5922,6030,6056,5872,5948,41520
13780,860,1031,1111,999,1044,1036,1045,7126
13782,687,698,611,625,675,611,755,4662
13783,2403,2441,2199,2060,2169,2282,2670,16224
13784,107,161,132,115,154,131,172,972
13786,525,534,664,633,514,413,464,3747
13787,3685,3903,3543,3748,3617,3847,3629,25972
13788,1014,1064,1042,1018,983,959,991,7071
13790,18034,17765,17858,18577,18610,18887,19104,128835
13794,29,25,80,130,116,109,105,594
13795,3581,3704,3638,3664,3861,3826,3800,26074
13796,1456,1353,1357,1285,1251,1244,1236,9182
13797,2235,2129,2109,2029,2199,2118,2250,15069
13801,1339,1228,1169,1264,1277,1443,1398,9118
13802,598,563,912,660,590,629,718,4670
13803,4302,4276,4153,4128,4131,3917,3975,28882
13804,578,597,657,620,610,379,391,3832
13806,268,188,260,187,185,162,205,1455
13807,1224,1186,1217,1067,1275,1190,1199,8358
13808,1534,1427,1362,1502,1547,1531,1771,10674
13809,2109,1896,1706,1637,1715,1567,1517,12147
13810,1016,1105,1104,1020,1209,1261,1149,7864
13811,4518,4509,4228,4327,4295,4315,4354,30546
13812,2509,2488,2299,2333,2310,2332,2348,16619
13813,631,502,629,1051,1089,956,977,5835
13815,13444,13683,13896,14053,14215,14306,13999,97596
13820,22143,22388,22746,22820,22709,22869,22455,158130
13825,3416,3506,3522,3505,3406,3452,3442,24249
13826,13,13,0,0,0,0,58,84
13827,11392,11792,11649,11795,12167,11595,11759,82149
13830,5124,5124,5020,4899,4804,4809,5042,34822
13832,679,756,673,510,698,736,709,4761
13833,4067,4345,4309,3915,4161,4187,4255,29239
13834,158,44,47,57,46,40,118,510
13835,1285,1306,1326,1404,1568,1614,1511,10014
13838,4732,4778,4450,4417,4277,4016,4409,31079
13839,990,1029,1214,1285,1470,1649,1405,9042
13841,628,652,730,639,595,523,529,4296
13842,623,569,702,644,646,610,695,4489
13843,2001,1964,2007,1790,1534,1578,1888,12762
13844,930,723,847,885,818,800,724,5727
13845,59,69,60,58,153,87,83,569
13846,270,251,271,267,281,294,305,1939
13847,65,55,48,67,107,127,67,536
13849,3779,3869,3893,3968,4277,4727,4551,29064
13850,22291,22288,22080,21914,21926,21810,22004,154313
13856,6258,6349,6570,6658,6622,6565,6596,45618
13859,352,277,269,275,248,305,182,1908
13860,95,56,17,80,87,101,94,530
13861,352,429,419,349,515,422,432,2918
13862,4504,4490,4531,4336,4284,4313,4189,30647
13863,769,787,793,761,759,663,688,5220
13864,1039,1006,1096,1121,1059,1131,1149,7601
13865,6191,6350,6373,6442,6465,6381,6371,44573
13901,19160,19116,19006,19186,18625,19165,19773,134031
13902,6149,6084,6172,6151,6158,6212,6177,43103
13903,18099,18403,18735,18737,19376,19769,18763,131882
13904,9769,9512,9626,9436,9288,9427,9579,66637
13905,27767,27720,27543,27708,28342,27783,28026,194889
14001,9609,9620,9790,9866,9860,9830,9464,68039
14004,12363,12359,12284,12146,12132,12202,12704,86190
14005,1865,1930,2032,2118,2225,2196,1986,14352
14006,9826,9754,9612,9282,9413,9375,9858,67120
14008,1450,1459,1295,1545,1325,1234,1467,9775
14009,5368,5409,5532,5549,5654,5534,5672,38718
14011,9859,9950,9957,9952,10102,10118,9822,69760
14012,2453,2506,2515,2400,2266,2392,2362,16894
14013,1742,1737,1732,1664,1816,1711,1751,12153
14020,22725,22835,23120,23208,23302,23492,23306,161988
14024,1770,1823,1700,1752,1767,1741,1688,12241
14025,2762,2964,3210,3390,3331,3238,3039,21934
14026,655,597,712,778,717,623,674,4756
14028,1558,1423,1423,1322,1549,1329,1595,10199
14030,1663,1595,1767,1661,1647,1646,1807,11786
14031,10069,10058,9710,9911,9807,9184,9392,68131
14032,8187,7841,7853,7623,7235,7256,7989,53984
14033,2045,2455,2252,2170,2063,2324,2219,15528
14034,2957,3027,3205,2978,2967,2895,2742,20771
14035,103,33,167,215,187,212,125,1042
14036,5092,5132,5119,5256,5117,5196,5201,36113
14037,912,914,855,928,910,1043,1166,6728
14039,108,119,86,87,101,138,101,740
14040,2117,2206,2365,2259,2156,2124,2217,15444
14041,179,323,295,315,338,330,237,2017
14042,3960,3784,3783,3834,3915,4021,3969,27266
14043,24004,23615,24267,24139,24425,24413,24742,169605
14047,6390,6402,6596,6878,6847,7050,6440,46603
14048,14349,14557,14718,15043,15072,15145,15072,103956
14051,20108,20654,20133,19795,20065,19776,19533,140064
14052,16524,16688,17072,17137,17818,17585,17329,120153
14054,1288,1253,1189,1280,1340,1291,1344,8985
14055,1536,1622,1461,1534,1653,1600,1405,10811
14057,8154,8116,8241,8080,8018,8018,8116,56743
14058,2036,2116,2190,2235,2249,2361,2285,15472
14059,10087,9814,9834,9619,9184,8697,8933,66168
14060,349,412,531,599,631,581,443,3546
14061,307,354,328,300,271,284,349,2193
14062,3073,3016,3311,3166,3222,3258,3329,22375
14063,14538,14524,14555,14627,14678,14675,14870,102467
14065,1725,1791,1825,1792,1823,1837,1896,12689
14066,1101,1055,1149,1188,1338,1334,1318,8483
14067,5691,5230,5456,5472,5038,4746,5040,36673
14068,7141,7130,7131,7289,7363,7208,7150,50412
14069,842,816,738,763,672,661,844,5336
14070,6356,6444,6050,6078,6629,6837,6732,45126
14072,20735,20679,20580,20469,20324,20120,20374,143281
14075,43112,42752,42837,43007,42670,42282,41937,298597
14080,4249,4370,4467,4564,4671,4417,4330,31068
14081,3154,3183,3167,3081,3061,3045,3095,21786
14082,428,348,322,302,325,415,426,2566
14085,7308,7040,7167,6988,7025,6753,7353,49634
14086,32875,32934,32159,31920,31685,31152,31847,224572
14091,916,967,1078,1138,1286,1372,1079,7836
14092,11399,11513,11595,11342,11388,11205,11086,79528
14094,49463,49936,50605,50807,51069,50472,50666,353018
14098,2876,2995,3079,3107,3099,3134,2958,21248
14101,2181,2098,2171,2098,2193,2251,1905,14897
14102,1290,1395,1494,1647,1417,1611,1281,10135
14103,10601,10788,10728,10886,11087,11054,11183,76327
14105,4303,4684,4247,4058,4489,4678,4566,31025
14108,5756,5825,5686,5507,5464,6015,5882,40135
14109,1174,1153,813,827,851,857,1117,6792
14111,3738,3606,3456,3498,3291,3153,3352,24094
14112,0,0,0,8,11,12,85,116
14113,560,602,620,630,614,617,703,4346
14120,44864,44417,44800,44334,44200,44446,45100,312161
14125,3798,3823,3765,3751,3855,3853,3782,26627
14126,510,574,685,682,726,793,588,4558
14127,30578,30507,30329,29940,29661,29586,29961,210562
14129,1539,1447,1436,1529,1542,1675,1591,10759
14130,128,172,234,241,277,282,265,1599
14131,5382,5273,4828,4756,4903,4989,5283,35414
14132,6171,6816,6933,6859,6585,6567,6218,46149
14134,125,123,111,125,65,89,104,742
14135,114,133,143,137,119,137,119,902
14136,5157,5170,5109,5252,5054,5073,5033,35848
14138,2152,2269,2250,2073,2199,2057,2018,15018
14139,2417,2329,2028,1983,1914,1891,2125,14687
14141,7424,7522,7684,7501,7737,7863,7728,53459
14143,1208,1174,1076,1200,1063,1037,1214,7972
14145,1744,1752,1522,1507,1501,1429,1618,11073
14150,41095,41430,41908,42279,42258,42027,41676,292673
14167,1759,1812,1765,1730,1678,1599,1663,12006
14168,96,76,111,104,91,92,36,606
14169,201,217,320,344,368,389,151,1990
14170,2655,2503,2370,2374,2405,2621,2286,17214
14171,2054,1933,2005,2062,1837,1869,2077,13837
14172,2999,2983,3104,3246,3277,3206,3200,22015
14173,396,354,263,217,219,312,396,2157
14174,5412,5447,5683,5956,5735,5542,5794,39569
14201,11711,13108,12872,12802,13371,12975,11549,88388
14202,3419,3340,3570,3741,3673,3616,3911,25270
14203,1807,1725,1751,1415,1216,1180,1618,10712
14204,8687,8934,8905,9235,9202,9840,8691,63494
14206,20352,20813,21670,22106,22248,22247,20751,150187
14207,23383,22979,23285,22312,22694,23017,23552,161222
14208,11514,11519,10918,11492,11258,11626,11125,79452
14209,7693,7995,8597,8679,8071,8119,7926,57080
14210,14379,13693,13787,13508,13318,13734,14694,97113
14211,22017,21906,20885,21545,21906,22707,22611,153577
14212,10611,10546,10974,10599,11078,10949,10641,75398
14213,24258,24375,23468,24134,23220,22371,24465,166291
14214,20381,19862,19743,19760,19625,19594,19775,138740
14215,39458,39501,39786,38980,40084,41032,39999,278840
14216,22171,22699,22203,22541,23066,23199,22431,158310
14217,22815,22763,22911,22936,23048,23371,23480,161324
14218,18912,18877,18943,18805,18953,18922,19039,132451
14219,11501,11416,10912,10888,11015,11255,11536,78523
14220,24132,24188,24525,24105,24299,24666,24227,170142
14221,54603,53936,54109,53475,52863,53402,53555,375943
14222,14377,14273,14519,15170,15605,15077,14046,103067
14223,23111,23211,22901,22713,22790,22782,22665,160173
14224,40660,40402,40002,40074,39939,39937,39889,280903
14225,33273,33221,33228,33075,32751,32942,33385,231875
14226,29414,28295,28593,28827,29514,29884,29267,203794
14227,22657,22810,22950,22915,22821,22957,23426,160536
14228,21533,22144,21887,21467,20774,19873,20857,148535
14261,5817,5769,5680,5600,5492,5534,5713,39605
14301,12730,12764,12965,12643,12985,12468,12817,89372
14302,48,24,25,49,75,97,107,425
14303,5655,6050,6073,5554,5790,5818,5981,40921
14304,29409,29075,28605,29745,30128,30309,30389,207660
14305,16682,16755,17249,17691,17411,18196,16898,120882
14411,14424,14152,14493,14257,14525,14345,14491,100687
14414,7046,7009,7062,7109,7119,7125,7142,49612
14415,173,140,61,75,133,115,132,829
14416,3550,3539,3606,3583,3607,3583,3817,25285
14418,1339,1404,1371,1118,1165,1085,1325,8807
14420,20795,20574,20638,20706,20526,20380,20467,144086
14422,2434,2473,2432,2490,2425,2444,2468,17166
14423,4816,4871,4828,4889,4739,4842,4799,33784
14424,27330,27212,26862,26567,26440,26110,27007,187528
14425,11860,11650,11415,11051,10818,10416,10717,77927
14427,2156,2189,2202,2136,2114,2237,1964,14998
14428,7837,7939,8003,8371,8511,8469,8096,57226
14432,6237,6116,6304,5850,5813,5614,5726,41660
14433,4375,4223,4121,4201,4219,4428,4629,30196
14435,2910,2976,2894,2912,2956,2937,2941,20526
14437,11484,11294,11314,11201,11380,11516,11415,79604
14441,457,462,444,384,335,259,325,2666
14445,7978,7823,7892,8006,8008,8054,8019,55780
14450,41191,41449,41414,41211,40922,41156,41104,288447
14454,11256,11143,11124,11153,11050,10880,11073,77679
14456,19522,19648,19865,20132,20177,20591,20087,140022
14462,530,561,594,578,555,623,655,4096
14464,7538,7369,7272,7117,7087,7111,7524,51018
14466,1910,1649,1844,1734,1677,1495,1719,12028
14467,10782,10322,9784,9925,9485,9568,9105,68971
14468,18547,18232,18271,18325,17785,17656,17813,126629
14469,6207,6271,6500,6166,5955,6026,6220,43345
14470,7848,8073,7930,7871,7937,8019,8016,55694
14471,2550,2763,2628,2675,2680,2690,2672,18658
14472,8303,8550,8308,8289,8468,8446,8598,58962
14475,260,243,227,263,243,254,234,1724
14476,2246,2253,2229,2266,2257,2298,2288,15837
14477,1740,1979,2089,2137,2024,1918,1732,13619
14478,1566,1478,1535,1478,1528,1335,1595,10515
14479,252,282,319,368,316,424,275,2236
14480,808,1118,1166,822,831,1013,833,6591
14481,1798,1814,1865,1912,1878,1879,1820,12966
14482,8278,8248,8265,8382,8305,8276,8275,58029
14485,4323,4500,4609,4454,4345,4412,4267,30910
14486,361,284,268,293,288,213,308,2015
14487,5874,5719,5539,5936,6101,6149,6025,41343
14489,7073,7091,7261,7356,7512,7264,7192,50749
14502,10866,10879,10698,10586,10576,10631,10691,74927
14504,1910,1760,1739,1582,1557,1555,1701,11804
14505,5065,5012,5050,5187,5376,5280,5393,36363
14506,1404,1182,1374,1371,1457,1453,1325,9566
14507,1272,1333,1292,1285,1215,1273,1351,9021
14510,4651,4778,4700,4815,4892,4998,4895,33729
14511,334,234,379,351,407,438,497,2640
14512,4592,4634,4765,4855,4737,4606,4721,32910
14513,13740,13783,14001,13905,13829,14188,13976,97422
14514,6784,6489,6719,6218,6243,5724,6389,44566
14516,2547,2543,2429,2254,2174,2032,2365,16344
14517,3163,2970,2989,2878,2958,2880,2883,20721
14519,11774,11737,11594,11484,11490,11282,11581,80942
14521,2454,2498,2755,2806,2876,2820,2761,18970
14522,9232,9369,9288,9486,9486,9463,9565,65889
14525,2751,2651,2772,2670,2820,2893,2865,19422
14526,20329,20387,20609,20229,20146,19843,19804,141347
14527,12738,12785,12923,12990,13157,13505,12820,90918
14529,190,183,85,108,114,94,67,841
14530,5289,5322,5392,5434,5425,5387,5575,37824
14532,4611,4583,4235,4328,4316,4175,4431,30679
14533,1820,1828,1826,1717,1978,2028,2000,13197
14534,32195,32250,32399,32537,32106,31995,31426,224908
14536,537,525,568,578,555,595,687,4045
14537,194,160,164,164,158,228,207,1275
14539,186,214,225,143,157,190,242,1357
14541,4317,4223,4634,4610,4483,4398,4129,30794
14542,42,50,58,41,47,35,97,370
14543,3186,3131,3174,3073,3166,3254,3152,22136
14544,2242,2259,2247,2420,2364,2235,2101,15868
14545,213,169,173,174,201,182,173,1285
14546,4834,5005,4843,4955,4624,4641,4695,33597
14548,3548,3716,4056,4496,4499,4662,4249,29226
14549,48,23,5,42,42,27,91,278
14550,1774,1866,1764,1714,1611,1535,1537,11801
14551,5339,5805,5693,5630,5720,5567,5651,39405
14555,1115,1074,1182,1229,1099,1327,974,8000
14559,18423,18909,18336,18098,18069,17978,18057,127870
14560,2091,2038,1860,1819,1628,1621,2164,13221
14561,2896,3057,3209,3264,3578,3607,3086,22697
14564,14789,14600,14382,14497,14382,14185,14487,101322
14568,6085,6240,6465,6203,6211,6356,6048,43608
14569,6084,6063,6216,6187,6137,6126,6211,43024
14571,1142,1004,1123,1181,1231,1456,1176,8313
14572,4968,5122,5228,5304,5398,5489,5081,36590
14580,51928,51416,50946,50559,50036,49078,50587,354550
14585,75,79,69,67,65,97,120,572
14586,11267,12046,11452,10755,10431,9827,10256,76034
14588,677,741,259,269,262,614,749,3571
14589,7618,7578,7573,7713,7694,7688,7854,53718
14590,5198,5170,5199,5020,5159,5490,5446,36682
14591,1557,1603,1552,1701,1687,1691,1748,11539
14592,152,166,187,224,225,229,110,1293
14604,1690,1624,1651,1607,1494,1446,1743,11255
14605,13199,13140,13737,13584,13524,13578,12610,93372
14606,28704,29338,29076,29551,30109,28872,28255,203905
14607,16675,16542,16159,16144,16002,15540,16223,113285
14608,12399,12358,12377,12058,12390,12539,12268,86389
14609,43762,44065,44103,42628,42085,40509,42571,299723
14610,13781,13459,13679,13655,14157,14213,14233,97177
14611,16531,17340,17773,17573,17403,17745,17396,121761
14612,33905,34516,34668,35070,35695,36115,34515,244484
14613,13232,12711,12212,13112,13022,13503,14730,92522
14614,1179,1174,1136,1105,1119,1136,1224,8073
14615,16375,16057,15579,15776,16573,16317,16099,112776
14616,28280,28666,28638,28688,27969,28534,28534,199309
14617,22848,22842,22776,23124,23091,23283,22789,160753
14618,22705,22352,21367,22110,22370,22524,22920,156348
14619,14787,14871,15237,14784,15078,15674,14749,105180
14620,24902,25310,25689,26110,25960,26780,25141,179892
14621,34095,34618,34576,33789,33133,33393,33802,237406
14622,11952,11804,12042,12040,11808,11882,12108,83636
14623,25923,25445,26003,25877,26462,26047,27173,182930
14624,35694,35851,35918,36097,35755,36523,36296,252134
14625,10354,10185,9990,10484,10563,10493,10387,72456
14626,30500,29645,29735,29724,29627,28759,30041,208031
14627,2506,2592,2703,2781,2780,2888,2320,18570
14701,40070,40325,40232,40048,40408,40485,40730,282298
14706,6198,6242,6294,6301,6359,6233,6356,43983
14707,193,225,261,289,274,278,239,1759
14708,209,164,264,273,311,267,183,1671
14709,1552,1550,1617,1514,1486,1548,1535,10802
14710,3237,3247,3359,3479,3569,3491,3540,23922
14711,2031,2013,1976,1835,1621,1600,1766,12842
14712,3384,3308,3483,3586,3522,3568,3342,24193
14714,524,500,464,572,555,551,487,3653
14715,2824,2747,2816,2763,2833,2944,2747,19674
14716,3114,3025,3100,3040,3046,3230,3104,21659
14717,510,581,602,683,638,701,636,4351
14718,2354,2376,2195,2320,2197,2124,2163,15729
14719,3547,3410,3501,3530,3638,3470,3497,24593
14720,712,699,603,724,758,717,675,4888
14721,119,113,78,104,145,184,230,973
14722,381,441,430,407,309,241,153,2362
14723,1113,1090,1149,1193,1243,1189,1295,8272
14724,2505,2446,2486,2465,2424,2500,2540,17366
14726,2146,2039,2193,2155,2080,1988,2156,14757
14727,5137,5152,5161,5090,5335,5370,5450,36695
14728,932,758,801,729,949,792,1031,5992
14729,813,788,853,902,960,971,948,6235
14731,1243,1510,1374,1302,1267,1325,1576,9597
14732,124,137,135,157,135,153,211,1052
14733,3856,4018,4352,4216,4128,4238,3833,28641
14735,2763,2723,2627,2626,2812,2806,2751,19108
14736,243,249,240,150,180,232,282,1576
14737,4139,4142,3997,3998,4085,4113,4252,28726
14738,3531,3551,3641,3700,3701,3695,3651,25470
14739,2766,2883,2699,2636,2911,2901,2903,19699
14740,1367,1406,1496,1639,1673,1659,1431,10671
14741,2297,2275,2218,2412,2226,2000,1873,15301
14742,316,296,215,247,253,265,314,1906
14743,1683,1890,1890,1896,1680,1828,1783,12650
14744,2259,2193,2265,2310,2255,2086,2094,15462
14747,2229,2216,2261,2192,2203,2171,2289,15561
14748,742,822,793,851,1011,957,746,5922
14750,4300,4269,4309,4448,4358,4337,4426,30447
14752,198,196,185,174,181,256,169,1359
14753,1041,1035,1065,978,1009,1057,1166,7351
14754,585,569,565,666,637,642,667,4331
14755,3122,3173,3120,3268,3056,3230,2916,21885
14756,103,184,164,105,100,96,110,862
14757,3405,3572,3520,3496,3441,3405,3487,24326
14760,18235,18253,18208,18523,18439,18506,18775,128939
14767,1913,2009,2021,1927,2022,2080,2088,14060
14769,927,1005,964,1017,983,970,919,6785
14770,2836,2765,2836,2896,2972,3041,2963,20309
14772,3916,4027,4087,3945,4093,4128,4255,28451
14774,143,213,200,260,267,228,151,1462
14775,2461,2323,2284,2294,2316,2319,2537,16534
14777,550,632,656,654,622,590,667,4371
14778,1428,1416,1388,1451,1487,1732,1453,10355
14779,6672,6598,6629,6633,6691,6704,6932,46859
14781,2119,2108,2181,2437,2204,2215,2225,15489
14782,2549,2626,2680,2762,2826,2878,2401,18722
14783,351,330,350,373,329,330,320,2383
14784,718,817,766,708,824,943,1033,5809
14787,4929,5080,5030,5074,5137,5132,5121,35503
14788,209,222,245,232,146,109,163,1326
14801,5611,5652,5638,5525,5452,5435,5475,38788
14802,4273,4287,4260,4324,4410,4374,4135,30063
14803,855,964,956,917,871,974,1174,6711
14804,1464,1588,1662,1636,1645,1461,1479,10935
14805,1049,1023,944,1026,948,1038,1100,7128
14806,2267,2136,2149,2161,2200,2330,2269,15512
14807,2836,2744,2764,3088,2884,2823,3076,20215
14808,494,539,475,438,473,485,591,3495
14809,2363,2413,2413,2345,2314,2476,2552,16876
14810,12621,12523,12444,12516,12418,12325,12356,87203
14812,3231,3332,3369,3339,3596,3393,3478,23738
14813,2449,2478,2559,2685,2577,2531,2520,17799
14814,1850,1803,1984,2165,2287,1991,1931,14011
14815,988,986,870,1034,956,1093,946,6873
14816,519,453,442,293,616,610,520,3453
14817,2494,2336,2151,2261,2273,2118,2380,16013
14818,1804,1861,1598,1836,1834,1840,1745,12518
14819,801,729,773,822,944,897,733,5699
14820,834,717,655,631,689,646,784,4956
14821,3193,3090,2967,3218,3265,3279,3314,22326
14822,1297,1282,1415,1391,1224,1250,1169,9028
14823,3660,3661,3617,3639,3704,3689,3754,25724
14824,424,477,654,787,761,775,678,4556
14825,781,900,1007,1032,1093,1155,919,6887
14826,1982,2166,2264,2148,2168,2257,2216,15201
14827,98,132,95,100,37,79,191,732
14830,19965,20051,19679,19734,19636,19838,19850,138753
14836,910,1019,1127,1124,1067,1036,1009,7292
14837,5653,5525,5569,5661,5425,5558,5648,39039
14838,2056,2064,2160,2010,1924,1676,1956,13846
14839,819,749,744,750,771,711,793,5337
14840,2866,3031,3110,3157,3135,3052,3061,21412
14841,599,701,909,973,1012,1003,915,6112
14842,940,828,808,987,956,919,938,6376
14843,12968,13001,13052,12919,13065,13175,13043,91223
14845,20728,21088,20961,20838,20350,20674,20453,145092
14846,824,756,785,789,741,721,792,5408
14847,2388,2376,2282,2276,2339,2308,2398,16367
14850,66159,65756,65647,64877,64394,64133,63886,454852
14853,2864,2798,2883,2781,2769,2773,2755,19623
14854,28,15,15,17,0,9,37,121
14855,1083,992,1002,988,810,815,956,6646
14856,234,118,100,134,129,127,215,1057
14858,1627,1666,1713,1692,1863,1560,1598,11719
14859,723,831,800,913,974,1041,1029,6311
14860,1235,1240,1270,1236,1214,983,1039,8217
14861,1215,1294,1305,1244,1263,1282,1404,9007
14864,1156,1141,1107,1131,1260,1378,1307,8480
14865,3005,2825,2787,2582,2643,2466,2607,18915
14867,5800,5846,5738,5722,5619,5497,5569,39791
14869,1359,1257,1343,1383,1396,1398,1378,9514
14870,9938,10032,10647,10366,10131,9749,9821,70684
14871,5294,5474,5561,5419,5278,5154,5456,37636
14872,769,638,650,798,775,816,605,5051
14873,2662,2768,2832,2652,2457,2444,2448,18263
14874,255,230,166,265,283,320,250,1769
14877,372,456,460,411,467,446,401,3013
14878,603,623,590,683,834,779,781,4893
14879,1999,2138,2231,2105,2165,2325,2398,15361
14880,1407,1339,1272,1488,1579,1449,1668,10202
14881,287,278,271,71,100,64,192,1263
14882,3985,4024,3939,3867,3919,3714,3826,27274
14883,3920,3892,4056,4379,4355,4821,4136,29559
14884,223,183,185,199,223,291,273,1577
14885,748,892,880,980,1091,1130,873,6594
14886,7269,7393,7236,6626,6722,6787,6753,48786
14889,1779,1638,1594,1549,1508,1363,1590,11021
14891,4310,4539,4655,4473,4448,4382,4149,30956
14892,8299,8146,8000,8074,7960,7934,8189,56602
14893,6,12,12,11,6,6,6,59
14894,1325,1424,1311,1337,1477,1497,1454,9825
14895,9446,9742,9802,9692,9591,9723,9616,67612
14897,846,887,921,853,939,919,980,6345
14898,1826,1918,2021,2083,2120,2287,1734,13989
14901,16334,16855,17019,17495,16658,16750,16736,117847
14903,7143,6985,6805,6943,6927,7030,7567,49400
14904,15782,15224,15411,15519,15806,15992,16269,110003
14905,9150,9311,9414,9255,9897,9742,9070,65839
15001,31945,32307,32188,32573,32722,32769,31964,226468
15003,11440,11504,11465,11613,11789,12170,11861,81842
15004,307,310,252,211,166,147,351,1744
15005,9692,9973,9783,9659,9453,9323,9450,67333
15006,330,464,486,329,215,213,240,2277
15007,252,256,254,334,312,392,323,2123
15009,15206,15311,15218,15236,15084,15095,15082,106232
15010,28545,28285,28232,28115,28476,28375,28425,198453
15012,15957,15727,15786,16060,16243,16133,15905,111811
15014,3155,3188,3203,3184,3204,3218,3184,22336
15015,1230,1202,1249,1225,1228,1183,1175,8492
15017,16495,16269,15830,15518,15846,16224,16213,112395
15018,813,701,655,668,710,835,821,5203
15019,1620,1598,1726,1892,1900,1976,1719,12431
15020,267,276,237,152,121,175,231,1459
15021,7767,7669,7772,7662,7926,7887,7352,54035
15022,9977,9986,10195,10181,10061,10171,10340,70911
15024,8628,8799,8721,8541,8603,8712,9029,61033
15025,16379,16426,16262,16089,16098,15745,15944,112943
15026,3452,3384,3275,3116,3021,3118,3390,22756
15027,2141,2206,2174,2082,2103,2134,2201,15041
15028,166,175,148,130,129,94,142,984
15030,1024,1069,1019,1040,1054,1009,1128,7343
15031,588,619,569,554,488,314,513,3645
15033,4910,4821,4877,4978,4981,5047,4910,34524
15034,1741,1864,1821,1838,1859,1948,1792,12863
15035,2111,2140,2233,2222,2182,2238,2129,15255
15037,10929,11041,11129,11037,11384,11089,10894,77503
15038,356,290,345,309,354,286,325,2265
15042,8517,8185,7874,8068,8155,8210,8105,57114
15043,2104,2024,2254,2680,2465,2263,2458,16248
15044,28016,27109,27319,26934,26292,26127,27049,188846
15045,4444,4454,4485,4481,4495,4502,4483,31344
15046,2607,2636,2637,2628,2619,2597,2640,18364
15047,82,69,26,0,0,0,151,328
15049,859,847,917,954,933,901,895,6306
15050,2550,2396,2415,2285,2535,2688,2431,17300
15051,375,334,294,359,523,485,461,2831
15052,3446,3557,3583,3451,3432,3550,3483,24502
15053,164,109,155,217,121,107,154,1027
15054,398,457,460,423,379,334,375,2826
15055,1099,1332,1324,1201,1284,1288,1360,8888
15056,1214,1201,1199,1136,1123,1104,1140,8117
15057,15485,15085,14900,14946,14362,13684,13930,102392
15059,4003,3944,4095,4231,4264,4239,4193,28969
15060,786,793,800,798,901,792,790,5660
15061,12363,12320,12510,12339,12434,12621,12799,87386
15062,7530,7584,7630,7682,7732,7817,7731,53706
15063,11178,11183,11104,11408,11435,11327,11677,79312
15064,252,468,502,539,578,466,382,3187
15065,11674,11684,11650,11723,11823,11742,11588,81884
15066,12687,12451,12714,12916,12682,12652,12785,88887
15067,2196,2136,2254,2367,2423,2274,2281,15931
15068,38224,38214,38256,38292,38270,38120,38785,268161
15071,10583,10294,10274,9897,9850,9567,9956,70421
15072,139,158,143,119,76,115,101,851
15074,8495,8988,9095,8846,9169,9118,8874,62585
15075,228,228,72,70,74,48,128,848
15076,884,1027,1192,1191,1074,1084,849,7301
15077,143,164,143,116,163,166,198,1093
15078,361,421,297,305,329,299,523,2535
15081,394,449,414,342,345,417,475,2836
15082,149,131,132,142,191,167,350,1262
15083,850,914,843,823,821,912,952,6115
15084,9798,9693,9879,9754,9699,9439,10130,68392
15085,7738,7824,7526,7579,7522,7540,7944,53673
15086,318,342,302,298,381,390,300,2331
15087,220,229,191,290,289,238,234,1691
15088,515,565,636,791,775,809,535,4626
15089,6154,6042,5898,5586,5797,6134,6262,41873
15090,23811,23103,22501,22369,21290,20585,21202,154861
15101,24506,25015,24422,24988,25717,25632,24292,174572
15102,29818,29706,29744,29988,29736,29638,29529,208159
15104,8839,8878,8913,9339,9232,9326,9038,63565
15106,19299,19305,19043,19090,18753,18711,18536,132737
15108,42037,42123,41570,40774,39880,39373,40153,285910
15110,5534,5556,5558,5581,5639,5717,5565,39150
15112,3168,3358,3564,3372,3320,3437,3292,23511
15116,14426,14064,14305,14403,13912,14022,14427,99559
15120,18492,18627,18678,18952,19080,19235,18931,131995
15122,19909,20004,20120,20123,20298,20340,20131,140925
15126,7392,6847,6848,6646,6881,6915,7014,48543
15129,10595,10721,10789,10844,10771,10839,10920,75479
15131,8265,8388,8375,8335,8335,8324,8240,58262
15132,21577,21627,21524,21456,21634,21916,21472,151206
15133,6314,6337,6355,6443,6466,6476,6432,44823
15135,5229,5338,5433,5304,5272,5305,5139,37020
15136,22119,22058,21999,21901,21661,21764,21849,153351
15137,9987,10030,10138,10123,10106,10129,10228,70741
15139,6420,6398,6358,6340,6323,6346,6307,44492
15140,3259,3270,3283,3295,3297,3316,3294,23014
15142,1298,1286,1284,1358,1437,1120,1163,8946
15143,20057,19516,20342,20162,20009,19276,19660,139022
15144,4124,4165,4104,4081,4024,4056,4142,28696
15145,7150,7144,7323,7388,7535,7516,7132,51188
15146,28238,28508,28486,28380,28366,28332,28323,198633
15147,17586,17723,17494,17314,17782,17593,17395,122887
15148,2651,2557,2492,2628,2582,2672,2814,18396
15201,12805,13349,13162,13688,12542,12667,12713,90926
15202,19354,19473,19506,19654,19579,19762,19685,137013
15203,10015,9570,9992,10134,9884,10529,9949,70073
15204,8554,9028,8077,7647,8066,7683,8329,57384
15205,22415,22476,22676,22459,22312,22479,21865,156682
15206,28954,29131,29196,29098,29504,29930,28615,204428
15207,12583,11969,11962,11245,11263,11564,11268,81854
15208,10304,9852,9844,9941,9873,9822,10406,70042
15209,12382,12694,12796,12875,12857,12912,12438,88954
15210,26716,27007,27290,27573,27308,26554,25954,188402
15211,10984,11036,11186,11428,11622,11549,11081,78886
15212,26331,27078,27620,28243,29296,29024,27895,195487
15213,27708,27656,28417,28400,28566,28630,30844,200221
15214,14007,14451,14804,14535,15002,15451,14352,102602
15215,12389,12656,12494,12834,12672,12718,12615,88378
15216,22889,22953,23092,23054,23194,23442,23350,161974
15217,28105,28370,27550,27439,27045,27402,27220,193131
15218,13757,13860,13815,13877,13813,13790,13851,96763
15219,16010,15731,15624,15410,15894,16002,16696,111367
15220,17805,17833,17643,17637,17448,17364,17718,123448
15221,31017,31177,31046,31099,31147,31323,31060,217869
15222,4196,3954,3638,3550,2994,2706,3294,24332
15223,6837,6829,6883,6737,6922,6824,7236,48268
15224,10791,10672,10780,10148,10504,10896,10141,73932
15225,1145,1097,1088,1086,1068,1103,1084,7671
15226,13618,13651,13842,13715,13432,14132,13974,96364
15227,28786,28375,28273,28399,27772,27761,28156,197522
15228,18135,17838,18173,18099,17864,17668,17595,125372
15229,13883,14115,13836,14024,13953,13906,13825,97542
15232,11691,11711,11451,11894,12114,11326,11374,81561
15233,4406,4505,4220,4387,4164,4382,4451,30515
15234,13483,14007,14353,14146,14226,14328,14056,98599
15235,34136,33671,33926,34257,34208,34836,34580,239614
15236,29493,29875,29894,29836,30324,30305,29724,209451
15237,42651,42549,41733,40891,41101,40750,41895,291570
15238,13329,12943,12959,12654,12821,12544,13162,90412
15239,21212,21564,21394,21418,21179,21007,21024,148798
15241,20523,20481,20186,20069,20075,20213,20395,141942
15243,13224,13471,13427,13220,13468,13060,13406,93276
15260,0,0,0,0,0,0,0,0
15290,0,0,0,0,0,0,0,0
15301,49395,49483,49565,49266,49279,48980,49331,345299
15310,297,291,282,323,291,283,290,2057
15311,1479,1433,1401,1423,1396,1471,1391,9994
15312,3690,3735,3851,3745,3609,3733,3579,25942
15313,373,365,390,342,317,313,377,2477
15314,3843,4003,3900,3923,3799,3798,3788,27054
15315,711,800,821,785,850,945,776,5688
15316,102,108,106,118,100,82,131,747
15317,37420,36968,36860,36569,36133,35878,36535,256363
15320,5161,5035,5201,5285,5326,5807,5384,37199
15321,1484,1557,1498,1447,1480,1527,1676,10669
15322,2037,2353,2352,2167,2224,2111,2018,15262
15323,4547,4687,4237,4271,4351,4403,4542,31038
15324,525,596,597,571,661,701,632,4283
15325,542,548,505,466,480,521,439,3501
15327,1545,1507,1380,1287,1257,1249,1527,9752
15329,1523,1541,1715,1718,1733,1878,1709,11817
15330,5525,5644,5634,5538,5271,5299,5299,38210
15331,726,772,816,931,1016,1060,1090,6411
15332,8051,7985,8074,8170,8249,8452,8148,57129
15333,2589,2362,2271,2232,2262,2278,2150,16144
15334,170,224,160,142,113,131,113,1053
15337,598,615,669,708,712,735,744,4781
15338,1644,1515,1565,1569,1654,1619,1606,11172
15340,1359,1429,1295,1455,1701,1793,1469,10501
15341,838,843,931,962,898,888,869,6229
15342,5070,4941,4751,4834,4995,4918,4818,34327
15344,1352,1414,1509,1517,1623,1683,1450,10548
15345,1484,1589,1684,1727,1681,1777,1642,11584
15346,522,520,553,531,592,629,749,4096
15347,562,555,405,391,230,380,582,3105
15348,402,282,245,244,192,165,283,1813
15349,1805,1780,1771,1815,1849,1622,1737,12379
15350,437,451,398,578,494,461,425,3244
15351,664,728,539,719,900,653,901,5104
15352,882,808,822,847,917,948,987,6211
15353,64,26,38,38,46,48,64,324
15357,1664,1628,1731,1766,1427,1382,1661,11259
15358,788,989,1167,1255,1230,1169,923,7521
15359,186,149,150,175,138,155,174,1127
15360,1702,1658,1767,1704,1731,1807,1731,12100
15361,51,67,48,43,41,41,151,442
15362,693,812,816,794,786,813,767,5481
15363,597,713,738,707,984,1327,760,5826
15364,750,809,755,798,835,947,869,5763
15366,183,151,139,274,322,546,164,1779
15367,9521,9084,9202,9300,8839,8315,8731,62992
15368,227,331,269,348,278,294,473,2220
15370,15001,15182,15278,15132,15118,15002,14870,105583
15376,1535,1546,1771,1813,1919,1988,1740,12312
15377,784,760,831,752,669,641,724,5161
15378,99,95,88,0,0,104,106,492
15379,128,110,104,88,129,115,132,806
15380,586,605,595,758,816,760,719,4839
15401,31859,31747,31749,31654,31878,32550,32288,223725
15410,1098,838,868,684,659,601,905,5653
15411,720,797,734,635,640,498,661,4685
15412,424,416,389,297,291,304,470,2591
15413,508,631,535,485,654,617,551,3981
15417,8802,8548,8548,8798,8175,8101,9469,60441
15419,4548,5033,4766,4774,4706,4679,4492,32998
15420,306,481,397,400,457,282,251,2574
15421,23,25,102,187,132,121,112,702
15422,220,216,179,107,299,127,220,1368
15423,2450,2258,2149,2351,2601,2502,1781,16092
15424,2187,2184,2458,2765,2745,2893,2489,17721
15425,19245,19348,19406,19505,19374,19412,19270,135560
15427,1149,1182,1415,1361,1233,1285,1091,8716
15428,2060,1947,1836,1794,1835,1679,1806,12957
15429,251,240,181,158,148,100,126,1204
15430,348,291,184,202,147,139,314,1625
15431,3844,4151,4199,4119,4407,4814,4744,30278
15432,449,440,444,394,380,360,427,2894
15433,857,799,805,910,841,870,741,5823
15434,299,292,321,343,295,290,313,2153
15435,671,577,642,532,429,711,437,3999
15436,2520,2481,2560,2502,2642,2574,2740,18019
15437,2666,2546,2424,2473,2470,2352,2573,17504
15438,1920,2059,2096,1992,2115,2099,2221,14502
15440,181,347,292,364,297,575,349,2405
15442,1752,1685,1774,2142,2331,2386,2105,14175
15443,176,276,299,307,237,77,377,1749
15444,376,347,337,283,525,436,517,2821
15445,2615,2453,2409,2728,2565,2775,2693,18238
15446,237,231,229,206,169,181,324,1577
15447,11,108,116,115,293,268,181,1092
15448,230,165,176,309,407,386,192,1865
15449,492,461,364,173,180,109,184,1963
15450,2135,2160,2214,2232,2117,2251,2323,15432
15451,1185,1089,1042,1085,1027,1139,955,7522
15454,81,376,377,315,384,263,237,2033
15455,606,350,391,429,377,404,298,2855
15456,2874,2713,2691,3113,3279,3118,2976,20764
15458,2409,2516,2728,2748,2603,2694,2379,18077
15459,1527,1488,1436,1305,1347,1519,1763,10385
15460,105,105,97,77,140,134,120,778
15461,4258,4003,4122,4130,4104,4191,4333,29141
15462,616,544,337,254,451,534,398,3134
15463,0,0,0,0,0,0,64,64
15464,1772,1732,1598,1558,1613,1515,1536,11324
15466,461,478,463,447,424,425,458,3156
15467,131,127,144,126,89,86,141,844
15468,2513,2425,2339,2399,2096,2171,2303,16246
15469,2153,2237,2523,2378,2342,2441,2331,16405
15470,954,992,1154,1086,1173,1067,982,7408
15472,261,425,442,241,367,320,306,2362
15473,4103,4281,4249,4297,3956,3769,3862,28517
15474,1788,1899,1972,1870,2099,1864,2049,13541
15475,1255,1157,1344,1279,1388,1487,1356,9266
15476,69,60,62,43,166,157,157,714
15477,794,834,742,693,708,729,855,5355
15478,6145,6680,6687,6918,6636,6722,6446,46234
15479,2004,2089,2036,2071,2179,2096,2113,14588
15480,1701,1645,1985,2182,2415,2464,1946,14338
15482,475,455,544,505,672,714,604,3969
15483,398,380,447,484,512,513,513,3247
15484,157,234,498,553,632,633,328,3035
15486,2302,2361,2038,2076,1891,1892,2303,14863
15489,353,425,327,329,373,416,389,2612
15490,638,717,763,1001,1108,967,628,5822
15492,128,134,136,118,83,65,108,772
15501,16370,16440,16641,16594,16528,16582,16861,116016
15502,99,130,128,117,128,139,191,932
15510,2468,2433,2327,2265,2223,2215,2229,16160
15520,292,257,264,273,452,340,293,2171
15521,1903,2005,1973,2040,2070,2077,1872,13940
15522,11804,11807,11664,11815,11641,12073,12036,82840
15530,5307,5245,5300,5160,5187,5454,5368,37021
15531,4262,4303,4176,4136,3992,4261,3861,28991
15532,229,219,227,267,279,217,142,1580
15533,1387,1417,1403,1506,1477,1504,1370,10064
15534,880,885,888,823,865,897,932,6170
15535,1973,1997,2055,2068,2085,1981,2203,14362
15536,480,474,483,414,440,430,459,3180
15537,8055,7763,8088,7902,8004,7957,7952,55721
15538,796,782,797,739,802,806,824,5546
15539,753,766,945,575,625,615,498,4777
15540,205,198,230,228,278,349,290,1778
15541,3630,3763,3691,4014,4085,4024,3721,26928
15542,1104,1118,1072,1014,956,1039,1175,7478
15544,179,186,147,151,134,123,264,1184
15545,2742,2892,2825,2991,3021,3077,2879,20427
15546,306,298,405,512,455,378,386,2740
15547,353,401,453,417,439,380,504,2947
15550,1578,1608,1632,1551,1627,1661,1699,11356
15551,841,932,927,913,927,904,860,6304
15552,5896,5929,5918,6131,6401,6265,6115,42655
15554,2298,2386,2379,2436,2409,2320,2553,16781
15555,115,115,93,64,46,31,112,576
15557,3516,3449,3585,3669,3651,3686,3684,25240
15558,2487,2380,2287,2197,2206,2044,2126,15727
15559,1950,1994,1877,2002,1960,1922,1968,13673
15560,177,180,179,178,203,209,175,1301
15561,176,155,142,133,132,129,168,1035
15562,178,157,160,190,168,197,201,1251
15563,3222,3225,3267,3115,3093,3107,3345,22374
15564,109,90,78,91,89,50,50,557
15601,57917,58276,58187,59313,59819,60278,59483,413273
15610,3799,3667,3655,3650,3524,3570,3738,25603
15611,779,453,566,526,522,486,543,3875
15612,358,265,296,206,165,347,474,2111
15613,14354,14191,13954,14178,14446,14194,13933,99250
15615,308,261,369,364,457,395,387,2541
15616,95,95,109,134,273,86,23,815
15617,383,332,368,433,513,475,367,2871
15618,2557,2626,2823,2661,2558,2619,2634,18478
15620,1047,1043,1094,1008,932,609,911,6644
15621,112,95,98,30,44,0,47,426
15622,1045,1300,1373,1382,1380,1481,1387,9348
15623,656,749,832,779,781,826,762,5385
15624,258,476,423,339,346,635,410,2887
15625,111,116,93,108,24,52,144,648
15626,5179,4938,5072,5356,4854,5104,5105,35608
15627,6597,6489,6495,6438,6361,6219,6544,45143
15628,657,547,517,712,786,821,525,4565
15629,866,742,705,688,592,683,676,4952
15631,1059,1079,1194,1057,1230,1280,1075,7974
15632,9074,9269,9347,9268,9454,9452,9363,65227
15633,318,259,228,259,266,389,293,2012
15634,584,573,739,815,639,581,523,4454
15635,135,173,156,101,98,75,220,958
15636,3836,4070,4054,3855,4189,4310,3946,28260
15637,2045,1991,2003,2191,1877,1736,1861,13704
15638,452,479,437,386,295,353,288,2690
15639,2256,2307,2142,2270,2412,2149,2301,15837
15640,562,560,566,625,788,729,378,4208
15641,451,426,486,503,469,470,500,3305
15642,44960,45132,45301,45544,45361,45590,45286,317174
15644,18487,18790,19515,19355,19309,19050,18836,133342
15646,224,200,192,199,194,151,233,1393
15647,177,147,136,276,190,212,314,1452
15650,27671,28005,28440,28469,28805,28080,28432,197902
15655,354,384,382,288,545,552,423,2928
15656,10044,10025,10071,10208,10108,10463,10298,71217
15658,8484,8736,8849,8704,8419,8564,8916,60672
15660,344,349,395,409,357,378,323,2555
15661,650,551,500,525,477,490,504,3697
15662,173,331,342,357,206,284,271,1964
15663,365,418,445,553,496,530,455,3262
15665,1784,1739,1765,1915,1625,1580,1472,11880
15666,16135,16370,16454,16538,16497,16869,16461,115324
15668,13267,13329,13450,13579,13508,13121,13139,93393
15670,3599,3550,3372,3152,3170,2982,3649,23474
15671,597,680,685,841,964,1122,865,5754
15672,3579,3624,3670,3339,3578,3622,3334,24746
15673,1311,1419,1423,1327,1374,1410,1296,9560
15675,1177,1264,1279,971,977,1049,1003,7720
15676,427,303,276,251,151,398,437,2243
15677,469,486,535,486,360,454,389,3179
15678,361,304,247,231,324,311,476,2254
15679,2766,3256,3600,3594,3610,3538,3343,23707
15680,147,125,130,110,114,134,101,861
15681,4797,5026,4849,4997,4938,4713,5241,34561
15683,8129,8073,8006,8210,8302,8125,8248,57093
15684,562,532,640,570,810,864,841,4819
15686,725,888,1043,976,970,959,972,6533
15687,1209,1148,1174,1194,1071,1144,1476,8416
15688,1017,861,786,725,569,593,641,5192
15689,258,282,275,191,195,96,229,1526
15690,8597,8654,8790,8858,9037,9226,9078,62240
15691,85,93,31,27,33,77,70,416
15692,1041,973,772,769,743,750,941,5989
15693,214,217,182,238,153,248,189,1441
15695,352,216,205,183,193,259,337,1745
15696,360,373,335,321,293,334,384,2400
15697,2940,2944,2980,2990,3056,3091,3038,21039
15698,685,801,724,744,666,638,791,5049
15701,34705,35090,34835,34509,34692,34811,34704,243346
15710,258,336,315,322,342,313,266,2152
15711,466,458,423,523,498,466,412,3246
15712,137,124,120,117,192,233,151,1074
15713,117,172,127,221,181,149,294,1261
15714,5170,5162,5077,5021,4990,4910,5323,35653
15715,542,605,625,671,649,657,621,4370
15716,793,562,757,801,654,726,683,4976
15717,10494,10823,11008,11020,11148,11042,10847,76382
15721,201,216,258,214,243,240,234,1606
15722,2334,2316,2159,2166,2203,2347,2432,15957
15723,22,36,37,39,38,31,46,249
15724,2234,2160,2152,2260,2273,2490,2412,15981
15725,1581,1488,1499,1494,1328,1230,1446,10066
15727,177,160,130,127,144,134,168,1040
15728,3580,3609,3326,3122,3167,3358,3701,23863
15729,1450,1517,1638,1699,1614,1578,1537,11033
15730,62,58,67,43,46,57,69,402
15731,494,578,562,418,315,476,315,3158
15732,1737,1871,1801,1755,1691,1817,1669,12341
15733,125,114,133,116,115,107,108,818
15734,296,251,227,239,343,307,322,1985
15736,753,780,718,668,604,592,613,4728
15737,107,110,103,125,119,111,83,758
15738,188,197,222,234,185,213,265,1504
15739,403,355,343,359,340,308,462,2570
15741,44,77,80,75,69,120,83,548
15742,1073,978,1027,965,901,1009,950,6903
15744,189,143,152,140,147,91,105,967
15745,174,209,244,371,472,391,337,2198
15746,133,106,124,154,158,161,135,971
15747,1894,1844,1947,2034,2093,2099,2027,13938
15748,6816,6800,6665,6766,7187,7297,7060,48591
15750,397,466,221,144,129,47,245,1649
15752,20,53,79,75,87,84,54,452
15753,542,523,559,564,576,515,513,3792
15754,578,395,326,505,512,700,502,3518
15756,248,244,285,212,209,209,207,1614
15757,1512,1580,1529,1539,1505,1591,1618,10874
15759,3130,2971,3020,3152,2975,2864,3004,21116
15760,97,87,117,132,141,157,152,883
15761,101,119,81,44,44,83,111,583
15762,993,900,863,907,771,838,823,6095
15764,174,185,118,109,90,109,163,948
15765,1809,1842,1989,1916,1808,1687,1707,12758
15767,14655,14560,14530,14536,14465,14631,14668,102045
15770,241,151,178,256,314,277,184,1601
15771,933,899,961,1086,1050,916,991,6836
15772,1641,1657,1702,1622,1731,1740,1715,11808
15773,493,492,492,471,462,464,516,3390
15774,3105,3007,3354,3438,3297,3246,3029,22476
15775,678,651,673,735,889,868,751,5245
15776,62,55,66,60,58,47,52,400
15777,124,131,125,148,95,97,170,890
15778,180,188,141,118,128,149,140,1044
15779,667,503,314,266,251,122,414,2537
15780,171,167,151,151,127,154,148,1069
15781,87,70,52,65,73,61,94,502
15783,86,76,82,90,78,70,140,622
15784,55,69,69,68,69,77,67,474
15801,19266,19302,19327,19488,19391,19311,19270,135355
15821,156,163,170,175,157,160,164,1145
15823,1481,1543,1521,1575,1611,1453,1431,10615
15824,5119,5174,5215,5152,5284,5339,5407,36690
15825,9151,9334,9682,9739,9800,9853,9562,67121
15827,270,244,324,298,344,349,231,2060
15828,254,276,281,376,368,354,286,2195
15829,1498,1259,1325,1308,1158,1286,1274,9108
15832,297,313,336,354,281,267,328,2176
15834,4328,4372,4428,4457,4567,4650,4533,31335
15840,2087,2011,1982,1867,1882,1843,1993,13665
15841,267,399,398,417,440,496,389,2806
15845,3094,3150,3109,3379,3529,3449,3197,22907
15846,3673,3658,3749,3702,3681,3616,3636,25715
15847,221,174,201,187,221,311,255,1570
15848,1317,1138,1004,1041,1096,1027,1027,7650
15849,1232,1251,1316,1145,1225,1372,1399,8940
15851,6693,6764,6468,6633,6742,6645,6671,46616
15853,6318,6284,6270,6278,6190,6507,6578,44425
15856,895,870,846,866,908,956,889,6230
15857,12905,13005,13054,13140,13232,13354,13212,91902
15860,1084,1064,1007,983,931,897,1065,7031
15861,125,121,106,138,155,155,174,974
15863,274,232,201,173,145,166,225,1416
15864,1678,1770,1721,1757,1833,1717,1845,12321
15865,1304,1362,1471,1410,1378,1340,1295,9560
15866,203,192,190,227,241,286,261,1600
15868,1365,1364,1410,1287,1256,1322,1350,9354
15870,1246,1245,1283,1345,1290,1394,1326,9129
15901,3507,3840,3934,4063,4077,4107,4190,27718
15902,11685,11889,12217,12762,13035,12777,12513,86878
15904,15834,15795,16310,16269,16475,16545,16608,113836
15905,20331,20306,20547,20790,20971,21086,21226,145257
15906,11549,11705,11603,11173,11156,11367,11144,79697
15909,5245,5403,5325,5410,5397,5734,5611,38125
15920,811,941,1006,877,933,792,922,6282
15921,119,158,195,211,235,192,176,1286
15922,206,191,187,181,162,106,177,1210
15923,1594,1646,1707,1733,1769,1911,1770,12130
15924,1031,1013,930,970,965,1007,1034,6950
15925,151,155,121,158,154,173,147,1059
15926,2472,2519,2581,2594,2688,2605,2676,18135
15927,853,780,802,839,819,1067,1176,6336
15928,1990,2125,2183,2432,2236,2317,1974,15257
15929,69,95,75,89,73,53,75,529
15930,200,114,127,156,163,73,241,1074
15931,8946,9060,9189,9453,9483,9032,9148,64311
15934,335,339,346,89,148,280,218,1755
15935,2517,2569,2559,2635,2524,2748,2620,18172
15936,1265,1439,1562,1597,1678,1731,1620,10892
15937,881,767,746,601,756,590,779,5120
15938,2369,2338,2488,2512,2496,2431,2583,17217
15940,4264,3929,4015,3962,4027,4112,3992,28301
15942,2197,2195,2106,1924,2091,2050,2079,14642
15943,3615,3702,3802,4048,4103,4258,3942,27470
15944,3271,3277,3567,3723,3939,3933,3472,25182
15945,149,157,180,220,222,176,198,1302
15946,6757,6938,7092,6987,6997,7190,7093,49054
15948,781,620,652,618,637,626,550,4484
15949,536,644,603,499,516,605,672,4075
15951,663,691,451,497,173,198,453,3126
15952,1483,1193,1300,1337,1431,1605,1413,9762
15953,273,303,199,177,158,145,83,1338
15954,2179,2137,2253,2294,2496,2511,2413,16283
15955,2647,2773,2677,2943,3018,3030,2551,19639
15956,2483,2605,2643,2441,2544,2617,2739,18072
15957,612,603,613,575,635,688,755,4481
15958,2089,2136,2079,2092,2144,2180,2301,15021
15960,589,585,596,398,503,468,425,3564
15961,800,766,804,765,757,759,854,5505
15962,181,177,144,132,103,82,149,968
15963,10715,10988,10784,10949,10831,10882,11114,76263
16001,39534,39816,39554,39863,40381,40566,40371,280085
16002,15494,15780,15751,15637,15866,16105,15877,110510
16020,1172,1179,1200,1199,1131,1178,1150,8209
16022,359,366,402,488,480,445,368,2908
16023,4217,4285,4342,4371,4252,4230,4169,29866
16024,263,201,227,197,218,166,209,1481
16025,5487,5494,5711,5661,5673,5463,5564,39053
16027,248,267,313,288,269,240,306,1931
16028,1918,2000,2014,2127,2100,1912,1886,13957
16029,804,688,694,647,692,664,705,4894
16030,338,353,341,281,305,247,316,2181
16033,5787,5689,5622,5727,5885,5998,6165,40873
16034,2094,2068,1971,2070,2045,2052,2054,14354
16035,81,81,65,89,88,118,122,644
16036,206,223,251,270,252,219,200,1621
16037,4569,4538,4636,4614,4527,4749,4589,32222
16038,3655,3796,4013,3804,3753,3749,3517,26287
16040,856,879,861,959,1028,945,975,6503
16041,2047,2055,2023,1938,2000,2040,1888,13991
16045,1269,1384,1335,1449,1511,1337,1195,9480
16046,15628,15464,15261,14608,13694,13251,14396,102302
16048,154,172,161,154,139,132,139,1051
16049,2932,3198,3179,3355,3480,3609,3241,22994
16050,1567,1641,1625,1666,1546,1623,1546,11214
16051,2985,3097,3141,3242,3018,2897,3043,21423
16052,2501,2463,2356,2374,2233,2241,2447,16615
16053,4385,4135,4390,4130,4106,4046,4020,29212
16054,382,371,415,338,365,386,497,2754
16055,8593,8368,8311,8416,8412,8291,8486,58877
16056,4465,4609,4784,4792,5015,4999,4791,33455
16057,14447,14386,14028,13758,13635,13713,13909,97876
16059,7902,7775,7827,8207,8118,8041,7738,55608
16061,2509,2458,2668,2744,2718,2814,2761,18672
16063,6613,6712,6691,6669,6686,6766,6559,46696
16066,29737,29420,28976,28520,28130,27703,28060,200546
16101,33681,33709,33758,34561,34664,34216,34042,238631
16102,5985,5708,5700,5576,5589,5825,5755,40138
16105,14849,14976,14864,14742,15040,15471,15448,105390
16110,315,264,314,312,277,314,314,2110
16111,1417,1444,1536,1346,1159,1206,1409,9517
16112,1571,1612,1574,1700,1472,1648,1571,11148
16113,396,354,382,391,348,402,448,2721
16114,635,578,550,564,583,597,606,4113
16115,3077,3276,3289,3407,3271,3326,3287,22933
16116,2978,2840,2845,2734,2853,2824,3074,20148
16117,17274,17210,17039,17059,17028,17542,17185,120337
16120,1970,2088,2300,2348,2296,2346,2463,15811
16121,4764,4808,4856,4925,5010,5032,4941,34336
16123,2132,2178,2458,2284,2322,2214,2237,15825
16124,2074,1989,1796,1919,1876,2041,2228,13923
16125,17777,18163,17898,18141,18272,18676,18186,127113
16127,15861,15862,15989,15968,15889,15849,16145,111563
16130,1962,1902,1947,1979,1947,1946,2023,13706
16131,859,821,803,802,821,806,933,5845
16132,146,262,301,394,364,411,355,2233
16133,1617,1590,1515,1639,1557,1499,1573,10990
16134,3961,3960,4014,4133,4040,4226,3886,28220
16136,732,708,701,683,783,749,801,5157
16137,12873,12889,12881,12757,13049,12817,12941,90207
16140,11,68,133,211,215,217,123,978
16141,1956,2010,1902,1977,1908,1863,1806,13422
16142,7089,7192,7575,7487,7128,6916,7056,50443
16143,3050,3360,3106,3014,2969,2968,2901,21368
16145,2664,2560,2555,2537,2682,2795,2726,18519
16146,13659,13754,13865,13952,14080,14289,14040,97639
16148,16550,16642,16678,16838,16857,16815,16959,117339
16150,7198,7253,7328,7282,7378,7503,7426,51368
16151,87,96,70,80,100,112,77,622
16153,2483,2608,2662,2686,2595,2486,2624,18144
16154,2328,2448,2947,2780,2722,2696,2492,18413
16155,130,87,76,78,75,63,103,612
16156,2852,2864,2890,3015,3305,3316,3319,21561
16157,2990,3287,3519,3369,3618,3602,3477,23862
16159,4756,4578,4595,4593,4770,4755,4706,32753
16160,925,1036,899,906,851,817,864,6298
16161,860,855,838,729,706,602,644,5234
16201,17954,18078,18396,18057,18426,18289,18214,127414
16210,1056,1168,1137,1144,1175,1109,1014,7803
16211,114,109,91,78,99,84,104,679
16212,297,291,273,317,362,373,339,2252
16213,150,171,184,158,137,154,204,1158
16214,9644,9806,9794,9584,9863,9596,10127,68414
16217,82,87,124,140,158,142,101,834
16218,1213,1262,1170,1464,1291,1274,1195,8869
16222,2551,2319,2401,2466,2456,2604,2526,17323
16223,166,171,136,117,112,113,154,969
16224,1221,1365,1305,1328,1340,1277,1181,9017
16226,7750,7896,8062,8062,8043,8337,8279,56429
16228,446,435,451,427,376,419,371,2925
16229,4995,5100,5092,4997,5010,5085,4997,35276
16230,416,449,540,562,607,562,494,3630
16232,4380,4319,4251,4306,4370,4276,4281,30183
16233,1180,1065,1072,1096,919,1077,1246,7655
16235,1252,1216,1281,1230,1192,1089,1256,8516
16236,420,426,388,494,404,321,262,2715
16238,470,403,407,412,401,375,410,2878
16239,5442,5141,4785,4147,4091,4007,4172,31785
16240,1286,1446,1442,1373,1201,1226,1533,9507
16242,4641,4518,4565,4644,4576,4525,4693,32162
16244,197,142,147,186,195,271,265,1403
16245,206,196,182,170,184,180,207,1325
16246,243,240,212,231,283,285,252,1746
16248,2987,3178,3272,3242,3247,3322,3130,22378
16249,1914,2013,1928,2017,2035,1965,2089,13961
16250,347,268,152,166,295,285,315,1828
16253,95,83,104,73,122,107,91,675
16254,3217,3443,3498,3500,3575,3392,3471,24096
16255,1742,1692,1814,1896,1785,1880,1943,12752
16256,2213,2195,2090,2074,1873,2059,2084,14588
16258,1849,2048,1690,1852,1926,2268,1869,13502
16259,1865,1871,1957,1959,1881,1852,1934,13319
16260,284,387,422,455,380,298,296,2522
16262,2866,2813,2813,2883,3084,3085,3007,20551
16263,308,420,452,458,467,536,317,2958
16301,16033,16039,15915,15540,15984,16136,16321,111968
16311,555,613,570,562,515,453,564,3832
16312,3,3,3,3,17,15,25,69
16313,1662,1735,1887,2037,2205,2236,1848,13610
16314,5411,5443,5380,5425,5513,5528,5507,38207
16316,5378,5230,5213,5382,5435,5609,5436,37683
16317,1492,1567,1580,1691,1727,1511,1456,11024
16319,1322,1237,1230,1212,1247,1174,1355,8777
16321,52,64,76,134,166,137,76,705
16322,96,149,153,162,116,131,158,965
16323,15549,15872,16125,16480,16426,16994,16372,113818
16326,461,462,441,489,511,484,391,3239
16327,3186,3240,3163,3186,3176,3018,2978,21947
16328,103,90,68,78,97,117,80,633
16329,527,548,525,533,548,581,528,3790
16331,81,68,64,66,83,86,88,536
16332,53,69,48,45,59,56,53,383
16333,273,260,209,198,206,216,240,1602
16334,345,299,370,340,391,389,338,2472
16335,27960,28036,28244,28314,28259,28282,28445,197540
16340,1874,1947,1834,1748,1811,1937,1990,13141
16341,1905,1873,1897,2026,2046,2233,2030,14010
16342,2342,2334,2417,2354,2569,2546,2281,16843
16343,456,388,329,333,404,212,449,2571
16344,588,560,590,632,657,618,523,4168
16345,3432,3415,3337,3334,3310,3446,3543,23817
16346,3360,3542,3519,3674,3316,3311,3247,23969
16347,2524,2384,2493,2566,2518,2271,2238,16994
16350,2924,3009,3022,3010,2637,2517,2737,19856
16351,1489,1581,1541,1578,1503,1566,1716,10974
16352,257,239,284,201,245,265,245,1736
16353,2588,2615,2876,3127,3201,3218,3348,20973
16354,10957,11046,11327,11261,11246,11323,11379,78539
16360,1375,1365,1350,1417,1469,1527,1383,9886
16361,53,103,94,92,77,80,53,552
16362,1189,1264,1138,1259,1227,1227,1102,8406
16364,1258,1335,1182,1093,1118,1189,1347,8522
16365,18099,18124,18400,18521,18834,18952,18579,129509
16370,147,189,220,346,393,365,358,2018
16371,3109,3230,3269,3308,3315,3337,3260,22828
16372,448,430,405,435,389,362,499,2968
16373,3174,3298,3420,3184,3286,3277,3510,23149
16374,1980,1843,1788,1940,1940,1900,1968,13359
16401,6705,6706,6636,6718,6558,6648,6581,46552
16402,728,748,765,803,819,804,956,5623
16403,6656,6698,7006,7056,7107,6957,7029,48509
16404,3593,3588,3385,3273,3270,3201,3269,23579
16405,813,811,852,873,868,830,922,5969
16406,3221,3486,3467,3666,3562,3617,3509,24528
16407,10929,11035,11078,11159,11151,11300,11317,77969
16410,1709,1664,1743,1772,1832,1875,1854,12449
16411,1682,1547,1550,1488,1433,1453,1477,10630
16412,10607,10574,10750,10856,10984,11211,10480,75462
16415,9560,9269,9187,8894,8701,8732,8916,63259
16416,184,240,243,275,282,222,203,1649
16417,7676,8095,8337,8536,8378,8311,8329,57662
16420,689,670,597,538,557,518,650,4219
16421,2605,2574,2468,2496,2532,2228,2518,17421
16422,251,168,152,169,159,208,401,1508
16423,4559,4527,4343,4492,4532,4355,4450,31258
16424,4561,4569,4593,4460,4644,4678,4676,32181
16426,3870,4089,4171,4150,3822,3788,3730,27620
16427,223,234,248,261,304,272,193,1735
16428,12604,12627,12640,12587,12591,12487,12478,88014
16433,5288,5285,5311,5189,5232,5368,5384,37057
16434,3093,3072,3041,3413,3494,3449,2990,22552
16435,1873,1904,2119,2038,2087,2132,2108,14261
16436,613,612,547,560,708,706,756,4502
16438,7941,8039,8080,7958,7879,7942,8083,55922
16440,945,948,865,902,948,945,891,6444
16441,10124,9724,9658,9756,10017,9664,10136,69079
16442,2875,2941,2932,3016,3027,3101,2958,20850
16443,1236,1276,1310,1235,1349,1540,1425,9371
16444,1445,1407,1296,1129,1013,1107,1717,9114
16501,2150,1920,2163,2106,2388,2300,2044,15071
16502,15948,15675,16416,17146,17560,17359,16664,116768
16503,16571,16476,15990,15548,15309,15530,16850,112274
16504,15751,16417,17135,17451,17461,17327,17322,118864
16505,16415,16617,16620,16746,16913,17677,17168,118156
16506,24289,24337,23917,23484,23576,23040,23720,166363
16507,10106,10213,10215,10428,10824,10799,11088,73673
16508,16758,16764,16499,16627,16474,16271,16050,115443
16509,28286,28051,27276,27634,27165,26382,26810,191604
16510,25314,25506,26055,25615,25479,26177,25625,179771
16511,11820,12031,11878,11664,11381,11542,11382,81698
16546,1020,1133,1117,1134,1092,1173,1154,7823
16563,1680,1651,1642,1601,1502,1522,1621,11219
16601,33104,33661,33654,33742,33538,33765,33870,235334
16602,29428,29332,29581,29751,29941,29784,29554,207371
16611,2525,2450,2409,2537,2406,2447,2410,17184
16613,1433,1537,1455,1548,1576,1640,1535,10724
16616,120,115,122,129,87,106,116,795
16617,2708,2736,2660,2854,2917,2969,2806,19650
16619,304,273,254,301,231,213,347,1923
16620,299,302,326,390,418,413,414,2562
16621,693,711,619,652,598,643,737,4653
16622,201,187,155,204,205,167,175,1294
16623,464,532,492,453,516,590,567,3614
16624,238,223,230,235,195,184,204,1509
16625,3917,3846,3858,4007,4021,3948,3868,27465
16627,2303,2340,2351,2243,2183,2158,2278,15856
16630,4422,4559,5179,5770,5872,5983,5080,36865
16631,51,47,52,38,28,130,90,436
16633,238,169,221,158,167,202,200,1355
16634,286,251,233,259,227,265,302,1823
16635,11974,11911,12345,12412,12725,12882,11321,85570
16636,724,728,753,801,814,742,742,5304
16637,2367,2516,2408,2228,2388,2511,2873,17291
16638,36,37,50,66,75,83,67,414
16639,1437,1531,1639,1569,1583,1600,1494,10853
16640,786,883,922,854,859,798,817,5919
16641,2461,2503,2578,2598,2613,2715,2598,18066
16645,154,149,150,130,133,130,142,988
16646,2401,2542,2575,2533,2437,2481,2558,17527
16647,692,665,631,563,593,688,764,4596
16648,15405,15488,15259,15122,14826,14703,15538,106341
16650,2031,2073,2134,1973,1990,1908,2036,14145
16651,5933,5977,5962,6003,5862,5908,5813,41458
16652,18340,18412,18588,18480,18025,17873,18028,127746
16655,1539,1487,1554,1539,1442,1460,1601,10622
16656,1263,1331,1473,1546,1495,1424,1297,9829
16657,1351,1345,1286,1319,1187,1157,1343,8988
16659,338,288,289,320,314,293,303,2145
16661,872,909,966,947,1011,963,951,6619
16662,5893,5926,6118,5975,5600,5620,6040,41172
16664,1956,2046,1975,1955,2053,1976,2104,14065
16665,366,311,285,291,285,267,299,2104
16666,2961,2792,3119,3393,3558,3879,2960,22662
16667,1446,1365,1308,1670,1709,1572,1392,10462
16668,3553,3591,3533,3543,3616,3665,3569,25070
16669,2140,2238,2277,2271,2353,2375,2351,16005
16670,43,45,29,28,18,8,47,218
16671,555,495,525,555,547,531,505,3713
16672,273,242,246,262,180,164,187,1554
16673,5258,5293,5141,5302,5436,5362,5519,37311
16674,732,725,729,664,539,570,736,4695
16677,281,314,144,161,110,208,481,1699
16678,2711,2800,2748,2735,2833,2821,2689,19337
16679,834,847,867,862,845,846,844,5945
16680,453,432,408,307,396,429,427,2852
16682,35,125,171,174,176,231,117,1029
16683,394,377,441,434,418,424,383,2871
16685,170,173,331,338,412,417,249,2090
16686,13268,13133,13075,13071,13373,13288,13488,92696
16689,401,435,583,549,595,594,462,3619
16691,324,282,292,324,329,349,314,2214
16692,739,702,742,736,758,784,753,5214
16693,4441,4376,4470,4493,4505,4484,4185,30954
16694,193,173,203,190,205,220,254,1438
16695,1037,1042,1086,1211,1222,1295,1198,8091
16699,795,1158,770,820,822,831,1469,6665
16701,17704,17852,17871,17940,17979,17907,17980,125233
16720,1247,1307,1286,1285,1268,1341,1392,9126
16724,91,86,90,96,77,94,143,677
16725,236,151,66,86,114,91,166,910
16726,604,518,496,550,538,563,542,3811
16727,226,202,202,200,190,276,211,1507
16728,29,47,40,26,32,27,25,226
16729,900,885,773,685,676,740,761,5420
16730,77,64,65,62,105,111,121,605
16731,2565,2796,2803,2883,2995,3042,2818,19902
16732,373,380,332,309,260,222,293,2169
16733,242,256,228,144,169,156,222,1417
16734,267,206,264,247,286,258,287,1815
16735,6055,6176,6175,6262,6090,6273,6309,43340
16738,2455,2499,2522,2665,2685,2674,2679,18179
16740,1086,1052,1100,1074,1053,940,1032,7337
16743,3935,4011,3959,3958,3856,3695,3942,27356
16744,316,332,552,515,459,509,332,3015
16745,580,586,608,573,590,726,611,4274
16746,1164,1330,1305,1412,1484,1395,1265,9355
16748,2631,2644,2770,2809,2818,2736,2997,19405
16749,4127,4103,4171,4227,4504,4475,4319,29926
16750,434,391,378,336,408,394,417,2758
16801,44237,44282,43447,42463,41731,40310,42812,299282
16802,11848,11408,12156,12776,13495,14392,12764,88839
16803,25365,24994,24503,24251,24057,23983,23685,170838
16820,1094,1058,1267,1303,1192,1143,1217,8274
16821,172,189,298,302,280,266,318,1825
16822,2059,2147,2019,1943,1931,1945,2283,14327
16823,29255,28798,27934,26987,26859,26722,26617,193172
16825,304,326,228,200,132,77,240,1507
16826,635,562,581,638,583,492,616,4107
16827,4609,4316,4254,4091,4069,4011,3991,29341
16828,4343,4732,4732,4731,4652,4304,4478,31972
16829,588,606,632,641,701,754,666,4588
16830,13658,13755,13958,14134,13988,14015,13695,97203
16832,692,735,462,379,343,324,510,3445
16833,5382,5409,5390,5337,5448,5257,5342,37565
16834,146,154,159,155,156,135,299,1204
16835,189,184,215,227,274,264,238,1591
16836,1147,1159,1097,1085,1160,1087,1152,7887
16837,161,108,119,128,93,85,186,880
16838,1891,1851,1764,1755,1637,1706,1821,12425
16839,636,637,469,477,473,449,489,3630
16840,587,623,632,587,550,395,510,3884
16841,5870,5640,5764,6017,6038,6089,5934,41352
16843,379,410,349,356,408,478,657,3037
16844,2815,2962,2988,3047,3041,3024,2769,20646
16845,967,1072,1096,1144,1287,1313,1088,7967
16847,312,350,406,368,409,331,335,2511
16848,367,357,380,421,471,446,319,2761
16849,352,350,397,327,282,356,331,2395
16851,723,923,1013,941,976,1037,866,6479
16852,330,346,327,392,459,469,371,2694
16853,187,183,216,171,154,215,300,1426
16854,829,910,971,950,979,848,947,6434
16855,330,277,335,313,331,336,282,2204
16858,3990,3890,3958,4027,4044,3945,3688,27542
16859,527,457,488,568,616,585,542,3783
16860,291,466,447,335,374,354,451,2718
16861,303,256,302,281,236,298,311,1987
16863,679,707,577,657,778,836,718,4952
16865,2055,2215,2042,2042,2005,1751,1839,13949
16866,10169,10110,10091,9974,9904,9585,9881,69714
16868,317,394,408,438,424,505,483,2969
16870,7001,6699,6621,6735,6534,6441,7046,47077
16871,27,28,31,29,27,30,46,218
16872,1486,1285,1251,1361,1430,1301,1551,9665
16874,1532,1582,1466,1358,1361,1340,1371,10010
16875,4528,4261,4263,3802,3535,3828,3945,28162
16876,304,333,336,356,351,310,311,2301
16877,1689,1645,1633,1657,1651,1870,1762,11907
16878,1629,1877,1717,1669,1541,1653,1762,11848
16879,345,306,387,495,545,704,532,3314
16881,2148,2125,2073,1967,2066,2182,2232,14793
16882,322,422,344,318,329,371,300,2406
16901,10276,10323,10423,10339,10335,10254,10243,72193
16911,468,469,413,421,426,369,332,2898
16912,1781,1830,1877,1900,1841,1953,1776,12958
16914,2208,2104,2174,2248,2368,2379,2347,15828
16915,6123,5985,5816,5900,5809,5942,5929,41504
16917,1307,1323,1411,1355,1453,1496,1437,9782
16920,2097,2089,1984,2213,2259,2319,2006,14967
16921,536,587,593,592,579,534,475,3896
16922,1983,1959,1976,2010,2070,2016,2002,14016
16923,1544,1606,1590,1546,1588,1575,1470,10919
16925,3483,3266,3272,3324,3088,3155,3186,22774
16926,910,869,784,748,830,779,872,5792
16927,625,689,759,720,712,738,651,4894
16928,1383,1320,1248,1401,1579,1576,1387,9894
16929,2378,2438,2244,2174,2274,2292,2320,16120
16930,1306,1317,1373,1348,1353,1333,1300,9330
16932,778,780,686,675,711,669,734,5033
16933,7124,7091,7534,7741,7128,7094,7488,51200
16935,1399,1400,1384,1342,1205,1138,1256,9124
16936,1986,1992,2023,2067,2255,2342,2095,14760
16937,297,272,312,272,245,146,172,1716
16938,723,754,726,683,694,687,747,5014
16939,284,449,439,416,434,449,295,2766
16940,334,350,407,398,431,381,302,2603
16941,106,100,116,108,110,95,69,704
16942,815,801,800,665,630,550,847,5108
16943,469,446,402,439,440,482,549,3227
16946,2456,2397,2290,2238,2239,2274,2484,16378
16947,5162,5339,5439,5262,5182,5227,4818,36429
16948,1672,1629,1732,1642,1547,1673,1634,11529
16950,3416,3466,3517,3427,3456,3450,3378,24110
17002,719,692,726,642,679,709,784,4951
17003,11491,11510,11738,11855,11854,12005,11720,82173
17004,4773,4769,5068,5225,5304,5239,5000,35378
17005,362,377,404,406,346,307,368,2570
17006,1010,1105,1041,1029,1169,1021,1052,7427
17007,5598,5787,5437,5673,5522,5548,5591,39156
17009,1968,2018,1986,2004,2185,2157,2007,14325
17010,102,115,0,0,0,58,182,457
17011,35305,34996,35165,35184,34659,35208,34586,245103
17013,35367,35116,35010,34398,34476,34466,34575,243408
17015,21634,21374,21186,21463,20801,20821,20798,148077
17016,883,616,620,584,603,588,799,4693
17017,1574,1665,1759,1845,1837,1857,1755,12292
17018,4468,4475,4283,4175,4455,4334,4313,30503
17019,18338,18249,18556,18318,17940,17570,17721,126692
17020,9177,9091,9105,9098,9041,9040,9047,63599
17021,881,956,857,905,833,785,1088,6305
17022,29965,29395,29351,29153,29139,28589,29602,205194
17023,3649,3726,3704,3559,3458,3463,3535,25094
17024,2003,1830,2015,2001,2141,2195,1893,14078
17025,17034,17314,17134,16608,16642,16250,16778,117760
17026,3627,3924,3878,3856,3550,3713,3616,26164
17027,2311,2250,2413,2340,2164,2129,2141,15748
17028,3718,3460,3604,3455,3650,3860,3720,25467
17029,354,459,474,574,626,510,371,3368
17030,935,899,886,833,820,745,832,5950
17032,8342,8331,8459,8507,8216,8087,8192,58134
17033,17248,17649,17491,17017,17023,16719,16972,120119
17034,2275,2249,2438,2366,2605,2730,2414,17077
17035,931,824,821,755,754,708,839,5632
17036,22750,21792,21663,22233,22528,22499,21913,155378
17037,928,966,886,947,958,1001,1126,6812
17038,8603,8650,8312,8286,8150,7811,8219,58031
17039,92,21,22,34,34,0,37,240
17040,2265,2388,2367,2363,2223,2333,2787,16726
17041,153,133,69,199,288,283,213,1338
17042,36957,36829,36945,37020,37257,37345,37133,259486
17043,5708,5825,6000,5949,5853,5759,5957,41051
17044,21063,21077,21088,21029,21001,21075,21209,147542
17045,3092,3107,3177,3123,3160,3305,3350,22314
17046,31533,31040,30863,30706,30057,29442,29790,213431
17047,2759,2869,2635,2753,2600,2449,2526,18591
17048,4060,3966,3876,4019,3867,3814,4046,27648
17049,3255,3302,3246,3150,3204,3343,3360,22860
17050,35908,34994,34596,34035,33277,32614,32815,238239
17051,4690,4655,4672,4693,4366,4435,4653,32164
17052,1553,1436,1512,1563,1812,1894,1635,11405
17053,5022,4881,4915,5021,4890,5100,5001,34830
17055,36201,35537,34844,34135,34210,33594,34237,242758
17056,63,75,85,81,40,80,128,552
17057,22121,22091,22161,22176,22116,22202,21329,154196
17058,1767,1908,1820,1927,1868,1784,1909,12983
17059,8074,7904,7955,8134,7971,7739,7579,55356
17060,1264,1251,1265,1282,1441,1467,1334,9304
17061,7046,6931,6829,6985,7058,6981,7157,48987
17062,4137,3995,4034,3944,4145,3973,3979,28207
17063,3385,3334,3293,3258,3326,3319,3311,23226
17064,693,523,381,367,349,331,645,3289
17065,4367,4162,4341,3989,3886,3810,4222,28777
17066,5339,5380,5097,5091,5664,5799,5348,37718
17067,14500,14195,14289,14551,14630,14300,14232,100697
17068,4405,4506,4489,4763,4723,4528,4298,31712
17069,101,111,105,113,131,129,133,823
17070,16009,15688,15375,15582,15058,14862,15692,108266
17071,142,132,142,107,77,77,108,785
17072,82,35,33,209,376,338,193,1266
17073,5490,5375,5400,5300,5186,5522,5271,37544
17074,7142,7124,7279,7271,7427,7557,7477,51277
17075,70,115,114,120,101,114,123,757
17076,37,68,36,41,41,43,48,314
17077,105,88,20,19,21,0,46,299
17078,21272,21023,20849,20198,19796,19228,20218,142584
17080,270,280,267,295,252,229,298,1891
17081,276,238,144,48,76,36,352,1170
17082,3372,3453,3588,3302,3367,3360,3588,24030
17083,12,29,49,66,73,63,109,401
17084,4425,4446,4346,4319,4291,4315,4340,30482
17086,2264,2284,2252,2300,2385,2367,2499,16351
17087,2867,3037,3164,3098,3131,3408,2767,21472
17088,1005,974,631,472,505,465,823,4875
17090,5496,5505,5511,5220,5140,5103,5216,37191
17093,1379,1099,924,925,702,869,801,6699
17094,2810,2836,2876,2796,2751,2640,2392,19101
17097,799,850,793,746,906,805,925,5824
17098,2326,2297,2353,2451,2382,2607,2528,16944
17099,1263,1209,1248,1155,1044,1009,1179,8107
17101,2127,1988,1942,1928,2099,2022,2212,14318
17102,8034,8434,8257,8032,7852,7747,7628,55984
17103,11443,10946,10850,11219,11391,11601,11848,79298
17104,19856,20513,21133,21123,21179,20935,20962,145701
17109,23450,23380,23544,23153,23077,22852,23131,162587
17110,25031,24715,24483,24752,24153,24593,24433,172160
17111,32233,32429,32059,31984,30464,30154,30714,220037
17112,34719,34375,33600,33190,33427,33104,33850,236265
17113,10567,10782,11048,11013,11096,11038,10749,76293
17120,0,0,0,0,0,0,0,0
17201,25962,25679,25258,25341,25417,25839,25293,178789
17202,30242,30801,30598,30193,30037,28781,30200,210852
17210,128,142,144,177,206,174,193,1164
17211,325,364,375,355,336,402,368,2525
17212,853,803,868,877,937,856,702,5896
17213,617,645,593,613,621,582,639,4310
17214,934,1090,1392,1158,1112,1085,1089,7860
17215,254,229,233,208,205,199,347,1675
17217,110,164,148,91,77,155,150,895
17219,482,537,403,404,357,328,405,2916
17220,337,345,337,469,597,684,534,3303
17221,511,556,532,551,536,583,637,3906
17222,10592,10521,10693,10468,10260,10399,10749,73682
17223,333,320,304,331,287,395,289,2259
17224,2007,2085,2162,2111,2149,1876,1834,14224
17225,20127,20140,19724,19718,19662,19313,18879,137563
17228,1168,1305,1220,1193,1141,1054,1183,8264
17229,1313,1322,1302,1296,1323,1322,1276,9154
17233,5168,5173,5047,5014,4909,4870,5047,35228
17235,360,651,712,774,821,705,672,4695
17236,7850,7831,8285,8268,8271,8860,8895,58260
17237,1903,2058,2106,2183,2100,2235,1917,14502
17238,1540,1602,1461,1463,1653,1724,1794,11237
17239,247,216,203,204,162,194,203,1429
17240,3904,3589,3185,3365,3314,3429,3345,24131
17241,11367,11423,11520,11715,12026,12031,11853,81935
17243,1806,1730,1725,1483,1548,1104,1329,10725
17244,2539,2380,2513,2399,2374,2244,2407,16856
17246,176,157,131,84,91,115,195,949
17247,426,450,379,334,308,275,366,2538
17249,415,344,277,268,297,303,371,2275
17250,70,138,122,216,214,213,68,1041
17251,181,199,171,131,111,116,158,1067
17252,3684,3547,3481,3476,3707,3665,3608,25168
17253,270,290,315,286,298,295,337,2091
17254,5,5,4,3,2,1,89,109
17255,996,1052,1083,1222,1104,991,1125,7573
17256,98,120,45,14,49,53,91,470
17257,29397,29359,29013,28878,28304,28101,27996,201048
17260,1212,1263,1270,1321,1105,1146,1164,8481
17261,268,257,264,252,227,232,193,1693
17262,1745,1595,1773,1642,1530,1347,1462,11094
17263,418,452,437,597,698,466,467,3535
17264,2129,2180,2275,2172,2369,2388,2305,15818
17265,641,627,629,645,661,484,496,4183
17266,444,517,579,610,616,690,581,4037
17267,2823,2683,2708,2798,2692,2713,2810,19227
17268,29491,28685,28153,28007,27389,27318,28285,197328
17270,49,184,167,171,221,249,115,1156
17271,299,270,270,316,319,411,339,2224
17272,397,342,290,238,252,204,294,2017
17301,4109,3881,3870,3501,3654,3881,4053,26949
17302,2851,2906,2882,2787,2894,2897,3083,20300
17304,2708,3021,2956,2930,3190,3295,3059,21159
17306,410,378,367,319,277,301,318,2370
17307,6007,5955,6108,5995,6021,5586,5899,41571
17309,2110,1972,1661,1673,1682,1575,2086,12759
17311,252,227,261,284,286,279,252,1841
17313,10686,11018,10914,10593,10600,10739,10899,75449
17314,5917,5827,5868,6009,5870,5950,5929,41370
17315,25496,26054,26129,26333,26570,26712,25756,183050
17316,8373,8265,8442,8293,8427,8169,8266,58235
17317,838,933,1002,993,748,620,755,5889
17318,436,317,321,262,334,329,344,2343
17319,11411,11352,10750,10535,10440,10034,10417,74939
17320,7743,7859,7919,7797,7895,7990,7823,55026
17321,2352,2323,2190,2230,2401,2353,2238,16087
17322,6342,6203,6549,6437,6692,6446,6012,44681
17324,3909,3846,4094,4095,4161,4221,4219,28545
17325,28128,28511,28223,28479,28710,28486,27619,198156
17327,7461,7410,7697,8190,8082,8329,7565,54734
17329,2523,2518,2339,2404,2387,2263,2494,16928
17331,51039,50717,50812,50336,49876,49645,50292,352717
17339,6754,7160,6975,6824,6981,7054,6940,48688
17340,10939,11170,11005,11025,10958,10841,10896,76834
17343,0,0,35,41,122,115,180,493
17344,3600,3671,3555,3443,3512,3588,3656,25025
17345,7918,7612,7625,7146,7606,7411,7679,52997
17347,6393,6424,6364,6481,6241,6179,6202,44284
17349,7093,7523,7508,7280,7452,7069,7570,51495
17350,13432,13009,12860,13242,12907,12720,12886,91056
17352,1209,1212,1279,1361,1272,1142,1292,8767
17353,3458,3217,3196,3290,2805,3128,3228,22322
17355,246,216,212,187,249,216,261,1587
17356,21307,21743,21774,22171,21800,22207,21610,152612
17360,6581,6040,6090,5854,5942,5913,5927,42347
17361,6259,5903,5904,5595,5380,5480,5806,40327
17362,13636,13795,14056,13941,13701,13668,13397,96194
17363,9306,9579,9562,9790,9762,9831,9413,67243
17364,3507,3681,3517,3634,3694,4151,3907,26091
17365,2346,2120,2081,2152,2158,2068,2510,15435
17366,5778,5969,5932,5852,5556,5593,5499,40179
17368,7224,6864,6665,6989,7425,6992,7322,49481
17370,4852,4922,5202,5366,5330,5746,5683,37101
17371,322,366,366,279,241,206,257,2037
17372,4339,4294,4303,4251,4229,4284,4101,29801
17401,18386,18214,18813,17561,17100,16827,17687,124588
17402,37461,36537,35690,35126,35767,35656,36360,252597
17403,38730,38705,37948,39766,39648,40131,39042,273970
17404,35351,35495,35745,35687,35861,34884,35517,248540
17406,23328,23743,23989,22834,21738,21641,22156,159429
17407,2366,2264,2298,2176,2124,2053,2355,15636
17408,23077,22761,22019,22377,22534,21855,22507,157130
17501,4214,4226,4512,4522,4491,4502,4307,30774
17502,2753,2919,2791,2637,2618,2570,2464,18752
17505,2204,2243,2142,2216,1669,1356,1785,13615
17507,36,55,54,26,24,32,62,289
17508,530,334,314,284,127,131,423,2143
17509,4942,4870,4696,4595,4424,4560,4664,32751
17512,18026,17768,17874,17398,17534,18003,17836,124439
17516,4360,4451,4514,4788,4596,4678,4496,31883
17517,16428,16353,15889,15768,15501,15230,15391,110560
17518,1434,1483,1411,1446,1477,1412,1355,10018
17519,7514,7249,7032,6953,6841,6757,6824,49170
17520,4642,4674,4659,4660,4670,4731,4686,32722
17522,33628,33200,32804,32475,31940,31801,32483,228331
17527,6020,6010,6244,6159,6310,6098,6080,42921
17529,4628,4505,4590,4349,4206,4224,4317,30819
17532,2929,2929,3258,3475,3414,3393,3381,22779
17535,2935,1981,1913,2354,2009,2089,2458,15739
17536,3016,2951,2785,2999,2799,2670,2839,20059
17538,6262,6458,6765,7040,6936,6448,6045,45954
17540,10270,9778,9349,9226,9658,9663,9791,67735
17543,42715,43039,42717,42594,41887,41522,42626,297100
17545,22456,21843,21937,21542,21582,21305,21256,151921
17547,7048,6669,6552,6999,7016,7149,7378,48811
17550,1215,1397,1023,849,780,407,790,6461
17551,11303,11393,11112,11012,10764,10747,10857,77188
17552,20070,20204,19979,19116,18710,18605,17831,134515
17554,8212,7571,7275,7928,7133,7196,7525,52840
17555,7026,7518,7903,7525,7659,7907,7525,53063
17557,14781,14582,14406,14175,14022,13696,13811,99473
17560,5189,5152,5318,5165,4869,4739,5118,35550
17562,4338,4457,4507,4604,4721,4632,4464,31723
17563,3775,3782,3855,3901,3869,3990,3849,27021
17565,2788,2807,2387,2170,2248,2230,2537,17167
17566,12568,12341,12240,11974,12305,12213,12019,85660
17569,5971,6223,5551,5209,5513,5724,5448,39639
17570,233,195,204,215,231,163,291,1532
17572,3867,3986,3468,3575,3424,3488,3859,25667
17576,258,142,32,207,173,169,129,1110
17578,7033,7011,7697,7811,7754,7762,7485,52553
17579,6247,6156,6258,6029,5886,6001,5935,42512
17581,877,963,925,914,916,859,951,6405
17582,2148,1941,2106,2056,2127,2059,2026,14463
17584,8988,8784,8908,8876,8972,9177,8957,62662
17601,51150,51437,49879,48769,48895,48567,49779,348476
17602,53858,52892,53836,53743,53388,51727,52452,371896
17603,61575,62653,62030,61719,62628,62979,61973,435557
17606,487,387,539,592,566,604,392,3567
17701,44662,44877,44721,44911,44600,44431,44661,312863
17702,10652,10672,10641,10564,10508,10512,10721,74270
17721,1764,1767,1766,1989,1951,2011,1604,12852
17723,41,30,43,55,46,41,34,290
17724,4819,5206,5573,5571,5445,5521,5424,37559
17727,73,64,65,37,52,46,72,409
17728,4897,5042,5097,5172,5283,5207,5120,35818
17729,48,57,57,63,91,108,159,583
17730,216,141,267,284,306,341,257,1812
17731,233,199,176,159,116,84,185,1152
17737,6291,6222,5970,5881,6160,6046,6220,42790
17739,23,18,26,40,44,48,32,231
17740,12626,12630,12839,12940,12952,12979,12754,89720
17742,27,34,72,62,59,96,39,389
17744,3166,3063,3047,3109,3234,3417,3175,22211
17745,19243,19408,19424,19153,18768,18628,19063,133687
17747,3361,3395,3274,3231,3188,3121,3073,22643
17748,272,221,208,245,254,265,300,1765
17749,389,347,302,266,275,214,244,2037
17750,193,122,128,107,117,96,167,930
17751,7336,7353,7572,7553,7479,7353,7084,51730
17752,4592,4625,4812,4948,4942,4961,4635,33515
17754,12302,11901,12117,11917,12059,12328,12233,84857
17756,12328,12648,12599,12220,12000,11750,12408,85953
17758,811,867,880,912,908,909,919,6206
17760,682,650,636,550,529,482,557,4086
17762,575,618,530,524,493,442,503,3685
17763,239,328,403,422,370,397,309,2468
17764,2224,2176,2143,2212,2210,2228,2327,15520
17765,1196,1175,980,926,980,936,1162,7355
17767,188,198,87,84,71,119,91,838
17768,314,305,267,216,226,247,377,1952
17771,3276,3388,3428,3487,3405,3534,3158,23676
17772,2482,2486,2518,2500,2683,2746,2399,17814
17774,1411,1427,1289,1261,1193,1172,1277,9030
17776,306,299,279,267,237,193,295,1876
17777,7325,6986,7230,7324,6927,6876,7056,49724
17778,83,81,68,75,72,68,102,549
17779,55,49,123,165,204,226,235,1057
17801,16438,16326,16288,16142,16532,16339,16671,114736
17810,6016,6068,5953,6033,6031,6071,4683,40855
17812,1350,1295,1464,1439,1456,1401,1480,9885
17813,2100,2022,2040,1966,1961,2264,1979,14332
17814,5029,5086,4786,4476,4425,4246,4860,32908
17815,30742,30958,31035,31207,31122,31112,30967,217143
17820,5499,5464,5427,5587,5638,5653,5556,38824
17821,18499,18533,18518,18604,18501,18537,18219,129411
17822,0,0,0,0,0,0,0,0
17823,1213,1245,1281,1223,1103,986,1273,8324
17824,3708,3631,3712,3835,4115,3966,4115,27082
17827,773,701,704,681,598,562,657,4676
17829,255,203,225,259,265,306,244,1757
17830,2017,2050,2092,1956,1822,1877,1947,13761
17832,733,780,651,670,684,680,628,4826
17834,3651,3834,3739,3603,3516,3455,3565,25363
17835,310,262,226,152,163,207,219,1539
17836,229,235,212,206,159,155,266,1462
17837,19873,19912,20364,20017,19819,19703,19815,139503
17840,374,327,429,511,524,528,533,3226
17841,4966,5052,4908,4894,4960,4981,4779,34540
17842,8585,8586,8808,8646,8947,8569,8910,61051
17844,10441,10426,9988,10012,9954,9867,10042,70730
17845,2034,2036,2135,2244,2449,2435,2245,15578
17846,3808,3675,3676,3537,3477,3505,3738,25416
17847,11708,12020,12018,12150,12136,12161,12051,84244
17850,712,704,623,602,639,634,645,4559
17851,7607,7576,7627,7741,7833,7915,7841,54140
17853,3422,3557,3411,3351,3377,3307,3221,23646
17855,1042,1069,1015,959,885,1008,992,6970
17856,3277,3428,3420,3627,3719,3636,3365,24472
17857,7466,7476,7502,7501,7492,7475,7505,52417
17859,2807,2939,3035,3062,3264,3430,3106,21643
17860,2557,2660,2467,2138,2145,2108,1994,16069
17861,113,58,63,78,95,68,143,618
17862,517,486,421,444,392,518,577,3355
17864,2335,2395,2380,2543,2669,2724,2445,17491
17865,136,176,117,143,150,155,92,969
17866,10480,10499,10484,10474,10372,10355,10310,72974
17867,178,175,138,175,172,157,169,1164
17868,986,1156,1242,1091,1037,1029,1052,7593
17870,15166,15098,15090,14941,14989,15012,14564,104860
17872,9330,9587,9718,9934,9751,10006,9943,68269
17876,1703,1664,1592,1628,1692,1896,1698,11873
17878,1361,1356,1301,1382,1400,1481,1528,9809
17880,138,142,64,70,64,66,72,616
17881,1329,1310,1467,1461,1672,1766,1556,10561
17884,266,230,220,229,250,269,305,1769
17885,171,122,178,187,214,160,141,1173
17886,1088,821,737,860,912,667,895,5980
17887,287,278,300,215,142,328,1778,3328
17888,289,283,283,280,303,358,326,2122
17889,2766,2666,2676,2662,2076,2022,2735,17603
17901,23719,23986,24175,23985,24090,24305,23990,168250
17920,363,337,347,336,315,294,331,2323
17921,7509,7481,7283,7252,7377,7453,7676,52031
17922,4973,4654,4946,4930,4610,4584,4783,33480
17923,501,460,449,359,287,311,433,2800
17925,456,439,437,406,401,365,376,2880
17929,1741,1789,1776,1805,1829,1667,1606,12213
17930,492,452,466,399,478,408,476,3171
17931,8835,9045,8717,8713,8557,8617,8472,60956
17933,113,78,26,66,68,87,89,527
17934,477,455,444,490,556,535,469,3426
17935,1436,1461,1616,1617,1804,1877,1737,11548
17936,811,865,841,836,840,812,763,5768
17938,2473,2545,2494,2489,2492,2451,2442,17386
17941,793,813,836,828,834,763,834,5701
17943,91,149,319,336,497,603,229,2224
17944,163,240,215,259,269,236,205,1587
17945,137,168,179,177,111,89,180,1041
17946,49,226,237,215,298,348,263,1636
17948,4995,5015,4940,4917,4954,4991,5029,34841
17949,345,294,267,277,282,257,263,1985
17951,197,233,292,303,301,343,325,1994
17952,235,230,197,211,227,216,282,1598
17953,498,506,443,430,489,459,469,3294
17954,4511,4490,4488,4512,4558,4586,4564,31709
17957,341,367,313,281,296,289,328,2215
17959,1430,1406,1422,1428,1371,1371,1422,9850
17960,3813,3724,3922,3864,3658,3693,3868,26542
17961,6539,6903,6884,7012,6962,7101,6958,48359
17963,9417,9395,9509,9482,9287,9240,9317,65647
17964,870,841,811,748,682,663,798,5413
17965,2045,1968,2048,2042,2090,1957,2067,14217
17967,2505,2406,2380,2305,2347,2267,2457,16667
17968,251,269,326,359,330,382,329,2246
17970,3094,3158,3287,3350,3402,3432,3241,22964
17972,10981,10961,10774,10958,11249,11437,11627,77987
17974,260,266,251,222,304,283,344,1930
17976,6803,6644,6676,6929,6820,6863,6937,47672
17978,209,155,144,156,177,193,224,1258
17979,158,163,142,88,75,145,168,939
17980,3042,3043,2944,2963,3161,3104,3238,21495
17981,2707,2726,2700,2712,2729,2761,2751,19086
17982,484,429,420,481,395,390,430,3029
17983,1443,1407,1392,1478,1479,1513,1620,10332
17985,1181,1204,1142,1203,1075,1099,1226,8130
18011,5623,5541,5622,5548,5553,5414,5450,38751
18013,17790,17711,18241,17971,18258,18395,17802,126168
18014,11369,11493,11592,11513,11377,11500,11387,80231
18015,33233,32241,32025,31728,32466,32026,32832,226551
18016,0,0,0,0,0,0,0,0
18017,38086,37794,37229,37274,37225,37572,37549,262729
18018,32047,32641,33167,32977,32833,32854,32413,228932
18020,20918,20512,20586,20387,20648,20553,20447,144051
18030,780,821,824,664,752,668,623,5132
18031,9224,8702,7981,7601,6888,6250,7528,54174
18032,9350,9338,9321,9316,9314,9335,9285,65259
18034,9057,8682,8529,8573,8486,7994,8256,59577
18035,110,98,120,169,218,204,241,1160
18036,12829,12887,12781,12607,12475,12971,12822,89372
18037,7781,7469,7322,7240,7100,7050,7070,51032
18038,2918,2707,2506,2708,3011,3150,3091,20091
18040,16606,16465,16268,15993,15572,14962,15742,111608
18041,5246,5149,5341,5298,5308,5242,5424,37008
18042,42039,42043,41903,41921,41744,41576,41570,292796
18045,26256,26424,26059,26145,25696,25609,26391,182580
18046,47,39,34,0,0,0,64,184
18049,17548,17667,17400,17302,16998,17365,17341,121621
18051,3581,3761,3913,3790,3965,4132,3327,26469
18052,27359,27314,27138,26971,26876,26826,26902,189386
18053,2244,2649,2705,2632,2560,2693,2375,17858
18054,4483,4461,4388,4329,4508,4239,4278,30686
18055,12038,12238,12563,12665,12294,11769,11780,85347
18056,820,671,723,737,855,685,943,5434
18058,10154,9874,9537,9671,9240,9453,9464,67393
18059,1083,1083,1227,1159,1174,1322,1228,8276
18062,25280,24932,25091,24419,24108,23382,24351,171563
18063,503,487,589,586,584,599,548,3896
18064,25301,25008,24577,24472,24305,24120,24073,171856
18066,5916,5921,5683,5800,5712,5763,6005,40800
18067,18424,18684,18660,18252,17774,17753,17852,127399
18068,0,0,0,151,130,158,42,481
18069,7928,8091,8053,8031,8148,8083,8017,56351
18070,1302,1078,961,875,920,741,739,6616
18071,10377,10294,10323,10460,10741,10577,10578,73350
18072,6465,6501,6565,6486,6308,6452,6571,45348
18073,9639,9563,9488,9675,9136,9179,9350,66030
18074,5841,5950,5877,6191,6108,6223,5775,41965
18076,2922,3047,3006,2906,2786,2835,2662,20164
18077,2348,2398,2395,2345,2375,2363,2370,16594
18078,7219,7168,7246,7228,7280,6822,7074,50037
18079,493,548,243,245,477,473,436,2915
18080,11523,11326,11589,11650,11487,11627,11456,80658
18081,181,135,207,270,274,451,357,1875
18083,451,449,481,532,527,620,530,3590
18085,1002,958,995,962,1027,891,1119,6954
18086,570,531,398,602,584,594,398,3677
18087,699,655,527,716,701,598,738,4634
18088,8123,8159,8199,8275,8337,8247,8375,57715
18091,5432,5471,5715,5932,6099,6030,5926,40605
18092,3058,3127,3397,3176,3302,3237,3223,22520
18101,4153,4013,4930,4739,3773,4505,3897,30010
18102,48692,48617,48248,47576,48483,48170,49779,339565
18103,47155,48163,48340,48527,48021,47424,45336,332966
18104,44333,43641,43070,43409,43396,43206,43236,304291
18105,22,20,65,67,61,59,12,306
18106,7500,7370,7206,6961,6829,6754,6889,49509
18109,17619,17264,16560,16312,16274,15689,16932,116650
18195,0,0,0,0,0,0,0,0
18201,27065,27458,27681,27647,27593,27302,27516,192262
18202,11857,11620,11389,11738,11859,11727,12083,82273
18210,8088,8248,8133,7676,7222,6993,8258,54618
18211,1596,1519,1474,1303,1357,1179,1304,9732
18212,172,171,116,128,100,123,131,941
18214,1955,1913,2333,2243,2324,2192,2078,15038
18216,946,891,958,996,1042,1082,1067,6982
18218,2271,2222,2274,2374,2415,2404,2281,16241
18219,1626,1493,1388,1400,1283,1211,1436,9837
18220,345,391,374,361,381,331,344,2527
18221,539,519,538,501,304,334,389,3124
18222,9196,9215,9233,9432,9279,9011,9020,64386
18223,158,156,172,122,142,105,115,970
18224,5547,5566,5599,5576,5500,5496,6017,39301
18225,125,118,116,43,5,3,114,524
18229,8975,9124,9159,9531,9579,9637,8498,64503
18230,101,100,102,63,85,92,132,675
18231,455,475,513,658,658,529,535,3823
18232,3834,3871,3891,3914,3953,3986,3941,27390
18234,472,507,509,419,391,283,401,2982
18235,18907,19038,19236,19323,18894,19090,19353,133841
18237,3276,3392,3605,3848,3515,3563,3110,24309
18239,229,228,424,433,490,515,232,2551
18240,3804,3729,3854,3835,3929,3869,3891,26911
18241,695,787,748,825,945,793,646,5439
18242,176,184,184,207,214,222,235,1422
18244,309,481,415,451,440,441,402,2939
18245,297,446,542,546,482,471,348,3132
18246,166,162,181,162,178,152,143,1144
18248,587,559,575,572,585,690,631,4199
18249,3796,3817,4060,3691,3721,3819,4129,27033
18250,2977,2981,3002,3020,3045,3050,3034,21109
18251,55,75,110,108,107,52,46,553
18252,10834,11279,11047,11174,11205,11453,11188,78180
18254,926,872,784,862,769,760,871,5844
18255,4572,4392,4486,4399,4241,4404,4337,30831
18256,380,389,380,419,532,512,359,2971
18301,30706,29843,29608,28426,27877,27898,28561,202919
18302,17042,17050,16967,17418,17289,17014,17362,120142
18321,1240,1499,1626,1825,1794,1836,1711,11531
18322,2706,2649,2614,2779,2711,2721,2781,18961
18323,141,73,83,67,99,82,275,820
18324,8934,9347,9774,10193,10769,10801,9714,69532
18325,2609,2777,2563,2605,2269,1609,2465,16897
18326,4622,4763,4941,4589,4782,5307,4152,33156
18327,444,563,601,596,614,799,700,4317
18328,7375,7386,7426,7398,7477,7449,7759,52270
18330,7532,8428,9015,9412,10112,9476,8927,62902
18331,613,825,896,1056,1191,1044,867,6492
18332,2949,3105,3305,3080,2515,2379,3085,20418
18333,281,368,396,453,761,827,712,3798
18334,5595,5311,4696,4014,4467,4290,4156,32529
18335,862,793,615,525,297,214,672,3978
18336,3979,3986,4076,4158,4102,3971,4082,28354
18337,14303,14351,14444,14527,14610,14705,14572,101512
18340,160,106,134,141,140,102,174,957
18342,441,523,385,382,424,487,492,3134
18343,4182,4323,3832,3773,3771,3682,3982,27545
18344,3500,3272,3345,3390,3479,3434,3589,24009
18346,2617,2408,2699,2925,2679,2261,2964,18553
18347,2330,2286,2159,2397,2413,2538,3364,17487
18349,186,129,203,226,239,196,132,1311
18350,1727,1761,1753,2026,2006,1711,1931,12915
18351,482,431,523,570,457,441,518,3422
18352,1330,1279,1326,1364,1154,1025,1098,8576
18353,12148,11620,11939,12005,12352,12732,12779,85575
18354,846,793,701,645,445,425,951,4806
18355,1319,1451,1327,1286,1417,1542,1492,9834
18356,151,138,167,272,275,136,136,1275
18357,197,70,90,271,129,142,104,1003
18360,27000,27228,27379,28061,28578,28822,28362,195430
18370,919,1081,947,930,1396,1384,1096,7753
18371,1173,1010,957,631,499,462,747,5479
18372,2712,3192,3095,3035,3262,2874,3210,21380
18403,7138,7178,7175,6998,6926,6644,7087,49146
18405,2531,2557,2632,2666,2574,2483,2561,18004
18407,13441,13528,13811,13779,13902,14235,13862,96558
18411,22011,21970,21946,22163,22260,22099,21985,154434
18413,170,75,136,146,162,168,151,1008
18414,5322,5401,5263,5392,5638,5396,5452,37864
18415,1015,1152,1212,1075,1046,1078,1245,7823
18417,997,1000,1191,1217,1168,1186,1121,7880
18419,4940,4752,4676,4778,4411,4372,4634,32563
18420,36,41,55,57,55,36,57,337
18421,5315,5315,5022,4625,4444,4372,4754,33847
18424,5181,4964,5183,5046,4880,5169,5613,36036
18425,1329,1531,1338,1481,1441,1545,1354,10019
18426,4300,4323,4337,4604,5045,5199,4526,32334
18427,50,178,209,188,290,246,118,1279
18428,12240,12054,11836,11540,11526,11669,12012,82877
18430,12,10,18,21,33,43,33,170
18431,11968,12276,12470,13089,13528,13897,12666,89894
18433,6480,6615,6642,6882,7094,7290,6508,47511
18434,4043,4126,4030,4232,4225,4287,4192,29135
18435,700,660,787,747,656,638,795,4983
18436,12976,13224,13809,14212,14446,14584,13853,97104
18437,210,201,188,179,164,168,211,1321
18438,1190,1151,942,937,1002,951,1172,7345
18439,437,433,459,430,492,535,500,3286
18441,258,238,324,343,407,335,289,2194
18443,515,482,322,346,241,328,458,2692
18444,13882,13725,14297,14054,13539,13284,13778,96559
18445,2577,2486,2336,2222,2020,1938,2329,15908
18446,3493,3787,4076,3916,3873,3855,3733,26733
18447,10744,10377,10193,10160,9975,9854,10548,71851
18451,581,570,647,398,392,431,448,3467
18452,4747,4758,5024,5010,5079,5047,4802,34467
18453,1010,1207,1165,1097,1084,1036,1104,7703
18454,4,10,26,28,37,34,64,203
18455,69,73,67,102,102,102,105,620
18456,435,452,464,456,422,392,423,3044
18457,205,199,124,73,124,44,82,851
18458,2875,2991,2986,3040,3131,3076,3017,21116
18459,54,65,65,63,85,36,51,419
18460,173,244,224,231,196,186,184,1438
18461,375,350,334,325,248,247,404,2283
18462,426,435,438,403,451,459,427,3039
18463,224,194,204,262,287,271,199,1641
18464,1161,1180,1007,1147,921,882,1193,7491
18465,1339,1424,1392,1588,1575,1678,1340,10336
18466,17629,17783,17609,17450,17306,17517,16681,121975
18469,408,415,411,475,506,473,357,3045
18470,1978,2060,2014,2116,2294,2437,2226,15125
18471,647,660,591,610,525,495,685,4213
18472,7364,7403,7506,7415,7437,7211,7521,51857
18473,667,589,562,432,380,434,495,3559
18503,1256,1219,1152,1141,1022,929,1182,7901
18504,20138,20197,20488,21199,20619,21692,21265,145598
18505,20485,20426,20274,20933,20973,20782,20586,144459
18507,4910,4983,4850,4745,4884,4925,4891,34188
18508,12613,12417,12015,11644,11731,11758,12292,84470
18509,13620,13417,13548,13612,14243,13297,13589,95326
18510,14733,14812,14736,14577,14632,14735,14119,102344
18512,11695,12145,12125,11989,11997,12401,12218,84570
18517,5503,5592,5533,4959,4965,4753,5274,36579
18518,8172,8225,8265,8299,8323,8343,8313,57940
18519,4639,4732,4839,4838,4953,4986,5104,34091
18602,307,316,312,339,238,222,257,1991
18603,19438,19362,19364,19334,19239,19018,19320,135075
18610,4096,4421,4973,4813,4788,5467,5008,33566
18612,18615,18421,17489,17393,17400,16757,18051,124126
18614,2455,2575,2678,2744,2767,2699,2426,18344
18615,1873,1721,1718,1745,1938,2068,1867,12930
18616,627,578,529,527,551,608,738,4158
18617,1743,1746,1735,1851,2084,1988,1924,13071
18618,3625,3791,3830,3769,3878,3949,3793,26635
18619,277,235,203,202,224,231,273,1645
18621,6221,6189,5962,5934,6154,6119,6248,42827
18622,246,224,245,260,208,236,257,1676
18623,2736,2658,2517,2489,2382,2473,2733,17988
18624,530,625,647,656,590,470,718,4236
18625,493,578,548,452,386,357,491,3305
18626,541,585,680,676,660,648,516,4306
18628,228,198,272,291,263,216,192,1660
18629,1595,1729,1656,1694,1739,1946,1801,12160
18630,3107,3047,3358,3325,3219,3204,3556,22816
18631,1394,1386,1376,1380,1194,1262,1286,9278
18632,470,443,417,403,354,429,409,2925
18634,13373,13635,13797,13752,13474,13460,13569,95060
18635,4055,4022,4066,4049,4113,3925,3881,28111
18636,1453,1461,1483,1507,1465,1588,1438,10395
18640,17470,17354,17109,17219,17157,17149,17155,120613
18641,6706,6927,7174,7378,7142,7057,6812,49196
18642,4353,4141,4039,3887,3950,3913,4345,28628
18643,12440,12478,12569,12555,12652,12794,12908,88396
18644,7147,7043,7183,7195,7321,7590,7546,51025
18651,8396,8590,8661,8587,8850,9151,8880,61115
18653,107,107,140,114,138,133,132,871
18655,5853,6251,6369,6471,6581,6519,6278,44322
18656,2271,2098,2417,2404,2252,2589,2195,16226
18657,11933,12291,12305,12270,12498,12376,11985,85658
18660,3564,3263,3179,3254,3209,3200,3702,23371
18661,5804,5903,5657,5332,5418,5695,5730,39539
18701,3514,3567,3422,3198,3005,2994,3447,23147
18702,39618,40023,40814,41119,41121,41513,40295,284503
18704,31108,31155,31097,31356,31277,31092,31206,218291
18705,14592,14464,14007,14066,14324,14131,14806,100390
18706,15882,15919,15973,16176,16268,16397,16105,112720
18707,16124,16147,16000,15939,15850,15715,15557,111332
18708,9018,9217,10045,10121,9937,9843,8817,66998
18709,2945,2924,2911,2910,2892,2870,2903,20355
18801,8056,8125,8457,8701,8744,8740,8266,59089
18810,5832,5792,5845,5876,6107,5917,6162,41531
18812,1771,1782,1748,1566,1583,1582,1644,11676
18814,200,178,161,172,125,186,156,1178
18816,143,154,165,169,158,172,128,1089
18817,174,196,207,207,214,226,306,1530
18818,1232,1281,1321,1361,1456,1403,1394,9448
18821,1179,1127,1106,1152,1153,1207,1153,8077
18822,3518,3631,3637,3651,3673,3520,3642,25272
18823,232,232,269,161,244,195,193,1526
18824,1426,1447,1382,1341,1314,1344,1401,9655
18825,136,144,148,138,107,130,111,914
18826,1694,1757,1569,1600,1487,1351,1910,11368
18828,336,314,295,224,216,223,352,1960
18829,789,888,934,799,817,879,868,5974
18830,618,611,697,792,846,832,735,5131
18831,1473,1461,1303,952,1099,1036,1039,8363
18832,1994,1953,1983,1920,1814,1901,1874,13439
18833,1950,2002,1867,1964,1954,1865,2056,13658
18834,3430,3536,3556,3712,3654,3881,3691,25460
18837,3065,3062,3151,3158,3315,3478,3267,22496
18840,10818,11007,10985,11177,11007,11113,10731,76838
18842,291,274,264,284,294,271,278,1956
18843,273,211,215,145,151,190,277,1462
18844,2038,1992,2060,2005,2061,1953,1870,13979
18845,323,312,324,360,314,307,297,2237
18846,1004,958,878,851,798,794,847,6130
18847,5682,5737,5675,5888,5886,5947,6024,40839
18848,8915,9099,8985,8997,9011,8790,9193,62990
18850,2233,2157,2258,2151,2249,2231,2357,15636
18851,813,827,888,879,766,798,706,5677
18853,4065,4044,4166,4449,4692,4316,4252,29984
18854,1277,1217,1272,1360,1345,1400,1510,9381
18901,27742,27134,27239,27725,27949,27937,27598,193324
18902,21098,20766,20517,20820,20482,20679,20973,145335
18912,246,295,11,8,0,0,39,599
18913,99,90,82,76,47,27,185,606
18914,21572,21550,21600,21694,21519,20987,21063,149985
18915,730,675,738,882,903,897,1063,5888
18917,2121,2120,2158,2286,2338,2223,2158,15404
18920,369,382,362,226,139,165,361,2004
18923,889,944,906,928,969,835,998,6469
18925,6894,6420,6560,6497,6245,5763,6195,44574
18929,9093,8882,8488,8435,8510,8610,9306,61324
18930,2590,2657,2354,2358,2543,2647,2721,17870
18932,536,520,415,470,414,354,388,3097
18935,0,0,20,21,37,40,116,234
18936,0,56,53,55,60,39,4,267
18938,13861,14093,14056,14105,14087,13854,13989,98045
18940,29114,29059,29084,29183,28982,28982,28825,203229
18942,3174,3175,3387,3275,3719,3755,3260,23745
18944,25190,25295,25430,24984,24361,24735,24479,174474
18947,6254,6972,7010,6864,6949,6964,6172,47185
18950,197,179,212,194,192,123,252,1349
18951,34577,34500,34484,34354,34511,34263,34651,241340
18954,9697,9482,9688,9660,9677,9719,9745,67668
18955,1919,1636,1520,1455,1551,1579,1662,11322
18960,12544,12386,12590,12566,12838,12893,12473,88290
18962,552,555,563,602,492,397,515,3676
18964,13744,13557,13819,13955,13408,13104,13812,95399
18966,37501,37843,37545,38010,38005,37949,37999,264852
18969,15824,15361,15140,14791,15132,14923,15273,106444
18970,789,764,804,813,664,672,696,5202
18972,3804,3656,3583,3698,3730,3577,3512,25560
18974,41024,41399,41533,41325,41577,41381,40953,289192
18976,19809,19922,19758,19464,19036,18788,19795,136572
18977,3697,3868,3988,3917,4132,4022,4291,27915
18980,506,485,562,551,503,517,510,3634
19001,17046,17198,17365,17115,17236,17581,17020,120561
19002,34063,33565,33187,33342,32883,31511,32412,230963
19003,13065,12788,12826,12674,12646,13278,12519,89796
19004,9634,9618,9550,9492,9544,9413,9416,66667
19006,21980,21644,21465,21048,21400,20953,21423,149913
19007,20715,20864,20500,20703,20805,20524,21125,145236
19008,20750,20884,20517,20572,20509,20414,20535,144181
19009,908,955,1026,982,1011,935,864,6681
19010,20664,20675,20642,20900,21184,21240,21103,146408
19012,6513,6704,6894,6754,6752,6805,6670,47092
19013,35463,35546,35589,35451,35496,35798,35130,248473
19014,21165,21238,21422,21067,20805,20972,21206,147875
19015,16552,16489,16336,16313,16421,16250,16632,114993
19017,263,335,327,366,407,432,348,2478
19018,23558,23632,23666,23283,23407,23593,23360,164499
19020,55339,55424,55527,55650,55741,55715,55493,388889
19021,9877,9918,10121,10105,10324,10374,10074,70793
19022,4052,3810,3977,3561,4104,4007,3669,27180
19023,22386,22447,22615,22710,22500,22430,22164,157252
19025,5333,5257,5379,5558,5679,5878,5395,38479
19026,31134,30919,31198,30324,30645,31248,30738,216206
19027,20040,20049,19507,19494,19684,19944,19067,137785
19029,3975,3984,4006,3973,3998,4039,3971,27946
19030,11947,11897,12347,12249,12512,12411,12122,85485
19031,4853,4968,4791,4678,4792,4883,4700,33665
19032,6616,6630,6615,6617,6617,6630,6606,46331
19033,8468,8289,8300,8669,8520,8322,7777,58345
19034,6270,6055,5908,5641,5591,5801,5999,41265
19035,4140,3853,3799,3528,3220,3442,3780,25762
19036,12991,12939,12852,12789,12736,12820,12942,90069
19038,30852,31008,30974,31405,30748,30709,31595,217291
19040,20571,20333,20142,20318,20236,20204,20536,142340
19041,5950,5871,6062,6132,6043,6229,6248,42535
19043,2738,2409,2435,2370,2472,2717,2664,17805
19044,15721,16018,16178,16294,16461,16557,15853,113082
19046,17264,17167,17187,17685,17781,17937,17809,122830
19047,35300,36066,35845,35202,35306,35594,35056,248369
19050,27665,27983,27941,27743,28326,28307,28073,196038
19053,26132,26176,26234,26005,25931,25993,25966,182437
19054,16653,17035,16960,17607,17437,17179,17437,120308
19055,13618,13317,13421,13223,13508,13759,13924,94770
19056,15252,15522,15586,15616,15677,16258,15486,109397
19057,18501,17905,17755,18171,17482,16846,17191,123851
19060,11125,11308,11185,11321,11228,10987,11368,78522
19061,20222,20103,19706,20087,20101,19526,19997,139742
19063,35159,35069,35875,35666,35864,35720,35704,249057
19064,24744,24562,24787,24689,24718,24561,24459,172520
19066,5783,6001,6140,6212,6284,6021,5864,42305
19067,51628,51407,51148,50790,50915,51503,51334,358725
19070,6941,7079,6885,7043,7182,7251,7277,49658
19072,9306,9283,9112,9129,9192,9309,9539,64870
19073,19363,18960,18508,18629,18392,18302,18332,130486
19074,5900,5897,5897,5894,5887,5890,5890,41255
19075,7568,7506,7541,7390,7391,7302,7354,52052
19076,6545,6568,6591,6606,6571,6533,6525,45939
19078,11193,11039,10793,10988,10961,11092,11067,77133
19079,9165,9195,9265,9309,9347,9294,9168,64743
19081,9940,9928,9934,9875,10189,10234,10337,70437
19082,40740,40411,40251,41431,40924,40111,40997,284865
19083,36809,36765,36292,36111,35748,35432,35878,253035
19085,8716,8563,8734,8602,8525,8669,8932,60741
19086,11756,11605,11376,11402,11252,11299,11420,80110
19087,32437,32747,32659,32663,32683,32694,32225,228108
19090,19085,19163,19342,19147,18868,18541,18832,132978
19094,3910,4909,4846,4544,3539,3524,4406,29678
19095,7393,7422,7847,7549,7270,7144,7063,51688
19096,13545,13792,14000,13967,13994,13457,13572,96327
19102,4867,4656,4354,4056,3592,3842,4705,30072
19103,22911,23154,23492,22427,22850,22212,21908,158954
19104,54890,54718,53360,52800,53002,51658,51808,372236
19106,12095,11763,11474,11424,10833,10431,11740,79760
19107,13464,12727,12319,12327,11802,11774,14875,89288
19109,0,0,0,0,0,0,0,0
19111,69917,70453,69367,68620,67295,64207,63090,472949
19112,0,0,0,0,0,0,13,13
19113,118,112,97,117,106,75,120,745
19114,30639,30677,30952,30651,30745,32140,30907,216711
19115,32583,32661,32504,33780,32605,33905,33207,231245
19116,33212,33842,33220,31763,32338,32726,33112,230213
19118,10539,10123,10093,9626,9261,9551,9808,69001
19119,28605,28211,29012,29017,28170,26870,27035,196920
19120,76459,77534,77645,76430,74763,71367,68104,522302
19121,32651,33045,32787,33543,34418,34625,36572,237641
19122,22076,21120,20359,19784,19343,19078,21653,143413
19123,14824,13971,13342,13285,12267,11667,13416,92772
19124,69125,64803,64015,64044,63222,63785,66691,455685
19125,24504,22963,22560,23070,22472,21379,22958,159906
19126,15339,16398,15982,16282,16531,17099,15758,113389
19127,6263,5889,6032,5457,5094,4576,5913,39224
19128,36958,37582,37152,35720,35041,34561,35239,252253
19129,11018,11178,11287,11582,11125,11398,10975,78563
19130,26765,26546,26743,25731,24219,23217,24870,178091
19131,41797,41652,43493,42194,43660,45545,43172,301513
19132,34590,36876,35930,36218,35903,35659,36268,251444
19133,26811,26914,26247,25881,24615,24775,26063,181306
19134,64089,62840,63631,61108,58914,59169,60675,430426
19135,31599,31868,31886,32336,33731,32282,33091,226793
19136,33656,33663,34873,36865,39587,39680,40647,258971
19137,8284,7853,7951,8439,8316,8324,8638,57805
19138,33808,34159,34240,34573,33955,32480,32273,235488
19139,43499,43534,42451,43181,43181,42943,41271,300060
19140,51132,52508,53608,53778,54687,55272,54133,375118
19141,34316,34255,33591,32058,32876,33236,31376,231708
19142,28221,28595,28770,29381,29332,30340,29595,204234
19143,63518,63553,64073,66372,66969,67104,64849,456438
19144,40613,41617,41549,44380,44803,44341,43329,300632
19145,47900,46758,47498,47776,47857,45930,47261,330980
19146,37233,37728,36596,34837,34095,33886,35113,249488
19147,38848,37967,36580,35014,33845,33171,36228,251653
19148,53870,53979,52629,51455,49088,48835,49732,359588
19149,56933,55077,55445,53731,53857,55535,55006,385584
19150,24376,25031,25282,24273,23370,22880,23378,168590
19151,34391,33982,32683,32824,32381,31495,29883,227639
19152,34887,34731,34684,33238,33832,32895,33293,237560
19153,12789,11925,11663,12053,12020,12670,12259,85379
19154,33159,34056,33618,33419,34006,34030,34196,236484
19301,6629,6686,6498,6247,6294,6461,6402,45217
19310,3178,3239,3264,2919,3310,3252,3066,22228
19311,9726,9549,9468,9094,8805,8759,8584,63985
19312,12068,11766,11750,11604,11442,11567,11539,81736
19316,110,94,116,94,236,215,186,1051
19317,9669,9882,9572,9453,9405,9194,9530,66705
19319,773,990,976,1097,1119,1123,1130,7208
19320,54144,53921,53952,52798,52093,51513,52342,370763
19330,5485,5315,5323,5495,5483,5079,5421,37601
19333,6431,6558,6644,6935,7076,6802,6895,47341
19335,47646,46709,46785,46691,46766,46365,46984,327946
19341,17187,17636,16982,16916,16846,16418,16709,118694
19342,18915,18961,18736,18709,18338,18262,18099,130020
19343,8243,8854,8492,8432,8486,8272,8142,58921
19344,12243,12204,12077,11947,11840,11651,11919,83881
19345,743,752,736,734,717,681,689,5052
19348,22914,22412,22036,21798,22240,22092,22232,155724
19350,11815,11596,11463,11406,11235,10950,10921,79386
19352,10764,10653,10812,10466,10122,10144,10622,73583
19355,24811,24491,24560,24743,24261,24047,24760,171673
19358,709,623,496,479,407,525,526,3765
19362,5810,6163,6432,6270,6245,6214,5815,42949
19363,17149,17186,16964,17104,17026,16650,17055,119134
19365,7125,7174,6844,6929,6781,6910,7006,48769
19367,32,39,42,104,135,138,171,661
19372,1707,1560,1406,1536,1311,1381,1360,10261
19373,5110,4701,4858,4693,4431,4342,4273,32408
19374,886,1023,1157,1498,1358,1321,1252,8495
19375,63,82,87,74,24,86,104,520
19380,50419,50400,50330,50098,49708,49827,49534,350316
19382,55178,54678,54144,53404,53265,52942,52388,375999
19383,2999,3105,3007,2902,3068,3127,3169,21377
19390,13502,13707,13588,13606,13212,13173,13425,94213
19401,42047,42120,42003,41799,41617,41329,41753,292668
19403,46168,45721,45307,44773,44465,43990,44260,314684
19405,5506,5469,5445,5252,5176,4855,5127,36830
19406,23493,23417,23330,23327,23454,23598,23441,164060
19422,18815,18637,18704,18485,18409,18598,18506,130154
19425,14942,14462,14464,14067,13791,13332,13922,98980
19426,40268,40391,40083,39344,38980,38446,38831,276343
19428,16498,16108,16243,16650,16421,16787,16580,115287
19435,204,182,100,198,158,139,100,1081
19436,494,497,599,605,601,630,640,4066
19437,623,638,552,615,511,591,757,4287
19438,24921,24880,24677,24283,23616,23382,23765,169524
19440,18282,18689,18366,18191,17750,17979,18038,127295
19442,0,0,0,0,0,0,45,45
19444,10861,10787,10796,10584,10357,10222,10519,74126
19446,56019,55072,54910,55090,54718,54948,55138,385895
19453,1217,1091,1275,1348,1423,1563,1483,9400
19454,29083,29705,29171,27927,28484,27951,27870,200191
19456,902,953,810,774,618,807,737,5601
19457,81,195,172,193,165,137,125,1068
19460,41288,41171,40648,40163,39619,39188,40154,282231
19462,15166,15234,14928,14845,15063,14755,14658,104649
19464,46595,46137,45815,45593,45498,45011,45788,320437
19465,17126,17069,17184,17053,17079,16778,17038,119327
19468,26061,25634,25694,25668,25174,24851,25536,178618
19472,40,34,36,34,0,0,74,218
19473,16272,16705,16339,15891,15975,15395,15726,112303
19474,547,478,465,519,407,389,733,3538
19475,11297,11248,11483,11550,11425,11587,11283,79873
19477,125,174,103,152,157,167,146,1024
19492,398,364,549,391,431,397,717,3247
19501,966,980,912,898,1009,940,1047,6752
19503,1240,1422,1387,1380,1371,1091,1142,9033
19504,4989,5222,5546,5377,5325,5328,4998,36785
19505,3184,2987,2649,2944,3116,3259,3226,21365
19506,7204,7128,6914,7167,7736,7582,7356,51087
19507,3495,3757,3787,3483,3597,3216,3280,24615
19508,15783,16378,15995,15646,15312,15731,15725,110570
19510,8271,7678,7492,7466,7527,7339,7639,53412
19511,102,162,168,218,358,396,215,1619
19512,17063,16925,17218,17055,17256,17394,16954,119865
19518,15071,14945,14859,14789,14568,14233,14734,103199
19519,0,64,69,95,104,126,101,559
19520,5534,5632,5527,5639,5596,5676,5465,39069
19522,14128,14654,14834,15082,14933,14607,14229,102467
19523,415,440,214,316,295,280,250,2210
19525,15814,15478,15169,14562,13964,13529,14107,102623
19526,11197,11303,11440,11487,11326,11500,11039,79292
19529,3482,3310,3357,3233,3121,3083,3131,22717
19530,16425,16412,16220,15941,15947,15714,16432,113091
19533,8461,8233,8311,8077,7567,7714,7686,56049
19534,1890,2071,1902,2026,2127,2113,2041,14170
19535,37,34,46,48,43,17,23,248
19536,567,583,479,437,404,453,490,3413
19538,15,29,30,46,112,203,64,499
19539,4746,4443,4583,4783,4690,4882,4597,32724
19540,11651,11489,11643,11689,12257,12111,11723,82563
19541,4138,3956,3831,3971,4085,4114,4403,28498
19542,0,0,0,0,0,79,67,146
19543,6122,6062,5829,6029,5992,5453,5905,41392
19544,82,52,153,152,187,218,196,1040
19545,441,509,438,498,520,496,428,3330
19547,4251,4089,4545,4250,4344,4548,4222,30249
19549,260,210,215,268,253,284,326,1816
19550,710,723,734,591,597,557,641,4553
19551,5021,5129,4958,5021,5062,4792,5034,35017
19554,355,356,295,345,339,315,374,2379
19555,3437,3442,3379,3458,3343,3383,3406,23848
19559,337,295,257,273,306,358,362,2188
19560,7946,7721,7812,7776,7656,7415,7805,54131
19562,2630,2684,2718,2609,2304,2441,2622,18008
19564,137,123,81,54,101,159,90,745
19565,9153,9199,8939,8774,8650,8449,8531,61695
19567,5123,5218,5207,5248,5264,5377,5388,36825
19601,34336,34310,33904,33574,33403,31885,32998,234410
19602,16821,16823,17848,17433,18190,18535,17900,123550
19604,26083,26349,26210,26983,26703,27757,27658,187743
19605,19649,19664,19271,19205,19094,19519,18985,135387
19606,34713,34736,34789,34724,34275,33996,34416,241649
19607,22768,22599,22401,22062,21482,21598,22544,155454
19608,22431,22178,22042,22354,21838,21455,22719,155017
19609,9535,9478,9618,9530,10402,10199,9946,68708
19610,15762,15907,15812,15757,15246,15332,15258,109074
19611,10668,10812,10718,10845,10985,10536,10589,75153
19701,40611,39520,40797,41159,40443,40387,39194,282111
19702,53870,53402,52515,52830,52656,51353,51899,368525
19703,15196,15228,15143,14806,14227,14027,14471,103098
19706,2012,2050,2012,2204,1917,1971,1822,13988
19707,15852,15531,15893,15675,15768,15765,16483,110967
19709,38485,38099,37826,37173,35438,34675,35107,256803
19710,15,19,18,18,0,0,41,111
19711,51185,51072,50696,50844,50327,50927,51322,356373
19713,30952,30710,30642,30969,30517,30332,30408,214530
19716,1040,1002,1065,1330,1337,1359,1568,8701
19717,4417,4358,4070,3951,4091,3632,3770,28289
19720,61615,61833,60491,59808,61095,60384,59250,424476
19730,1251,1197,719,484,471,329,451,4902
19731,359,210,185,141,153,191,252,1491
19732,73,68,73,82,117,26,25,464
19733,234,251,299,253,147,76,110,1370
19734,11892,11995,11594,10955,10536,10029,11651,78652
19735,50,46,0,0,0,45,12,153
19736,61,0,0,0,0,0,32,93
19801,15422,15622,15895,15656,15355,15684,16286,109920
19802,26113,26273,25367,25396,25385,25791,24621,178946
19803,21779,21339,21236,21373,21154,21277,21364,149522
19804,17651,17593,17980,18027,18446,18398,17944,126039
19805,41010,41112,41071,40586,41422,40111,40937,286249
19806,9567,9506,9685,9864,9867,9931,9560,67980
19807,6978,7098,7109,7236,7337,7609,7405,50772
19808,38776,38767,38323,37286,36866,37231,38442,265691
19809,15273,15231,14466,14405,14080,14311,14049,101815
19810,25269,25369,25635,25460,25553,25538,25011,177835
19901,36989,37135,37116,36636,35333,35598,35055,253862
19902,396,399,207,180,125,134,283,1724
19904,33766,33218,32185,32516,33183,32791,34132,231791
19930,2266,2250,2116,2185,1940,2028,2768,15553
19931,225,214,225,211,232,216,211,1534
19933,9818,9220,8890,8384,8495,7854,8535,61196
19934,13594,14234,13814,13255,13231,13024,12805,93957
19936,241,288,310,306,421,442,302,2310
19938,8770,8992,9224,8762,8705,8822,8357,61632
19939,6018,5944,6032,6651,7296,7371,5979,45291
19940,5602,5197,5600,5642,5224,5311,5574,38150
19941,3069,2886,3484,3270,3012,2811,2522,21054
19943,12503,12548,12327,12473,12105,11656,11425,85037
19944,626,641,637,551,497,640,620,4212
19945,6814,7483,8594,8758,8819,8423,6862,55753
19946,4819,4321,4293,4445,4263,4310,4420,30871
19947,19562,18990,18447,18710,18267,18252,18799,131027
19950,7499,7733,7601,7400,6481,6581,6951,50246
19951,1873,1790,1678,1879,1922,1836,1733,12711
19952,10428,10502,10452,9940,10021,10060,10220,71623
19953,4327,3915,4152,4218,4065,3965,4386,29028
19954,1675,1435,1366,1388,1511,1510,1464,10349
19955,40,94,97,78,80,81,72,542
19956,15103,15591,15460,14994,14906,14197,15500,105751
19958,23580,22768,21844,20339,19356,18904,19650,146441
19960,6487,7143,7372,7510,7398,6833,6295,49038
19962,11373,10691,10589,9943,10086,9460,10206,72348
19963,20395,19365,18931,19147,18304,18054,19206,133402
19964,1096,1331,1355,1263,1550,1353,1340,9288
19966,27957,27230,26638,27050,26916,26846,24601,187238
19967,1077,798,442,432,415,318,354,3836
19968,9760,9236,8886,8936,9139,9108,9549,64614
19970,7799,7347,6693,6226,6678,6342,6170,47255
19971,12173,12254,11866,11576,11224,11735,12385,83213
19973,24509,23706,23249,21788,21540,21072,23838,159702
19975,8735,8926,8467,8345,8862,9172,8253,60760
19977,26063,25449,24977,24446,23273,21671,22984,168863
19979,660,689,639,642,551,686,632,4499
20001,44998,43731,41345,40811,38570,38395,38551,286401
20002,59659,57412,56646,56331,55023,53640,52370,391081
20003,29071,28538,28202,27383,27231,25836,26454,192715
20004,1708,1667,1667,1531,1589,1569,1622,11353
20005,13063,12947,12497,11858,12062,11987,12775,87189
20006,2920,2905,2969,3049,2941,2884,3227,20895
20007,26415,26687,26470,25590,25249,25055,26866,182332
20008,28261,28141,28327,27590,27527,27641,27525,195012
20009,51508,51499,50709,49979,47537,46366,47992,345590
20010,32421,32544,33670,32084,31139,30172,30138,222168
20011,67349,66571,65701,62569,59379,58108,58536,438213
20012,14457,14393,14656,14441,14640,15037,13414,101038
20015,16323,16331,15916,15614,15796,15396,15332,110708
20016,35192,35101,34371,34144,33991,33020,32519,238338
20017,20371,19311,19364,19195,18336,18171,17735,132483
20018,20363,19957,18834,18296,17367,16750,16894,128461
20019,57962,56090,53352,52572,52103,52232,54358,378669
20020,54955,53646,52480,51176,51213,49961,49864,363295
20024,12183,11665,11245,11678,11713,12021,11510,82015
20032,41232,39776,38152,36772,35349,33628,35653,260562
20036,5655,5405,5157,5207,5672,5356,5435,37887
20037,15285,15687,15156,14502,14304,13642,14642,103218
20045,0,0,0,0,0,0,0,0
20052,431,388,341,503,555,597,470,3285
20053,0,0,0,0,0,0,0,0
20057,3697,3651,3809,3886,4074,4216,3888,27221
20064,2125,1945,1742,1723,1684,1656,1890,12765
20105,16265,15021,13647,12468,11420,10697,11315,90833
20106,5334,5187,5265,5439,5416,5606,5142,37389
20109,38360,37332,35711,36470,34256,33389,37265,252783
20110,47975,48019,47103,45480,43640,41939,43876,318032
20111,34433,34000,32648,31845,31106,30344,30590,224966
20112,26914,26867,27187,26017,25777,25046,25833,183641
20115,6485,6551,5975,6006,6261,6400,5838,43516
20117,2507,2530,2450,2428,2576,2486,2693,17670
20118,6,11,11,8,9,8,7,60
20119,4383,4345,4407,4197,3988,3788,3946,29054
20120,40581,41180,41244,41732,41318,41418,40695,288168
20121,29695,29835,29932,28902,28381,28076,27988,202809
20124,15318,15620,15713,16278,16032,16000,14857,109818
20129,616,532,734,712,643,704,618,4559
20130,123,127,173,247,330,370,281,1651
20132,17455,17939,17531,17262,16503,16693,15900,119283
20135,2940,2835,2959,2898,2970,3085,2834,20521
20136,30539,31361,31367,30283,29346,28389,28498,209783
20137,1410,1318,1456,1422,1415,1478,1510,10009
20139,250,266,171,181,271,188,217,1544
20141,6375,6493,6275,6588,6558,6231,6131,44651
20143,1211,1175,1357,1081,1213,1289,1216,8542
20144,1205,1268,1222,1289,1389,1396,1012,8781
20147,62907,61983,59371,57758,55759,53312,54086,405176
20148,42883,38831,34777,31453,28440,25533,28310,230227
20151,22746,22203,21959,21744,21715,20865,21374,152606
20152,30697,28574,27826,26591,25621,24296,24946,188551
20155,34202,32716,32069,31724,29738,28750,29411,218610
20158,4347,4219,4196,4149,4395,4354,4288,29948
20164,40370,39222,39056,36808,36201,35123,37747,264527
20165,33813,33519,33252,33306,32377,31465,32383,230115
20166,9961,10150,9945,9857,9465,9376,9521,68275
20169,22800,22604,21476,20792,19702,19108,19801,146283
20170,42731,42818,42634,41673,41152,39997,41236,292241
20171,49367,49067,48663,47565,46201,45047,45887,331797
20175,31887,31288,30606,29156,28263,27044,27169,205413
20176,51588,50629,48876,47889,46270,45420,46506,337178
20180,6985,6535,6426,5990,6135,5927,6549,44547
20181,8630,7959,7844,7891,7505,7211,7877,54917
20184,635,541,764,888,807,940,839,5414
20186,14459,14713,14854,14892,14365,14668,14557,102508
20187,16886,16511,16179,15860,15862,15762,15252,112312
20190,18759,18445,18274,18127,17638,16520,17529,125292
20191,29666,29362,29021,28968,28574,27841,29128,202560
20194,13020,13635,13319,13501,13436,13203,13165,93279
20197,1830,1738,1667,1482,1743,1877,1840,12177
20198,2345,2262,2316,2248,2116,2295,2492,16074
20202,0,0,0,0,0,0,0,0
20204,0,0,0,0,0,0,0,0
20228,0,0,0,0,0,0,0,0
20230,0,0,0,0,0,0,0,0
20240,0,0,0,0,0,0,0,0
20245,0,0,0,0,0,0,0,0
20260,0,0,0,0,0,0,0,0
20307,217,299,118,127,108,88,353,1310
20317,460,482,406,355,348,345,903,3299
20319,69,89,89,104,106,101,84,642
20373,119,141,66,68,38,39,131,602
20390,540,485,279,233,115,46,584,2282
20405,0,0,0,0,0,0,0,0
20418,0,0,0,0,0,0,0,0
20427,0,0,0,0,0,0,0,0
20506,0,0,0,0,0,0,0,0
20510,0,0,0,0,0,0,0,0
20520,0,0,0,0,0,0,0,0
20535,0,0,0,0,0,0,8,8
20540,0,0,0,0,0,0,0,0
20551,0,0,0,0,0,0,0,0
20553,0,0,0,0,0,0,0,0
20560,0,0,0,0,0,0,0,0
20565,0,0,0,0,0,0,0,0
20566,0,0,0,0,0,0,0,0
20593,0,0,0,0,0,0,0,0
20601,26029,25028,25881,24814,24801,24745,24156,175454
20602,26393,26708,26647,25835,25225,24640,24955,180403
20603,31304,31784,31733,30964,30628,29861,28967,215241
20606,490,443,408,360,335,335,431,2802
20607,10350,10639,9730,9923,9560,9668,9802,69672
20608,793,806,744,781,813,806,919,5662
20609,1073,1111,1090,1081,1066,943,1120,7484
20611,1452,1197,945,972,878,828,1078,7350
20612,480,473,372,279,259,258,261,2382
20613,14261,14606,14284,14440,13446,12645,11860,95542
20615,456,460,433,424,244,291,405,2713
20616,6100,6014,6604,6684,6369,6348,5857,43976
20617,719,932,969,1007,878,1041,781,6327
20618,543,794,811,689,705,560,607,4709
20619,12124,11447,10886,10529,9817,9808,10503,75114
20620,1330,1218,1291,1359,1586,1535,1443,9762
20621,923,1118,1385,1405,1180,1517,1373,8901
20622,6135,5319,4781,5087,4651,4784,4900,35657
20623,3162,3041,2773,2878,3016,2899,2744,20513
20624,1327,1206,1229,1213,1164,1128,1282,8549
20625,828,703,630,628,644,546,1062,5041
20626,290,267,247,256,359,388,373,2180
20628,174,210,133,316,305,278,594,2010
20629,312,180,263,219,227,310,535,2046
20630,374,376,291,334,187,115,348,2025
20632,384,290,359,280,331,333,347,2324
20634,7114,6871,6769,6562,6252,6683,5927,46178
20636,10789,10096,10280,10349,10435,10505,9937,72391
20637,5164,5247,5102,4675,4856,4590,5423,35057
20639,15238,15034,14682,14422,14442,13848,14227,101893
20640,10658,11137,10579,10614,9945,9246,10438,72617
20645,1029,1031,1117,926,862,749,857,6571
20646,20118,18615,18937,19060,18866,18274,18890,132760
20650,14379,14030,13472,13467,13569,12897,13717,95531
20653,23973,24344,25580,25587,26057,24597,24481,174619
20657,18959,19525,19639,20181,20538,20601,20483,139926
20658,1054,1196,1005,1014,990,1081,854,7194
20659,23946,24656,24010,23872,23320,23165,23498,166467
20660,24,25,28,2,44,76,97,296
20662,3127,3262,2836,2557,2752,2751,2934,20219
20664,2931,2905,2746,2836,2636,3020,2987,20061
20667,550,508,485,509,416,201,494,3163
20670,1583,1488,1421,1331,1203,1333,1014,9373
20674,609,723,813,829,925,858,830,5587
20675,1766,1563,1398,1312,1663,1785,1671,11158
20676,4234,4419,4478,3503,3775,3716,3871,27996
20677,2177,2487,2270,2477,2802,2707,2322,17242
20678,12452,12163,12285,11877,11168,11108,11045,82098
20680,1190,1361,1461,1270,1148,1415,1119,8964
20684,1462,1443,1116,857,959,1210,1125,8172
20685,6423,6342,6313,6614,6818,6801,6471,45782
20686,1583,1720,1020,933,754,1098,1332,8440
20687,382,367,379,379,368,188,313,2376
20688,1864,1653,1559,1633,1645,1687,1828,11869
20689,1919,1481,1440,1562,1865,1919,1694,11880
20690,754,622,567,457,394,397,740,3931
20692,1418,1641,1676,1475,1312,1036,1051,9609
20693,1054,1299,1243,1008,926,1156,1088,7774
20695,6851,5661,4829,5537,5770,6144,6794,41586
20701,0,0,92,108,122,144,2,468
20705,28139,27305,26658,25487,25222,24070,26188,183069
20706,38938,39718,38682,38161,37358,37274,38692,268823
20707,32344,32362,32099,31938,31459,31123,31538,222863
20708,26315,26196,25375,25287,25206,24972,25546,178897
20710,9817,9690,9559,9396,9323,9150,9313,66248
20711,6632,6535,6586,6592,6462,6549,6643,45999
20712,9200,9146,9000,8954,8965,9071,9031,63367
20714,4772,4394,4598,4398,4077,4085,4345,30669
20715,26193,26627,26906,27772,27011,26766,26382,187657
20716,22152,21860,21184,20779,20485,20197,20787,147444
20720,22436,21865,22097,21755,21356,21302,21031,151842
20721,28901,27718,27847,26412,26134,26771,27016,190799
20722,5918,5966,5883,5408,5571,5429,5711,39886
20723,33399,32129,31049,29882,28739,27639,28972,211809
20724,17647,17060,17000,16024,15177,16065,16093,115066
20732,9957,9973,9861,10071,9616,9372,9919,68769
20733,2902,2799,2747,2873,2708,2973,2672,19674
20735,38562,38610,38237,36505,35555,35383,35421,258273
20736,9512,9947,9517,9556,9264,9318,8904,66018
20737,21922,21720,21248,20427,20195,20944,20684,147140
20740,31515,31152,29017,28459,27776,27772,28780,204471
20742,6615,6759,8574,8583,8822,8218,7808,55379
20743,39108,38828,38788,37626,36099,37031,38621,266101
20744,52730,51759,51460,50632,51088,51627,50722,360018
20745,29512,29145,30260,29710,28626,27822,28451,203526
20746,27322,27196,27659,28624,28009,28074,28838,195722
20747,37752,37800,37597,38415,39879,40424,40054,271921
20748,39204,38236,38525,38371,39490,39728,38792,272346
20751,2411,2327,2315,2273,2127,2343,2343,16139
20754,6757,6616,6809,6911,6978,6999,6951,48021
20755,9730,10137,9809,10369,10712,10977,9302,71036
20758,425,488,486,559,668,682,721,4029
20759,4207,4250,3417,3174,3437,3435,3355,25275
20762,3336,3226,3356,3632,3210,2651,2973,22384
20763,2030,2101,2358,1708,2347,2435,2664,15643
20764,4426,4801,4742,4643,4590,4275,4176,31653
20765,360,479,578,465,420,373,514,3189
20769,6972,6619,6793,5962,6244,6109,6604,45303
20770,25839,25954,25405,24873,24816,24631,25173,176691
20772,45653,44836,44075,43749,43925,42975,42625,307838
20774,44154,44796,44182,42874,42351,42145,43013,303515
20776,3350,3344,3339,3672,3607,3388,3289,23989
20777,3464,3719,3281,3230,3199,2848,3314,23055
20778,2103,1909,2114,2085,2152,2162,2009,14534
20779,1094,1169,1314,1375,1192,1137,1182,8463
20781,11379,11493,11841,11665,11920,11898,11440,81636
20782,34919,33896,33480,33840,33769,32339,30560,232803
20783,46980,48590,49006,47331,46389,45517,44487,328300
20784,30373,30306,29383,29484,29515,28801,29449,207311
20785,37061,36592,35901,36357,35771,35467,35052,252201
20794,15282,14510,13917,14579,14682,15721,14098,102789
20812,334,286,255,251,232,290,255,1903
20814,28828,28241,28154,27804,26998,26827,27642,194494
20815,30269,30009,30533,30774,30323,30152,29082,211142
20816,16341,16581,16611,16037,15904,15240,16208,112922
20817,36856,36164,36071,36370,36222,35780,36240,253703
20818,1783,2056,1948,1967,2057,2380,1962,14153
20832,26443,26151,25999,25454,24919,24531,24965,178462
20833,7471,7638,7832,7186,7698,7939,7735,53499
20837,6262,6046,5935,5888,5657,5666,5789,41243
20838,283,247,200,250,267,234,259,1740
20839,58,64,111,133,195,206,214,981
20841,11069,11467,10546,10796,10637,10150,10460,75125
20842,1681,1634,1879,1597,1622,1923,1824,12160
20850,48303,47184,46711,46629,45464,45420,46340,326051
20851,14972,14930,14352,13641,13665,13146,14191,98897
20852,46784,45962,44596,42364,40725,38430,40365,299226
20853,30286,30336,30073,29714,29548,29921,29673,209551
20854,49926,50494,50369,49759,49714,49088,49611,348961
20855,14871,14686,14178,14176,14377,13973,14295,100556
20860,2741,2566,2347,2513,2375,2283,2396,17221
20861,1852,1848,1999,1705,1596,1710,1875,12585
20862,268,260,154,161,175,180,343,1541
20866,14582,13959,12900,12627,12557,13856,13344,93825
20868,827,1012,1199,1170,1335,1063,790,7396
20871,18388,16795,15246,14393,12953,11757,13130,102662
20872,13248,13016,13238,12942,13264,13449,13104,92261
20874,60306,59202,57979,58537,57883,55891,57367,407165
20876,26695,26423,26300,26037,25895,25304,25496,182150
20877,38149,36724,36816,34886,33519,31279,34321,245694
20878,64356,64890,63855,63474,62983,62892,62446,444896
20879,26259,25584,25592,25269,24630,24570,24360,176264
20880,487,535,538,516,489,441,450,3456
20882,13921,14253,14397,14157,14294,13730,14063,98815
20886,34266,34752,34337,34023,33725,33184,33282,237569
20895,19437,19494,19284,19005,18711,18887,19054,133872
20896,981,919,1005,936,973,854,906,6574
20899,133,127,131,115,130,131,142,909
20901,36319,36280,36308,35837,35135,34871,34832,249582
20902,52461,51960,50980,49074,49458,48325,48841,351099
20903,25114,25835,25521,25119,25445,24778,23625,175437
20904,56874,55623,56395,55688,55956,54657,54612,389805
20905,18071,18308,17867,19071,17489,18138,18044,126988
20906,69112,69820,68733,67387,64936,63580,64696,468264
20910,41305,40707,39689,39252,37510,37404,37445,273312
20912,26221,26098,24993,24264,24857,24804,24807,176044
21001,24470,23520,22445,21813,21213,20769,21487,155717
21005,2464,2351,2497,2198,1889,1967,2112,15478
21009,29875,29796,29587,29509,29322,28770,29766,206625
21010,216,184,93,125,294,367,104,1383
21012,20713,20860,21298,20781,20784,20773,21317,146526
21013,5089,5121,5008,5150,5093,4829,4653,34943
21014,36060,36124,35085,35192,34468,34659,36047,247635
21015,28412,28146,28053,28447,28286,26997,27763,196104
21017,6730,7180,7527,7575,7335,7732,7062,51141
21028,3043,3573,3649,3638,3565,3588,3460,24516
21029,12019,11802,12642,12107,11236,10667,11333,81806
21030,24328,24736,25321,24585,23754,24238,24355,171317
21031,0,0,25,32,35,40,4,136
21032,9217,9365,8961,8743,8626,8349,8848,62109
21034,3435,3235,3393,3314,3283,3534,3387,23581
21035,8643,8352,8246,7899,7991,7283,7815,56229
21036,2594,2327,2469,2311,2187,2591,2114,16593
21037,21138,20994,20907,21050,20525,20600,20618,145832
21040,24590,24587,25027,25053,24282,24408,24420,172367
21042,39812,39508,40585,39243,39556,38447,38076,275227
21043,46701,44661,42784,42415,41498,40350,42246,300655
21044,43034,42123,42011,41906,40854,41314,41704,292946
21045,39426,40433,39832,40365,40367,39407,38288,278118
21046,16178,16143,16147,15940,15569,15832,15080,110889
21047,12340,12067,11662,11831,12014,11786,11873,83573
21048,10133,10703,10364,10714,10712,11174,10650,74450
21050,18533,18601,18897,18145,18954,18550,18202,129882
21051,361,296,272,252,227,305,279,1992
21052,316,308,279,278,227,220,303,1931
21053,3548,3284,3300,3227,3300,3133,3305,23097
21054,10449,9808,10182,9589,9441,8967,10127,68563
21056,158,187,249,222,141,182,267,1406
21057,3946,3881,3947,3834,3993,3967,4112,27680
21060,32154,32130,30921,29233,28848,27207,29223,209716
21061,54247,54878,55022,53491,52784,52919,53684,377025
21071,621,615,541,454,275,247,497,3250
21074,15216,14864,14602,14199,14220,14685,15084,102870
21075,30661,29874,28613,27181,26220,25719,26344,194612
21076,15909,15032,14148,13745,13205,12577,12952,97568
21077,352,282,166,155,117,44,224,1340
21078,17844,18481,18653,18417,18441,18215,17603,127654
21082,444,397,352,404,543,533,654,3327
21084,7619,7287,7358,7561,7548,7968,7652,52993
21085,16258,16209,16377,16257,16581,16957,16171,114810
21087,5559,5476,5584,5541,5391,5476,5451,38478
21090,10199,10288,9928,9986,10273,9986,9784,70444
21093,37810,37397,37384,36945,36282,36266,36465,258549
21102,10820,10810,10878,11261,11218,11219,11751,77957
21104,4614,4958,4944,4715,5018,5348,4601,34198
21105,18,19,16,18,25,39,65,200
21108,18855,18183,17659,17890,18074,17471,17964,126096
21111,3903,4065,4238,4326,4624,5095,4903,31154
21113,32712,32025,32004,31219,30570,30127,30469,219126
21114,25985,26209,26158,26636,26196,26011,25225,182420
21117,58759,59435,57724,56894,55580,54188,53778,396358
21120,7136,7447,7155,7052,6732,6952,6967,49441
21122,60583,61133,60439,60968,60168,59248,60576,423115
21128,14023,14211,14543,13902,13449,13459,12802,96389
21130,223,234,364,365,282,223,187,1878
21131,7460,7239,7288,7204,7073,7603,7253,51120
21132,2720,2698,2548,2040,2311,2603,2634,17554
21133,33475,32182,31099,31020,29896,28779,29998,216449
21136,33355,33328,33512,33190,34471,34895,33781,236532
21140,3208,3222,3386,3338,3479,3774,3457,23864
21144,34972,34008,32488,32328,31928,31017,31884,228625
21146,27490,27180,27434,26703,26521,26791,26705,188824
21152,5639,5905,5908,5891,6324,6495,5544,41706
21153,322,386,313,318,344,399,323,2405
21154,5879,6120,6678,7165,6843,6684,6464,45833
21155,2699,2712,2576,2425,2236,2491,2371,17510
21156,349,365,373,399,388,302,358,2534
21157,37358,36732,37094,37650,37990,37020,36920,260764
21158,21136,20843,20113,19873,19673,19573,20234,141445
21160,2762,2655,2349,2143,2210,1994,2408,16521
21161,5421,5308,5661,5732,6278,6283,5490,40173
21162,3935,3964,3878,3687,3351,3216,3655,25686
21163,7184,7032,7190,7280,7373,6989,7026,50074
21201,16479,16028,16188,15867,15547,15844,16972,112925
21202,22247,21814,21656,22700,22054,21652,22832,154955
21204,20562,20271,20269,20116,19930,19502,20253,140903
21205,15257,15112,15869,16100,17042,16549,16146,112075
21206,49777,50744,50231,50182,50147,51179,50846,353106
21207,48030,48585,48889,50107,49520,50049,48133,343313
21208,36283,34307,33510,32173,32488,31850,33917,234528
21209,28179,28230,27808,28831,28202,27283,26465,194998
21210,15083,15186,14873,14805,14971,14378,14292,103588
21211,16884,17418,17080,17051,16927,17143,17351,119854
21212,34054,34250,33000,33255,33408,33542,32322,233831
21213,30528,29532,29773,30307,30391,31155,32733,214419
21214,20499,20823,20817,20590,19589,20069,20564,142951
21215,61019,63434,63763,63448,63515,64937,60161,440277
21216,28890,27048,25599,25517,25946,26502,32071,191573
21217,38596,39511,40614,40443,39788,39234,37111,275297
21218,47928,48230,49259,49552,51290,50900,49796,346955
21219,9175,8990,8927,8978,9266,9452,9379,64167
21220,40868,40021,40399,39816,39313,38702,39199,278318
21221,41748,40912,40187,40407,41575,41114,42154,288097
21222,54725,54946,55043,54523,55163,54967,55786,385153
21223,25127,24904,24879,24049,25270,25819,26366,176414
21224,49686,49714,49345,49552,47784,45912,49134,341127
21225,32988,33388,33091,34315,35401,34825,33545,237553
21226,7779,7824,7766,7749,6795,7089,7561,52563
21227,34446,34908,34584,34386,34624,34676,33534,241158
21228,48961,49577,49527,48483,48191,46709,47577,339025
21229,47710,46986,46669,44470,45438,46680,45213,323166
21230,34293,33829,34441,33556,33364,32631,33568,235682
21231,16545,17047,17148,16801,16367,16415,15748,116071
21234,69447,69764,69316,69893,68256,67712,69752,484140
21236,38364,37843,37640,38166,37599,38117,38474,266203
21237,30987,30617,30342,29832,29728,29470,30059,211035
21239,31933,31849,31455,30147,29726,29183,28793,213086
21240,0,0,0,0,0,0,0,0
21244,37000,36565,36697,37742,36875,35633,34611,255123
21250,2676,2782,3026,3234,3351,3392,3205,21666
21251,899,867,820,769,801,834,934,5924
21252,2640,2766,2683,2643,2675,2743,2872,19022
21286,20745,20449,20051,19831,19506,19486,19206,139274
21401,37068,37407,37482,36938,37112,36661,36012,258680
21402,6451,6103,5878,6212,6121,6064,5217,42046
21403,30566,30521,30453,30352,30044,29312,30269,211517
21405,292,528,576,525,435,420,544,3320
21409,20436,20288,20153,20355,19563,19081,20064,139940
21502,42876,43614,43546,43422,43549,43694,44400,305101
21520,2144,2241,2081,2044,1924,2128,2074,14636
21521,1200,1301,1256,1307,1498,1304,1265,9131
21522,211,103,131,105,101,232,141,1024
21523,195,235,236,265,299,382,286,1898
21524,597,536,495,554,731,653,626,4192
21529,518,481,546,485,414,420,631,3495
21530,1517,1808,1685,1586,1597,1607,1591,11391
21531,2188,2311,2280,2134,2239,2349,2227,15728
21532,15499,15749,15586,16088,15883,15556,15620,109981
21536,4209,3967,4443,4499,4370,4035,4121,29644
21538,442,532,565,724,718,747,716,4444
21539,2669,2418,2784,2684,2738,2977,2819,19089
21540,95,97,91,91,109,98,65,646
21541,1192,1240,1051,1258,1222,1267,1546,8776
21542,686,673,642,492,484,520,483,3980
21543,102,120,76,78,113,109,140,738
21545,2003,2037,2011,1995,1897,2013,1940,13896
21550,14452,14384,14493,14345,14423,14123,14194,100414
21555,1951,1564,1861,1945,1590,1801,1936,12648
21557,1937,1795,2016,2162,2168,2327,1895,14300
21561,2506,2576,2557,2532,2731,2655,2627,18184
21562,2990,3141,2992,3084,3247,3229,3141,21824
21601,23986,23920,24227,23685,23633,23348,23597,166396
21607,691,782,644,611,652,692,583,4655
21610,380,326,337,398,460,457,378,2736
21612,433,400,349,305,306,325,492,2610
21613,17859,17604,17409,17603,17618,17495,17330,122918
21617,10650,10274,10141,9827,9616,9748,9907,70163
21619,5986,6036,5756,5606,5949,6209,5848,41390
21620,12679,12860,12406,12364,12415,12204,12853,87781
21622,637,635,812,708,667,686,558,4703
21623,2068,2212,2271,2080,2021,1847,2111,14610
21624,169,183,120,130,122,136,143,1003
21625,2694,2896,2640,2720,2562,2389,2719,18620
21626,165,175,122,132,102,98,120,914
21627,24,21,74,24,15,44,18,220
21628,643,684,592,481,324,283,556,3563
21629,9515,9544,9625,9321,9575,9413,9555,66548
21631,2492,2451,2638,2500,2681,2526,2731,18019
21632,5949,6001,5838,5588,5861,5896,6353,41486
21634,144,337,352,408,410,331,305,2287
21635,2361,2389,2251,2208,2204,1963,2098,15474
21636,1104,1106,1244,1309,1460,1580,1186,8989
21638,5128,4920,4959,4938,4881,4881,4934,34641
21639,4379,4482,4424,4845,4647,4546,4408,31731
21640,1359,1434,1284,1224,1367,1428,1632,9728
21641,96,84,63,43,53,41,117,497
21643,5455,5147,5128,5276,5298,5621,5979,37904
21644,191,177,163,222,90,116,111,1070
21645,1058,971,1028,1055,1292,1440,1039,7883
21647,175,212,212,243,341,421,289,1893
21648,267,308,330,358,308,312,255,2138
21649,1976,1847,1985,1892,1906,1951,1858,13415
21650,155,70,88,69,266,374,238,1260
21651,2823,3010,3363,3248,3193,3005,2898,21540
21652,140,190,181,144,117,93,183,1048
21653,61,66,69,50,106,73,114,539
21654,1015,1046,1025,967,1003,1122,1236,7414
21655,5333,5170,5148,5132,4945,5030,5009,35767
21657,1021,982,939,982,908,785,777,6394
21658,3768,3589,3891,3863,4009,3923,3862,26905
21659,1339,1492,1525,1747,1724,1742,1551,11120
21660,3948,4054,4198,4449,4108,4045,4063,28865
21661,2556,2581,2723,2739,2708,2547,2653,18507
21662,582,649,793,901,808,837,555,5125
21663,3119,2909,3070,3389,3375,3506,3308,22676
21664,681,759,855,856,763,652,539,5105
21665,368,335,346,240,329,249,287,2154
21666,11698,11900,12028,12762,12498,12431,12309,85626
21667,266,240,239,216,194,227,310,1692
21668,2025,1898,1881,1888,1713,1568,1904,12877
21669,216,219,169,202,137,170,229,1342
21671,855,872,879,967,757,780,756,5866
21672,144,120,164,215,216,190,241,1290
21673,3142,3208,3164,3252,3240,3306,3136,22448
21675,254,217,72,76,56,49,105,829
21676,473,486,419,421,425,405,398,3027
21677,535,575,624,536,494,455,440,3659
21678,2128,2310,2495,2573,2382,2627,2301,16816
21679,456,427,400,418,593,547,483,3324
21701,36588,35968,36530,36417,36648,36273,35293,253717
21702,39781,39608,38203,37601,37423,38131,38847,269594
21703,34666,33723,32894,33226,32376,32445,32854,232184
21704,15764,15455,14820,14222,13407,12778,13321,99767
21705,13,12,4,3,2,2,8,44
21710,4784,4986,4995,4907,4791,4991,4515,33969
21711,972,788,837,892,1029,936,1029,6483
21713,9970,9385,9164,9102,9165,9663,9502,65951
21714,201,65,52,45,11,0,99,473
21716,5090,5071,5037,4976,4881,4631,4885,34571
21717,36,34,34,0,0,0,54,158
21718,147,150,153,166,148,177,151,1092
21719,1255,1343,1412,1332,1357,1324,1548,9571
21722,5976,5511,5530,5499,5346,5527,5545,38934
21723,640,690,631,628,745,821,803,4958
21727,6756,6483,6561,6323,5977,5808,5850,43758
21733,892,838,863,1125,1036,1223,1163,7140
21734,688,751,805,974,913,1058,771,5960
21737,2010,1995,1815,1402,1066,940,1458,10686
21738,3461,3322,3450,3415,3266,3428,3268,23610
21740,61849,62217,61584,60616,60838,60369,61859,429332
21742,32874,32854,32549,32609,32585,32189,31444,227104
21746,2656,2722,3074,2835,2584,2312,1883,18066
21750,3797,3771,4023,3999,3919,3923,3766,27198
21754,6025,6228,6148,6015,5900,5870,6323,42509
21755,5672,5848,6040,5628,5549,5537,5591,39865
21756,3828,3837,3706,3374,3333,3360,3612,25050
21757,3296,3054,2961,2715,2829,2871,3036,20762
21758,4705,4909,4759,4909,5005,5426,4921,34634
21762,301,234,180,170,88,74,249,1296
21766,558,439,497,529,679,690,700,4092
21767,1286,1219,1148,963,1112,1229,991,7948
21769,11476,11208,11190,11000,11025,10461,11236,77596
21770,5187,5307,5457,5645,5923,5932,5164,38615
21771,29220,29778,29558,28700,29101,28896,29563,204816
21773,5478,5468,5422,5466,5768,5752,5460,38814
21774,12909,12562,12425,12242,11625,11272,11662,84697
21776,5148,4945,5251,5165,5243,5286,5735,36773
21777,1616,1591,1700,1538,1432,1466,1470,10813
21778,1220,1077,1141,1288,1345,1333,1094,8498
21779,1096,764,853,985,1019,935,983,6635
21780,1552,1559,1623,1745,2027,1906,1625,12037
21781,194,107,93,74,54,30,136,688
21782,4098,4371,4367,4621,4811,4437,4097,30802
21783,8877,8968,9031,9222,9073,8810,9130,63111
21784,39115,39188,39696,39259,39401,38965,37941,273565
21787,10319,10889,11531,11073,11194,11238,10693,76937
21788,11827,11909,11794,11811,11452,11108,11622,81523
21790,53,53,45,41,25,20,100,337
21791,5532,5738,5643,5660,5678,5533,5281,39065
21793,10250,10337,10149,10624,10194,9956,9775,71285
21794,2748,2680,2421,2585,2251,2099,2434,17218
21795,9066,9291,9225,9507,8943,8530,9233,63795
21797,8551,8713,8160,8466,8124,7989,8839,58842
21798,2106,2348,2647,2625,2601,2315,2345,16987
21801,29494,31106,31052,30997,30990,30680,29961,214280
21802,100,97,66,47,35,27,89,461
21804,40100,38772,37988,38081,36461,36816,38491,266709
21810,477,348,334,247,439,413,487,2745
21811,22026,21530,20994,20754,20834,21286,22550,149974
21813,2924,2687,2614,2897,3104,2714,2852,19792
21814,471,609,566,449,489,531,380,3495
21817,5348,5272,5049,4889,4945,5138,5236,35877
21821,887,788,896,815,842,928,991,6147
21822,2084,2166,2039,1801,1676,1907,1930,13603
21824,125,126,122,124,134,155,198,984
21826,5391,5217,5250,4941,4727,4689,4837,35052
21829,584,904,839,880,924,943,527,5601
21830,3880,3552,3576,3619,3608,3387,4026,25648
21835,517,825,765,631,698,653,507,4596
21837,2991,2964,2784,2560,2697,2651,2614,19261
21838,1350,1419,1659,1649,1710,1710,1736,11233
21840,628,587,571,466,458,189,375,3274
21841,1099,978,1073,1047,1038,1031,860,7126
21842,11036,11326,11319,11442,11360,11408,11089,78980
21849,3501,3283,3769,3870,4121,4154,3238,25936
21850,2669,2729,2631,2610,2640,2785,2790,18854
21851,7603,7579,7657,7699,7582,7222,7315,52657
21853,11394,10845,10847,11106,10775,10925,11126,77018
21856,824,762,892,870,1185,1037,1035,6605
21861,969,1023,1003,962,1118,948,757,6780
21862,243,443,506,441,280,200,106,2219
21863,4794,4888,5270,5213,5379,5306,5029,35879
21864,867,826,899,901,624,725,611,5453
21865,588,668,404,690,608,464,470,3892
21866,70,54,54,45,38,51,78,390
21867,33,44,41,44,48,15,114,339
21869,972,900,785,606,740,758,1006,5767
21871,1914,2078,3140,3188,3163,3093,2124,18700
21872,544,523,605,470,611,606,718,4077
21874,2224,2137,2447,2442,2168,2250,2210,15878
21875,6290,6375,6483,6351,6802,6542,6467,45310
21890,3345,3976,2692,2902,3127,2696,3240,21978
21901,18326,18941,18253,16786,16428,15584,15875,120193
21902,243,244,214,181,150,115,471,1618
21903,6003,5867,6061,6106,5788,5660,5687,41172
21904,7192,7992,7775,7623,7734,7465,7252,53033
21911,10678,11216,11129,11312,11109,11790,11004,78238
21912,1078,1203,1406,1062,1100,1428,1240,8517
21913,1036,883,675,657,602,464,663,4980
21914,682,491,497,551,594,599,765,4179
21915,2860,2677,2598,2824,2820,2764,3030,19573
21916,42,37,36,34,29,28,37,243
21917,2618,2820,2985,2649,2455,2662,2520,18709
21918,3920,3735,4021,4157,4253,4633,4284,29003
21919,2997,3435,3479,3827,3669,3693,3467,24567
21920,353,214,231,167,124,113,257,1459
21921,43940,42066,42316,43383,44090,43617,44471,303883
21930,207,139,127,116,164,101,94,948
22003,60039,60058,59872,58390,55524,55520,55990,405393
22015,44918,45029,45126,44657,43442,43116,43102,309390
22025,16774,16897,17219,16955,17849,17879,17379,120952
22026,15584,15896,15694,15221,14704,14677,14258,106034
22027,2310,2081,2338,2567,2523,2514,2362,16695
22030,58759,57649,56961,55490,54047,53251,55066,391223
22031,31890,31445,31681,31329,31342,30021,29795,217503
22032,30392,29956,29698,29574,29389,29846,29377,208232
22033,39524,39359,38415,37605,36786,36328,37691,265708
22035,0,0,0,0,0,0,0,0
22039,17839,18126,18791,18676,19356,19301,18364,130453
22041,28872,29110,28088,27018,27234,26116,27989,194427
22042,34124,34215,32689,32356,31961,30768,33537,229650
22043,25792,25923,26348,25910,24656,23627,24302,176558
22044,13330,14230,13783,13054,13343,13190,14092,95022
22046,17941,17062,16691,16588,16231,15457,16235,116205
22060,10099,10260,10004,9757,9420,9188,8878,67606
22066,18419,18366,18817,19475,19295,19579,18099,132050
22079,34496,34218,34031,32986,32225,32380,32059,232395
22101,30238,29867,30221,30370,30381,29142,29887,210106
22102,25149,23806,23329,22146,21920,20157,21985,158492
22124,18607,18352,18530,18249,17915,17599,17558,126810
22125,725,729,669,648,659,516,711,4657
22134,8297,8644,8445,9072,8948,8251,6862,58519
22150,26853,26912,27165,27551,28052,27594,27105,191232
22151,17627,17484,17649,17734,17678,17834,17456,123462
22152,29331,28900,29029,29094,28704,28102,28550,201710
22153,31141,30809,31249,31906,31979,32026,31285,220395
22172,9717,9338,9334,9111,8330,8319,8699,62848
22180,24557,25035,24376,23941,23717,23914,23491,169031
22181,15586,15702,15158,15008,14359,14278,14879,104970
22182,26196,26532,26150,26044,26208,25004,24863,180997
22185,0,0,0,0,0,0,0,0
22191,67276,66463,64590,61863,59665,56615,57598,434070
22192,57513,56024,55402,54216,52691,51060,53394,380300
22193,82290,80461,78440,74742,73467,71016,73047,533463
22201,36166,35137,34427,34069,32980,32403,33476,238658
22202,23379,22337,21679,21004,20265,19290,22543,150497
22203,22932,23462,23268,22929,21593,21070,21850,157104
22204,54046,53091,52512,49521,49348,48247,47233,353998
22205,19195,19455,18875,17882,17413,17081,17087,126988
22206,20677,21142,20327,20460,19474,18774,19051,139905
22207,33191,33153,33553,33057,31884,31253,30920,227011
22209,12392,12118,11551,12036,11977,11122,12314,83510
22211,1021,1020,918,895,922,841,648,6265
22213,3575,3551,3470,3374,3478,3206,2936,23590
22214,0,0,109,120,115,135,0,479
22301,12156,12102,11938,11723,11524,11425,11162,82030
22302,18818,18486,18218,17495,17567,16939,16485,124008
22303,14499,13746,13855,13144,12395,12141,12601,92381
22304,47576,47488,46993,46148,45359,43956,44300,321820
22305,17965,16808,16201,15416,14424,13379,15440,109633
22306,34271,34489,33241,31996,31225,31108,32326,228656
22307,10126,10220,10434,10272,10489,10210,9581,71332
22308,13453,13491,13257,13188,13178,13040,12737,92344
22309,34882,35105,33728,32207,31685,31249,33220,232076
22310,30889,30333,28887,28712,28908,28835,29609,206173
22311,18035,18183,17631,18648,17406,16770,17560,124233
22312,33915,32763,31364,29836,29133,28143,30614,215768
22314,31442,31117,30353,29600,28946,28944,29653,210055
22315,28173,28494,27794,27231,26044,26171,26202,190109
22401,27853,27395,26632,25931,24932,24015,24286,181044
22405,30230,29977,30149,29763,29164,29081,29152,207516
22406,24405,23556,22411,21838,20869,19945,20757,153781
22407,57950,57023,57339,56381,56718,55968,54962,396341
22408,28396,27953,27233,27405,26224,26982,26851,191044
22427,4465,4564,4085,3702,3674,3397,3286,27173
22432,464,390,427,424,502,295,394,2896
22433,427,308,261,215,180,147,232,1770
22435,2753,2374,2491,2578,2053,2102,2439,16790
22436,848,1020,880,881,729,807,746,5911
22437,1208,1079,1435,964,789,1066,725,7266
22438,169,246,222,262,362,215,463,1939
22443,8272,7924,8086,8134,8552,8341,8083,57392
22448,554,573,674,826,957,1001,599,5184
22454,1771,1693,1622,1887,1932,1878,1796,12579
22460,1443,1650,1320,1568,1754,1761,1876,11372
22469,1249,1507,1516,1639,1736,1712,1921,11280
22473,4895,5100,5323,5202,5319,5450,5099,36388
22476,697,649,681,633,471,429,369,3929
22480,760,848,892,945,869,872,714,5900
22482,3048,2956,2633,3141,2958,3251,2993,20980
22485,24726,24360,23903,23325,22782,22320,23004,164420
22488,1306,1216,1684,1486,1123,1025,1398,9238
22503,4194,4439,4746,4372,4398,4110,4334,30593
22504,215,245,203,162,242,214,263,1544
22508,13723,13716,13921,13767,13714,12862,12696,94399
22509,26,17,0,0,0,0,31,74
22511,991,1272,1462,1271,1244,1362,1240,8842
22514,2653,2532,2430,2451,2436,2423,2603,17528
22520,6471,6213,5586,5541,5334,5609,5402,40156
22529,155,382,421,434,384,406,335,2517
22530,51,23,75,103,161,181,126,720
22534,3559,3529,3174,2961,2872,2391,2796,21282
22535,568,468,410,362,327,398,580,3113
22538,252,217,238,255,459,247,307,1975
22539,2218,2380,2267,2177,2341,2023,2063,15469
22542,2268,2182,2094,1335,1332,1494,1950,12655
22546,15731,15832,15997,15952,15986,16300,15850,111648
22548,412,59,59,57,25,25,73,710
22551,19652,20064,18816,17929,17883,18094,19242,131680
22553,14656,14322,13507,13821,13617,12604,13935,96462
22554,54986,54078,53283,52564,51396,50314,51463,368084
22556,27931,27359,26731,25485,25859,26018,25675,185058
22560,5919,6008,5995,6120,6472,6382,6704,43600
22567,2806,2482,2683,3218,3518,3448,3163,21318
22572,6772,7324,7517,7410,7688,7745,7470,51926
22576,1827,1616,1408,1674,1761,1734,1785,11805
22578,2362,2256,2159,2096,2125,2393,2510,15901
22579,60,50,62,57,135,154,155,673
22580,4998,4770,5239,5249,4981,4798,5160,35195
22601,28816,28751,28473,28401,27843,27261,27813,197358
22602,29007,28920,29085,28282,29208,29001,28443,201946
22603,14726,14180,14228,13678,13760,13903,13910,98385
22610,1797,1653,1617,1635,1589,1804,1842,11937
22611,8654,8860,8640,8492,8378,8357,8757,60138
22620,2630,2346,2377,2350,2350,2280,2348,16681
22623,621,578,511,545,693,723,670,4341
22624,2476,2449,2501,2766,2635,2452,2565,17844
22625,3912,4155,4073,4414,4115,4145,3641,28455
22627,643,607,453,469,779,853,637,4441
22630,32167,31671,31023,31009,30781,30728,30292,217671
22637,2014,1977,1727,1619,1381,1234,1970,11922
22639,467,395,349,284,272,301,560,2628
22640,622,671,794,845,837,777,532,5078
22641,366,244,695,644,663,782,361,3755
22642,4390,4446,4363,3912,3880,3513,4414,28918
22643,91,77,66,84,52,99,197,666
22644,2233,2420,2434,2484,2449,2417,2177,16614
22645,4130,3899,3828,3638,3776,3698,3880,26849
22646,173,191,212,246,214,205,205,1446
22650,735,985,1348,1256,1463,1404,978,8169
22652,1319,1175,1122,1263,1243,1426,1399,8947
22654,1400,1196,1055,1043,608,468,640,6410
22655,20115,19951,19767,19449,19481,18970,19328,137061
22656,3128,3029,2799,2743,2144,2222,2381,18446
22657,9846,10394,10599,10508,11024,10990,10956,74317
22660,2371,1984,1893,1984,2034,1949,1689,13904
22663,1377,1485,1784,1727,1521,1648,1536,11078
22664,8856,8969,9072,9095,8438,8380,8753,61563
22701,33717,33414,32891,32200,31755,31280,31444,226701
22709,881,851,1006,823,938,946,874,6319
22711,18,14,17,10,0,71,92,222
22712,8789,8171,8310,8053,7731,7393,8415,56862
22713,1588,1534,1466,1609,1329,1342,1406,10274
22714,926,1102,1028,1237,1291,1196,1129,7909
22715,1394,1779,1520,1723,1634,1484,1082,10616
22716,1024,1143,1125,1119,873,732,853,6869
22718,729,814,761,497,422,341,534,4098
22719,302,381,476,472,458,668,395,3152
22720,1074,1070,1147,1083,1108,1056,1059,7597
22722,359,317,305,345,221,132,273,1952
22723,54,38,0,143,122,138,128,623
22724,2252,2297,2088,1708,1525,1542,2282,13694
22726,600,538,475,607,637,641,776,4274
22727,4795,4748,4818,4683,4815,4827,5547,34233
22728,3074,3168,3248,3193,3425,3624,3310,23042
22729,1055,1221,1284,1304,1307,1324,1338,8833
22730,193,37,8,43,38,38,115,472
22731,88,45,74,78,131,78,139,633
22732,318,371,346,348,183,192,191,1949
22733,1977,1873,1907,1496,1641,1258,1469,11621
22734,3405,3705,3360,3717,3584,3014,3187,23972
22735,3123,2704,2382,1690,2163,2241,2277,16580
22736,834,943,987,872,868,809,732,6045
22737,2897,2370,2696,3313,2880,2820,2936,19912
22738,1187,1222,1160,1360,1239,1379,1149,8696
22740,1320,1420,1450,1260,1147,1038,1313,8948
22741,151,81,111,274,331,242,182,1372
22742,2074,2112,2121,2185,2080,1998,1926,14496
22743,176,270,295,196,203,244,204,1588
22747,991,1039,1093,1037,1102,1173,1132,7567
22749,299,203,228,312,398,420,349,2209
22801,39467,38455,37794,38142,37495,37250,37989,266592
22802,29223,29089,29097,28401,28238,27307,26293,197648
22807,3223,3197,2574,2449,2351,2182,3311,19287
22810,791,600,600,690,662,471,863,4677
22811,550,442,498,426,538,640,500,3594
22812,8828,8770,9159,9048,8985,8995,8927,62712
22815,8583,8221,8291,8251,8149,7958,8355,57808
22820,211,195,185,161,132,139,214,1237
22821,5489,5937,5910,5894,5876,5786,5753,40645
22824,6387,6353,6110,5865,5762,6067,6018,42562
22827,10056,9833,9805,9403,9619,10193,10388,69297
22830,1751,1859,1836,1944,1889,1696,1773,12748
22831,1039,928,986,946,892,886,813,6490
22832,1363,1391,1228,1293,1336,1222,1091,8924
22834,934,1056,1188,1092,1258,1398,1250,8176
22835,11560,11562,11486,11374,11467,11429,11634,80512
22840,4562,4852,5117,5191,4832,4506,4354,33414
22841,2852,2978,2902,2867,2773,2830,2791,19993
22842,5567,5496,5247,5330,5485,4869,5063,37057
22843,2194,2119,2200,2394,2520,2771,2458,16656
22844,4565,4570,4498,4358,4370,4438,4528,31327
22845,10,0,0,0,0,0,33,43
22846,2280,2191,2078,1881,1710,1899,1855,13894
22847,852,1004,1013,978,1030,1206,1066,7149
22849,4723,4448,4379,4730,4700,4229,5044,32253
22850,1068,1015,1114,839,937,781,899,6653
22851,6129,6260,6045,6157,6015,6621,5956,43183
22853,4444,4493,4443,4572,4554,4386,4367,31259
22901,33109,32854,32396,32149,32698,32489,32532,228227
22902,23495,22827,22061,21276,20609,20178,21223,151669
22903,39392,38869,39137,39607,39363,37931,38229,272528
22904,5486,5643,5411,5019,4387,4346,4633,34925
22911,17993,18039,18016,17490,16982,16421,15971,120912
22920,3750,3800,3995,4201,4271,4357,4186,28560
22922,1944,1851,1949,2298,2358,2036,1993,14429
22923,4932,4845,4377,4094,4062,4699,5035,32044
22931,323,402,310,288,309,338,382,2352
22932,8198,7942,7801,7516,7666,7600,7488,54211
22935,873,728,730,633,629,842,926,5361
22936,4937,4805,4754,4656,4560,4890,4853,33455
22937,1732,1754,1659,1857,2061,1999,1486,12548
22938,1568,1713,1444,1609,1369,1276,1444,10423
22939,5754,5527,5202,5296,4770,4850,5398,36797
22940,1397,1143,1057,1057,1060,1010,1119,7843
22942,8392,8100,8170,8368,7747,7984,8113,56874
22943,296,210,244,298,259,269,444,2020
22946,255,236,315,279,183,318,244,1830
22947,3905,4285,4286,4005,4129,4002,4198,28810
22948,156,128,136,182,165,275,305,1347
22949,1170,1128,1409,1165,987,1171,1300,8330
22952,2471,2510,2468,2088,2044,1581,2029,15191
22958,2275,1912,1829,1473,1633,1626,1637,12385
22959,1410,1207,1261,1311,1439,1551,1578,9757
22960,10873,10650,10932,11001,11113,10845,10722,76136
22963,14925,14591,14661,14936,15656,15926,15401,106096
22964,165,210,224,111,140,146,261,1257
22967,1672,1762,1721,1821,1590,1846,1956,12368
22968,10076,10099,10833,10353,10117,9764,9815,71057
22969,893,1166,1248,1234,1502,1456,1437,8936
22971,1674,1697,1529,1652,1744,1827,1735,11858
22972,293,242,279,250,337,528,439,2368
22973,6415,6544,6263,6792,6636,6563,6191,45404
22974,6419,6804,6312,5881,5512,5393,5385,41706
22976,621,562,517,197,173,343,339,2752
22980,31698,31502,31260,31706,31903,31168,31451,220688
22989,0,0,0,123,117,132,112,484
23002,10046,9946,10660,11071,11263,11145,10439,74570
23004,691,820,1015,866,652,659,851,5554
23005,16021,15486,15077,14798,15069,14973,15227,106651
23009,6431,6696,6333,6337,6344,5957,6279,44377
23011,1603,1605,1776,1751,1285,1405,1429,10854
23015,4193,4499,4487,4388,3830,3445,4249,29091
23021,201,280,356,347,485,481,345,2495
23022,1325,1500,1392,1418,663,718,930,7946
23023,583,362,302,234,255,203,323,2262
23024,8815,8911,8787,8090,7706,7761,8120,58190
23025,212,164,232,247,183,192,233,1463
23027,1322,1197,1227,1179,1234,978,1413,8550
23030,4838,4933,4937,4907,5063,5088,5128,34894
23032,289,214,221,221,339,297,283,1864
23035,1232,1491,1339,1388,1277,1310,1473,9510
23038,1550,1449,1651,1437,1258,1025,1775,10145
23039,1147,1189,1077,1074,1092,962,1056,7597
23040,4307,4471,4125,4334,4381,4537,4661,30816
23043,1709,1518,1420,1386,1499,1489,1692,10713
23045,80,72,22,11,42,44,96,367
23047,2163,1705,1558,1698,1833,1846,1952,12755
23050,760,853,806,702,553,576,598,4848
23055,1148,1011,1167,936,1011,1004,915,7192
23056,457,256,414,417,340,369,458,2711
23059,34219,34695,34478,33940,33363,31258,31919,233872
23060,36426,34017,34816,33848,33569,33885,33417,239978
23061,21284,21279,20568,19903,20129,19861,21208,144232
23062,2293,2076,2133,2271,2528,2760,2340,16401
23063,4726,4745,5105,5625,5675,5551,5278,36705
23064,295,207,161,55,66,114,131,1029
23065,2086,2309,2003,2068,1906,1749,1909,14030
23066,402,488,534,565,599,409,471,3468
23068,292,389,302,337,390,308,257,2275
23069,3065,3229,3406,3625,3432,3447,3197,23401
23070,443,612,826,767,895,705,431,4679
23071,1580,1544,1500,1588,1428,1285,1563,10488
23072,11599,11690,12187,12486,12561,12732,11541,84796
23075,10100,10575,10156,10541,10495,10548,9819,72234
23076,926,802,791,821,691,572,606,5209
23079,643,695,675,599,346,245,437,3640
23083,2215,2301,1637,1176,1079,1049,1732,11189
23084,1806,1845,1584,1508,1525,1530,1799,11597
23085,457,415,438,421,343,400,364,2838
23086,3371,3082,2863,2705,2810,2637,3247,20715
23089,5383,5562,5323,5015,5003,4917,4914,36117
23091,162,345,298,286,212,182,309,1794
23092,817,746,663,563,605,387,584,4365
23093,12771,12814,12465,12997,12887,13117,12694,89745
23102,3162,3026,3491,3342,3184,3436,2659,22300
23103,5041,5039,4724,4381,4301,4155,4634,32275
23106,953,1020,1303,1270,1144,1563,976,8229
23108,277,270,296,223,213,176,161,1616
23109,2315,2458,2595,2358,2357,2317,1821,16221
23110,709,617,670,846,554,575,794,4765
23111,37105,37033,36951,36754,36509,36962,36490,257804
23112,52029,50756,50815,50595,48386,48066,46982,347629
23113,24720,24505,24147,23811,23672,23833,23848,168536
23114,18558,18505,18259,18676,18559,17634,17449,127640
23115,250,233,228,243,196,163,146,1459
23116,28405,27470,27774,28115,27917,27706,27228,194615
23117,8829,8633,9578,9520,10056,9812,9141,65569
23119,455,306,243,215,155,269,295,1938
23120,8369,7575,6698,6193,5753,5554,5971,46113
23123,2069,1776,1598,1618,1360,1426,1860,11707
23124,3857,3260,3188,3436,3234,3028,3185,23188
23125,161,59,46,79,93,124,223,785
23126,197,170,159,234,420,229,534,1943
23128,1048,1183,1173,1310,1190,1180,1045,8129
23129,465,428,334,320,278,317,374,2516
23130,99,130,215,351,303,394,268,1760
23138,365,305,262,385,545,473,953,3288
23139,24318,24396,24157,23815,23170,22578,24425,166859
23140,6043,6312,5857,5694,5573,5218,5175,39872
23141,6380,5872,6001,5816,6223,6220,6471,42983
23146,3095,3156,3070,3107,3040,2968,3093,21529
23148,2094,2217,2202,2051,2024,2224,1827,14639
23149,3168,3096,2965,3135,2630,2684,3190,20868
23150,11500,11372,11811,12117,11928,12102,12045,82875
23153,989,987,1155,1073,1136,1197,1334,7871
23156,1601,1597,1622,1446,1944,1846,1555,11611
23160,2661,2680,2663,3132,3818,4274,2708,21936
23161,174,140,150,62,64,93,173,856
23163,98,116,234,280,345,406,220,1699
23168,6757,6385,6687,6947,6480,6072,6115,45443
23169,1113,1363,1416,1522,1572,1920,1325,10231
23173,2091,2229,2253,2268,2342,2521,2820,16524
23175,1629,1782,1523,1540,1455,1655,1907,11491
23176,508,476,651,599,639,772,656,4301
23177,558,568,606,962,830,720,616,4860
23180,516,367,529,592,647,611,441,3703
23181,5520,5711,5457,5618,5389,5390,5426,38511
23185,48780,47766,47227,46458,45675,45450,46370,327726
23187,242,233,144,155,148,0,267,1189
23188,41415,40742,40557,39235,39005,37748,38733,277435
23192,6737,6906,6691,6382,6907,6807,7067,47497
23219,3922,3587,3431,3284,3295,3371,3781,24671
23220,34862,34303,34684,35002,34996,33490,35545,242882
23221,15348,15832,15570,14702,14199,13871,13680,103202
23222,25456,25790,25494,25820,25911,26403,24563,179437
23223,49532,48938,48021,48111,47951,48060,47677,338290
23224,37762,36702,36897,35885,35356,34644,33461,250707
23225,42187,40059,40084,39470,38296,38055,39169,277320
23226,15960,15809,15266,15078,14987,14629,15805,107534
23227,25946,26302,25287,25961,24844,24484,24440,177264
23228,35989,36191,35169,33844,33710,32544,34198,241645
23229,34818,34366,33570,32930,32637,32484,32283,233088
23230,5982,5928,5540,5360,5546,5534,5852,39742
23231,37452,36285,35254,35211,34384,34061,34685,247332
23233,30873,30131,29722,29081,28612,28222,28908,205549
23234,43439,44295,44202,42360,42265,42643,42989,302193
23235,30690,31170,30535,29522,30251,30391,30165,212724
23236,26745,26705,26998,26234,26509,25567,25822,184580
23237,21641,21518,21501,21807,21326,20609,21192,149594
23238,25961,26083,26077,25848,25251,25139,25134,179493
23250,0,0,0,0,0,0,0,0
23294,17866,18044,17869,17222,17163,17206,17558,122928
23301,1431,1223,1484,1566,1698,1616,1831,10849
23302,258,340,294,15,46,80,155,1188
23303,1046,1121,1135,890,775,613,741,6321
23304,38,161,152,143,141,162,71,868
23306,862,898,875,933,943,950,1088,6549
23307,480,582,493,582,782,845,769,4533
23308,1784,1846,1613,2128,2177,2369,2106,14023
23310,4441,4422,4385,4564,4760,4885,4736,32193
23313,74,96,80,117,146,165,78,756
23314,7609,7471,6751,6905,7043,7185,6991,49955
23315,1505,1643,1514,1466,1583,1463,1525,10699
23316,507,455,441,374,182,141,342,2442
23320,55222,54310,53666,53339,51650,51514,51797,371498
23321,34524,34883,35122,35453,34777,33890,33653,242302
23322,63764,62968,62187,61868,61369,60185,60473,432814
23323,38315,37183,35956,34915,34489,34392,35906,251156
23324,23681,23558,23395,22441,23502,23617,22851,163045
23325,17800,17741,17899,17676,17492,17279,17592,123479
23336,2919,2930,2935,2968,3017,3093,2941,20803
23337,645,543,424,358,289,343,377,2979
23347,436,574,790,742,619,620,671,4452
23350,3488,3255,3215,3492,3547,3434,3403,23834
23354,192,221,315,276,196,219,207,1626
23356,1236,1221,1087,969,806,620,1246,7185
23357,867,763,577,771,765,1014,776,5533
23358,61,35,17,17,28,23,152,333
23359,1082,1003,1210,989,1123,1139,776,7322
23389,66,131,123,136,85,76,137,754
23395,445,431,315,232,267,354,645,2689
23398,48,76,51,52,18,16,153,414
23401,320,277,298,143,117,205,212,1572
23405,982,1128,1001,955,1145,1169,973,7353
23407,518,657,640,419,436,500,411,3581
23408,42,22,32,38,36,46,77,293
23409,121,105,62,5,20,19,84,416
23410,2227,2792,2555,2667,2239,2348,2015,16843
23413,1302,1124,1242,937,809,813,840,7067
23414,56,58,135,160,241,323,100,1073
23415,1811,1761,1857,1687,1677,2264,1893,12950
23416,406,436,429,476,456,338,356,2897
23417,3214,3137,3379,3784,4411,3873,4047,25845
23418,716,838,775,819,890,1062,863,5963
23420,3459,2746,2980,2882,2917,2572,2376,19932
23421,4429,4600,4847,5078,4614,4869,4255,32692
23422,147,203,214,206,215,243,278,1506
23423,386,365,275,285,260,196,344,2111
23426,161,200,237,231,187,147,225,1388
23427,213,198,216,218,254,296,243,1638
23430,17866,17388,17522,17202,16920,17012,17281,121191
23432,1215,1138,1393,1360,1269,1451,1538,9364
23433,1170,1100,1012,856,868,925,1218,7149
23434,49375,49020,48645,47846,47448,47403,47670,337407
23435,28222,27895,27452,27088,26688,26132,27053,190530
23436,988,1094,1093,1146,1149,1176,942,7588
23437,4015,3849,3934,4552,4765,4482,4283,29880
23438,1997,2046,1891,1899,1983,1856,1818,13490
23440,501,491,485,483,520,541,727,3748
23441,211,177,111,81,187,38,171,976
23442,1069,1183,1182,1292,1405,1157,1059,8347
23451,43154,42761,42584,42355,42293,42244,41544,296935
23452,60415,60333,60072,60422,59180,58875,59321,418618
23453,36321,36533,35824,35707,35244,36321,35960,251910
23454,60390,61172,62064,62748,63520,62459,60283,432636
23455,50418,49598,49246,48765,47678,46999,47938,340642
23456,53258,53271,52760,51261,51483,50405,51748,364186
23457,4340,4323,4350,4548,4188,4362,4289,30400
23459,1141,1144,1111,1227,1052,1020,1091,7786
23460,1866,1789,1052,829,678,680,1201,8095
23461,461,461,254,168,152,164,287,1947
23462,62326,61786,62300,61287,60583,61083,61973,431338
23464,75610,75119,74006,72834,73477,72367,72359,515772
23480,302,297,275,273,264,294,328,2033
23486,126,229,209,210,168,140,140,1222
23487,6241,6396,6753,6493,6499,6369,6298,45049
23488,91,109,124,128,125,126,201,904
23502,21319,21282,21933,22103,23363,22652,20678,153330
23503,32270,32018,34829,35632,36357,37693,30856,239655
23504,22934,22517,23336,23272,22914,23264,23483,161720
23505,30915,32070,31478,30613,30925,29997,28503,214501
23507,7263,7346,8201,8153,7495,8232,25818,72508
23508,21824,21699,21707,20456,20170,19174,20263,145293
23509,13339,13005,12754,13297,12725,12968,12817,90905
23510,7744,7296,7356,7171,6987,6700,7031,50285
23511,14110,13850,8957,8725,8331,6858,2457,63288
23513,30040,30197,30871,31436,31343,31671,29595,215153
23517,4434,4693,4484,4398,4299,4258,4484,31050
23518,30108,29983,30139,30581,30487,31083,28095,210476
23523,8623,8710,8174,7776,7264,7393,7793,55733
23551,801,786,526,477,396,0,930,3916
23601,25538,26432,25331,24907,24140,24602,25127,176077
23602,39836,39471,40308,39925,40345,40293,39676,279854
23603,3787,3940,3754,3647,3901,3891,3899,26819
23604,6734,6539,6547,7210,7279,7165,5720,47194
23605,13023,12829,13206,13436,13687,13550,13854,93585
23606,30179,29843,29203,28648,27710,27544,29283,202410
23607,22341,22437,22825,23709,23988,24620,24519,164439
23608,43757,43383,43827,43612,43791,43296,42917,304583
23651,507,429,510,592,540,537,696,3811
23661,13082,13763,14038,13795,13709,13306,14113,95806
23662,12017,12027,12050,12095,12110,12097,12150,84546
23663,13841,13861,15132,15279,16844,16525,14495,105977
23664,9830,9550,9327,9170,8526,9524,10194,66121
23665,6128,5934,5611,5593,5262,5167,5120,38815
23666,52207,51728,50123,49434,49149,49387,49825,351853
23669,42261,42727,42617,43132,43230,43669,43148,300784
23690,3654,3416,3347,3694,3437,3143,3032,23723
23691,134,180,183,188,189,190,127,1191
23692,18893,19347,18611,18440,18546,18640,18846,131323
23693,23420,23454,23687,23732,23807,24346,23292,165738
23696,3695,3652,3744,3845,3733,3604,3669,25942
23701,22987,23577,23510,23549,23018,24040,25161,165842
23702,11472,11441,12251,11715,11356,10907,11424,80566
23703,27125,26915,26795,26988,27751,28153,25739,189466
23704,18064,18416,18208,18578,18353,17734,18716,128069
23707,15586,15090,14711,14694,14939,14428,14236,103684
23708,420,364,325,313,332,788,181,2723
23709,417,332,207,64,37,16,78,1151
23801,5091,4747,4700,5351,5346,5552,3393,34180
23803,39759,38846,39909,40187,40988,39311,40542,279542
23805,19530,20466,19717,19793,19228,19807,19490,138031
23806,1868,1904,1997,2061,2109,2152,2251,14342
23821,1647,1857,1817,1582,1413,1648,1597,11561
23824,6908,6984,7398,7730,7599,8186,7214,52019
23827,1447,1328,1238,1461,1500,1351,1443,9768
23828,187,395,405,416,452,515,395,2765
23829,2570,2652,2669,2416,2375,2599,2622,17903
23830,1483,1325,1398,1106,1149,1368,1491,9320
23831,36369,34935,34048,33130,32354,31409,33079,235324
23832,35195,34561,32647,32263,32830,33307,33739,234542
23833,3107,2846,2938,2501,2361,2249,2297,18299
23834,24696,24976,25307,25887,25573,25436,25612,177487
23836,12586,12830,11916,11222,11376,11235,11444,82609
23837,4806,4802,4471,4661,4373,4088,4298,31499
23838,15633,16003,16371,16186,15453,15948,15341,110935
23839,790,696,768,809,759,841,741,5404
23840,2418,2277,2267,1835,1734,1359,1858,13748
23841,3430,3862,3524,4190,3974,4005,3479,26464
23842,6707,6902,7683,7090,7219,7225,6906,49732
23843,601,584,489,514,544,756,654,4142
23844,581,595,727,747,812,823,788,5073
23845,407,295,248,218,422,455,356,2401
23846,849,745,555,548,529,595,933,4754
23847,15128,15798,15766,16090,16087,16719,16962,112550
23850,891,888,729,743,623,788,1051,5713
23851,13357,13104,13558,13625,13820,13712,13715,94891
23856,877,803,905,935,965,943,1033,6461
23857,455,759,654,757,546,482,525,4178
23860,30918,31269,31314,30917,30583,30486,31970,217457
23866,2091,2088,2172,2189,2172,2108,2237,15057
23867,2089,1814,2220,2651,2874,2971,2189,16808
23868,7283,7451,7386,7739,7347,7214,7367,51787
23872,2642,2252,2254,2263,2345,1962,2376,16094
23874,959,1015,970,914,1029,956,1004,6847
23875,11932,11309,10743,10714,10779,10067,10878,76422
23876,446,490,483,505,549,488,456,3417
23878,1295,1224,1332,1132,1121,1138,1118,8360
23879,696,655,664,608,1027,859,679,5188
23881,1788,1851,1946,1779,1975,2084,2176,13599
23882,1684,1681,1800,2071,2348,2412,2516,14512
23883,2658,2664,2880,3077,2987,3011,2551,19828
23884,70,83,88,89,64,59,93,546
23885,2494,2491,2517,2539,2531,2726,2807,18105
23887,378,362,418,303,410,423,574,2868
23888,1937,1978,1720,1941,2152,2235,2275,14238
23889,602,472,409,351,485,365,581,3265
23890,3138,3206,4169,4697,5074,4365,4249,28898
23891,4879,5068,3315,2183,1401,1698,2358,20902
23893,140,198,303,231,156,273,454,1755
23894,502,606,506,453,499,775,673,4014
23897,592,551,521,605,373,428,595,3665
23898,1748,1863,1853,2310,2132,2354,2223,14483
23899,280,281,291,336,357,347,351,2243
23901,17447,17382,16149,16490,16788,16610,16399,117265
23909,750,725,1476,2023,1627,1792,2027,10420
23915,1072,938,1006,788,818,755,1220,6597
23917,3097,3422,3689,3666,3859,3850,3684,25267
23919,2243,2257,2154,2551,2198,2655,2666,16724
23920,3895,4012,3801,3998,3871,3323,3489,26389
23921,1919,1961,1896,1577,1305,1152,1991,11801
23922,3944,3709,3201,2404,1998,1952,3785,20993
23923,2402,2481,2234,2227,2701,2491,2592,17128
23924,6384,6445,6934,7066,7335,7190,6232,47586
23927,4005,4101,3969,4077,3897,3991,4381,28421
23930,5392,5664,6022,6142,6598,6300,5690,41808
23934,458,501,684,812,850,758,681,4744
23936,8084,8122,8693,9193,9628,9866,8212,61798
23937,2174,1993,2182,2330,2171,2142,1970,14962
23938,283,251,281,251,306,365,407,2144
23942,1431,1142,1245,1187,1078,1125,1112,8320
23943,92,96,275,278,295,260,225,1521
23944,3971,4303,4528,4481,4610,4797,4261,30951
23947,4140,3834,3633,3700,3760,3967,4293,27327
23950,3830,3453,3645,3397,3967,3793,3348,25433
23952,212,173,124,168,147,174,217,1215
23954,1481,1748,2172,2183,2112,2068,2017,13781
23958,3600,3301,3256,3375,3022,3062,3170,22786
23959,1117,1308,1306,1235,1219,1480,1264,8929
23960,1796,1781,1840,2066,2000,2324,1990,13797
23962,328,458,366,345,277,410,670,2854
23963,110,300,398,421,411,739,587,2966
23964,1175,1231,1200,1215,1280,1296,1138,8535
23966,2529,2757,2386,1886,1998,1904,2337,15797
23967,1435,1366,1267,1296,925,920,1118,8327
23968,803,781,746,776,659,882,837,5484
23970,7900,7834,8035,8326,8639,8466,8254,57454
23974,5281,5292,5342,5174,5079,4671,5012,35851
23976,52,86,139,136,152,96,230,891
24011,357,332,304,231,149,119,219,1711
24012,29912,30095,29724,29572,29604,28507,29015,206429
24013,7789,7716,7523,7762,8484,8306,8684,56264
24014,17116,17713,17467,17022,16586,17026,16570,119500
24015,15658,15804,15750,15825,15594,15157,15255,109043
24016,8725,8532,8807,8847,8549,8759,9047,61266
24017,25323,24439,24008,23651,23323,23638,23392,167774
24018,37746,37407,37151,37223,37339,37543,36432,260841
24019,26943,26931,26869,26904,26840,26767,26502,187756
24020,457,449,384,379,389,530,455,3043
24053,2879,2806,2971,2901,2951,2745,2715,19968
24054,6687,6381,6568,6658,6645,6805,6797,46541
24055,12629,12608,12749,12890,13399,13631,13674,91580
24058,173,242,374,387,357,361,324,2218
24059,814,811,792,746,723,904,872,5662
24060,54827,54304,54145,53541,53205,53290,53311,376623
24064,4651,4142,4377,4360,4418,4806,4963,31717
24065,6301,6422,6436,6069,5828,6274,6141,43471
24066,4827,4646,4763,4569,4749,4527,4883,32964
24067,2249,2163,2310,2539,2594,2536,2230,16621
24069,1939,1894,2149,1627,1858,2021,1879,13367
24070,1252,1526,1378,1504,1566,1762,1363,10351
24072,1239,1243,1404,1390,1217,1173,1298,8964
24073,30394,30860,30109,29311,28598,28439,29793,207504
24076,1174,1201,808,751,1220,1192,972,7318
24077,826,1077,1151,1237,1292,1131,932,7646
24078,7450,7689,7786,7832,7543,6685,7115,52100
24079,1846,1960,1707,1825,1534,1514,1766,12152
24082,369,229,547,421,390,296,419,2671
24083,3153,2819,2617,2277,2208,2080,2587,17741
24084,11090,11309,11310,11290,11754,11873,11304,79930
24085,2148,2120,2163,2043,2044,2103,2182,14803
24086,212,211,254,231,171,179,210,1468
24087,4770,4551,4925,4706,4837,4974,3914,32677
24088,5178,4950,4787,5058,5070,5100,5408,35551
24089,3067,3011,2895,2841,2765,3043,2640,20262
24090,5217,4895,4485,5138,4691,4547,4781,33754
24091,7158,7176,6718,6426,7334,7128,7215,49155
24092,2825,2705,2939,3070,2738,2816,3063,20156
24093,132,205,216,199,160,231,192,1335
24095,4754,4613,4636,4148,4085,4032,4677,30945
24101,6171,6464,6784,6604,6496,6419,6132,45070
24102,1683,1806,1709,1773,1916,1824,1697,12408
24104,3589,3771,3657,3727,3491,3473,3469,25177
24105,478,479,653,942,881,785,500,4718
24112,31141,31792,32418,32773,32610,32653,32646,226033
24120,1582,1462,1520,1802,2006,2056,1860,12288
24121,10405,10269,9891,9538,9676,9671,10501,69951
24122,1605,1462,1589,1889,1721,1773,1683,11722
24124,4725,4315,4218,4236,4602,4951,4352,31399
24127,4109,4144,4214,4289,4331,4161,4261,29509
24128,1782,1614,1673,1683,1573,1782,1872,11979
24130,20,21,0,0,0,0,8,49
24131,54,52,76,31,27,75,140,455
24132,531,556,603,456,404,367,460,3377
24133,2504,2726,2558,2478,2687,2903,2626,18482
24134,5201,5354,5614,5626,5603,5430,5741,38569
24136,3293,3576,3494,3588,3607,3400,3393,24351
24137,2504,2811,2677,2893,2565,2788,2582,18820
24138,1670,1699,1811,1646,1626,1555,1613,11620
24139,569,719,744,800,666,573,575,4646
24141,21952,21709,21345,21702,20925,20143,20668,148444
24142,2810,2761,2794,2755,2967,3158,2470,19715
24147,1576,1366,1149,1187,1164,898,1201,8541
24148,7815,7771,7525,7685,7689,8251,8013,54749
24149,3749,3575,3506,3493,3667,3398,3339,24727
24150,660,707,790,783,815,881,693,5329
24151,19845,19840,19403,19066,19756,19041,20000,136951
24153,37537,37128,37089,36526,36110,35808,37761,257959
24161,588,504,340,257,224,291,471,2675
24162,1691,1718,1546,1830,2043,2113,2421,13362
24165,1325,1448,1281,1125,1324,1431,1613,9547
24167,320,352,331,255,179,129,345,1911
24168,281,264,330,324,242,267,187,1895
24171,8639,8201,7983,7881,7567,7565,8250,56086
24174,2857,2696,2838,2579,2541,2663,2539,18713
24175,8001,8834,9395,9719,9915,9698,8818,64380
24176,1462,1623,1614,1723,1823,1587,1360,11192
24179,18261,18671,18547,18464,18773,18594,18616,129926
24184,4861,4672,4628,4505,4845,4516,4705,32732
24185,709,1034,1269,1573,1204,1356,854,7999
24201,16634,16861,16851,16755,16897,16893,17116,118007
24202,12154,12556,13195,13195,13140,12727,12905,89872
24210,17109,17066,16569,16239,16195,16028,16840,116046
24211,9995,10193,10048,10503,10217,10072,9922,70950
24216,2665,2843,2698,2891,3110,2904,2939,20050
24217,301,337,395,451,519,715,406,3124
24219,11171,11357,11429,11661,11682,11858,11265,80423
24220,610,473,503,615,805,857,895,4758
24221,766,837,763,944,1064,814,938,6126
24224,6215,6273,6503,6830,7234,7000,6734,46789
24225,1871,1944,1913,2033,1732,1752,1697,12942
24226,1462,1547,1533,1713,1443,1484,1433,10615
24228,6776,6616,6519,6636,6863,6711,7016,47137
24230,9053,9003,9279,8813,8859,8796,9597,63400
24236,2981,2917,3105,3371,3093,3266,3085,21818
24237,1149,1214,1059,1235,1121,1120,1192,8090
24239,167,247,198,180,119,126,113,1150
24243,2255,2383,2324,2489,2343,2163,2222,16179
24244,6176,6324,6161,5616,5393,5185,5723,40578
24245,908,983,1008,1172,1262,1160,1129,7622
24246,431,457,365,359,398,190,455,2655
24248,2570,2801,2734,2512,2696,2491,2596,18400
24250,1489,1282,1399,1395,1135,1271,1319,9290
24251,8371,8500,8311,8289,8747,9025,8773,60016
24256,3523,3639,3711,3618,3685,3834,3491,25501
24258,1666,1800,1915,1622,1654,1716,1624,11997
24260,5995,6082,5948,6103,6437,6717,5734,43016
24263,6237,6541,6711,6702,6364,6161,7950,46666
24265,499,549,645,998,1134,1218,930,5973
24266,9101,9146,9225,8526,8711,8997,9521,63227
24269,401,353,577,716,599,467,324,3437
24270,497,628,531,582,703,692,582,4215
24271,2501,2452,2396,2559,2481,2432,2689,17510
24272,439,660,566,455,407,540,527,3594
24273,6660,6986,6939,6755,6596,6194,6262,46392
24277,6676,6244,6201,6289,6978,7545,5849,45782
24279,5320,5396,5761,5709,5946,6405,5541,40078
24280,825,667,604,693,756,717,823,5085
24281,2861,2767,2833,2691,2498,2562,2487,18699
24282,659,674,610,587,589,677,727,4523
24283,1966,1948,2049,2206,2406,2409,2171,15155
24290,2034,1954,2146,2469,2325,2331,1874,15133
24292,347,464,488,548,540,587,535,3509
24293,9953,9768,9888,10352,9916,10295,10791,70963
24301,13774,13432,13523,13653,13802,13882,14366,96432
24311,1978,2019,2154,1906,2002,1828,1977,13864
24312,1946,2143,2241,2006,2539,2448,2401,15724
24313,854,896,1087,1209,1035,1027,884,6992
24314,1638,1640,1481,1524,1718,1516,1560,11077
24315,3514,3744,4005,3926,3661,3272,3774,25896
24316,0,17,41,26,23,15,50,172
24317,4087,4208,4189,4335,4391,4111,3858,29179
24318,748,722,739,792,632,749,639,5021
24319,7400,7474,7403,7398,7593,7532,6979,51779
24322,194,209,189,216,222,204,174,1408
24323,657,668,575,584,681,694,644,4503
24324,2129,1979,2101,2211,1975,1753,2013,14161
24325,927,873,835,1052,1199,1311,1039,7236
24326,1209,1132,1097,970,897,872,1058,7235
24328,1591,1458,1392,1607,1687,1918,1726,11379
24330,3266,3333,3255,3722,3817,3766,3401,24560
24333,17722,17759,18040,17947,17540,18171,17996,125175
24340,5880,5506,5741,5431,5693,5734,5657,39642
24343,9038,9021,8835,8815,8898,8532,9267,62406
24347,1685,1900,1800,1937,1826,1847,1931,12926
24348,3736,3806,3892,4048,4294,4436,3958,28170
24350,904,1064,1030,898,1189,1225,1261,7571
24351,678,755,787,630,599,491,668,4608
24352,1000,954,1224,923,944,862,890,6797
24354,14802,15107,15228,15271,15304,15187,15315,106214
24360,6247,6099,6207,6497,6626,6577,6169,44422
24361,5525,5267,5240,5206,5146,5324,5431,37139
24363,1444,1521,1277,1241,1182,1167,1365,9197
24366,590,537,511,473,567,858,781,4317
24368,5305,5306,5250,4870,4640,4931,4953,35255
24370,5892,6104,5976,6228,6072,6605,6572,43449
24374,960,893,964,1012,1182,1044,787,6842
24375,1489,1256,1397,1569,1571,1628,1611,10521
24377,270,267,308,245,361,320,348,2119
24378,1188,1145,1286,1412,1364,1347,1229,8971
24380,2727,2607,2990,2928,2260,2289,2639,18440
24381,4215,4243,4001,3522,3294,3421,3816,26512
24382,13833,13937,13676,13810,13303,13368,14366,96293
24401,35789,35427,35562,35256,35403,35116,35499,248052
24411,51,175,116,112,116,126,112,808
24412,54,66,67,138,155,152,131,763
24413,172,131,160,142,170,160,178,1113
24415,94,90,78,87,94,44,41,528
24416,8470,8391,8289,8674,8809,8611,8807,60051
24421,3869,3777,3555,3439,3664,3451,3868,25623
24422,6167,6390,6477,6694,6566,6878,6315,45487
24426,14083,14176,14049,14035,14140,14076,14329,98888
24430,3708,4041,4454,4617,4788,4997,2643,29248
24431,2107,2148,2396,2489,2713,2422,2656,16931
24432,290,349,298,308,300,309,336,2190
24433,82,72,75,99,46,51,99,524
24435,2315,2283,2098,2264,2457,2256,1925,15598
24437,1263,1211,1278,1159,1026,703,904,7544
24439,1247,1176,1277,1396,1203,1188,1253,8740
24440,3321,3281,3080,2762,2548,2423,2916,20331
24441,6541,6833,6699,6994,6575,7064,6140,46846
24442,110,147,128,137,175,163,120,980
24445,2632,2270,2319,2207,2229,2207,2673,16537
24448,314,345,356,448,434,437,376,2710
24450,16569,16541,16872,16649,16467,16826,16741,116665
24457,150,122,301,230,293,379,270,1745
24458,388,432,425,469,387,450,442,2993
24459,591,637,715,966,929,763,818,5419
24460,1367,1525,1326,1501,1292,1496,1530,10037
24464,235,187,186,263,281,262,213,1627
24465,1360,1340,1337,1282,1458,1404,1382,9563
24467,1993,2065,1976,2055,1972,2263,2212,14536
24471,1364,1166,1032,1011,971,1044,1355,7943
24472,2086,2146,1976,1673,1395,1595,2271,13142
24473,740,679,817,743,988,1095,922,5984
24474,417,363,439,501,669,599,544,3532
24476,176,249,242,258,288,291,280,1784
24477,10999,10372,10150,9933,9687,10004,10573,71718
24479,1327,1224,1294,1234,1323,1332,1537,9271
24482,4744,4436,4316,4230,4695,5000,4872,32293
24483,613,761,1179,1047,1089,991,587,6267
24484,879,1146,1195,1118,1236,1044,741,7359
24485,147,167,183,287,407,370,389,1950
24486,3699,4002,4130,3656,3217,3337,3490,25531
24487,308,293,448,321,277,262,320,2229
24501,26509,26074,26574,26605,26458,26799,26757,185776
24502,46432,46545,45728,44647,44312,43202,43426,314292
24503,18842,18901,18678,19111,19394,19521,19331,133778
24504,9593,10222,10525,10818,10864,10623,9777,72422
24517,5378,5581,5670,5535,5615,5798,5693,39270
24520,2170,2005,2000,1965,2057,2316,2450,14963
24521,10875,10779,10544,10582,10499,10893,10576,74748
24522,9670,9558,9924,9625,9729,9205,9213,66924
24523,19632,19281,18789,18761,18527,19073,18952,133015
24526,1119,1092,1218,1292,1240,1456,1593,9010
24527,2890,3059,3104,2924,2902,2943,3027,20849
24528,3217,3072,3133,3289,3291,3292,3200,22494
24529,1604,1613,1334,1320,1381,1317,1724,10293
24530,1350,1425,1278,1132,1174,979,1088,8426
24531,9120,8719,8969,9306,9468,9132,9203,63917
24534,1198,1447,1514,1537,1546,1689,1740,10671
24536,372,244,158,146,150,61,194,1325
24538,4990,4536,4496,4729,4409,4798,4742,32700
24539,133,134,110,61,39,33,134,644
24540,31881,31267,30893,31276,31329,32120,32170,220936
24541,27541,28101,28878,28901,28936,28768,28221,199346
24549,4222,4421,4850,4682,4818,4634,4292,31919
24550,7881,8208,8011,7698,7391,7208,7258,53655
24551,23460,22966,22080,21793,21439,20425,20667,152830
24553,1771,2138,2233,2490,2516,2172,1902,15222
24554,4361,4126,3844,3637,3515,3403,3995,26881
24555,1907,2489,2395,2506,2365,2393,2140,16195
24556,3147,3543,3547,3581,3537,3352,3053,23760
24557,7353,7214,7102,7341,7744,7632,7977,52363
24558,6659,7128,7039,6721,7255,6731,6347,47880
24562,499,385,303,328,560,456,426,2957
24563,5334,5645,5359,5335,5404,5697,5489,38263
24565,1075,1190,1166,1129,1186,1175,1026,7947
24566,1447,1263,1419,1546,1547,1236,1402,9860
24569,1079,949,1215,1111,1204,1129,1064,7751
24570,16,11,7,0,0,0,20,54
24571,2027,1889,1920,2012,1744,1791,1979,13362
24572,15893,15461,15659,15878,15643,15674,16395,110603
24574,4206,4475,4271,3866,3996,3539,3977,28330
24577,4892,5020,4927,4945,4988,4744,5239,34755
24578,1007,916,883,866,767,814,1056,6309
24579,1718,1613,1352,1266,1459,1402,1389,10199
24580,414,538,661,626,619,688,613,4159
24581,33,0,0,0,0,0,23,56
24586,5721,5845,5556,5949,5560,5656,5562,39849
24588,9138,8575,8963,8792,9016,9093,9647,63224
24589,2052,1958,1932,2254,2172,2413,2271,15052
24590,7983,8346,8009,7877,8046,8185,8074,56520
24592,14458,14516,14850,14529,14313,14230,13934,100830
24593,1899,2044,1958,2047,1827,1710,1963,13448
24594,1588,1494,1223,1389,1400,1740,1651,10485
24595,587,598,653,717,787,895,679,4916
24597,1176,1187,1134,1301,1036,1172,1257,8263
24598,1804,1726,1732,1995,2004,2104,1984,13349
24599,806,846,664,394,402,390,606,4108
24601,65,65,66,45,47,81,77,446
24602,1229,1080,909,1012,968,891,962,7051
24603,939,959,1118,1266,1202,1391,978,7853
24604,496,559,589,643,447,285,342,3361
24605,8924,9315,9094,8426,8622,9189,9301,62871
24606,128,167,351,386,391,448,170,2041
24607,469,465,394,452,395,338,462,2975
24609,6819,7283,7231,7139,6695,7084,7630,49881
24612,180,186,200,138,104,224,229,1261
24613,319,382,403,405,535,553,911,3508
24614,7434,7971,7621,7570,7751,7798,8061,54206
24620,3064,2992,3300,3439,3606,2952,2774,22127
24622,840,742,852,858,1139,1113,1028,6572
24628,386,394,299,242,139,114,295,1869
24630,6933,6822,7118,7466,7427,7418,6774,49958
24631,2416,2318,2056,2096,2040,2469,2843,16238
24634,622,562,573,711,679,605,574,4326
24635,1340,1334,1185,1121,1112,1079,1650,8821
24637,4024,3799,3818,4070,3941,3733,3410,26795
24639,2960,3301,4044,4027,4615,4435,3533,26915
24641,5756,5899,5968,5982,5966,5889,5953,41413
24646,762,644,687,559,641,516,750,4559
24649,3036,2973,2925,3123,2821,2670,2760,20308
24651,6217,5986,6210,6026,5702,5371,6314,41826
24656,3071,3112,3192,3310,3278,3375,3404,22742
24657,399,424,352,440,404,370,321,2710
24701,20837,20891,20771,20885,20815,20383,20786,145368
24712,1917,2007,1822,1915,1818,2045,2063,13587
24714,177,127,121,87,227,247,257,1243
24715,460,366,433,548,641,671,594,3713
24716,497,460,345,320,321,327,508,2778
24719,158,216,441,503,393,426,223,2360
24724,61,53,110,116,104,104,66,614
24726,433,255,281,313,329,653,566,2830
24729,202,163,140,127,138,124,149,1043
24731,272,302,275,278,254,160,255,1796
24733,804,870,659,552,573,563,853,4874
24736,481,497,735,846,1008,1004,902,5473
24737,95,72,50,107,137,209,243,913
24738,194,168,201,262,282,253,308,1668
24740,30988,30588,31136,31041,31143,31064,30435,216395
24747,2796,3091,2979,3011,2764,2901,3006,20548
24801,4813,4849,4679,4449,4239,4441,3858,31328
24808,615,634,650,644,731,830,675,4779
24811,611,530,607,647,325,438,599,3757
24813,347,411,348,415,484,413,511,2929
24815,829,950,949,823,530,481,559,5121
24816,220,185,109,100,70,133,151,968
24817,799,771,767,839,960,974,954,6064
24818,778,1045,1224,1561,1816,2016,1409,9849
24822,735,677,554,564,675,757,955,4917
24823,431,519,666,541,535,508,383,3583
24826,85,71,45,273,351,501,150,1476
24827,1440,1717,1612,1591,1529,1254,1501,10644
24828,814,815,820,890,942,971,927,6179
24830,105,84,86,97,109,127,139,747
24831,119,136,152,164,161,160,250,1142
24834,427,324,526,571,535,702,412,3497
24836,564,549,571,544,734,589,800,4351
24839,1397,1497,1300,1115,1180,963,1523,8975
24843,114,89,107,140,137,58,158,803
24844,1546,2029,2080,1839,1778,1720,1810,12802
24845,517,295,298,280,164,180,282,2016
24846,105,164,165,168,151,184,244,1181
24847,366,302,349,350,262,289,293,2211
24848,179,234,175,166,138,159,262,1313
24849,359,356,278,304,362,233,337,2229
24850,861,915,824,830,824,717,1093,6064
24851,413,427,369,308,343,290,419,2569
24853,485,488,589,731,897,1031,793,5014
24854,344,390,526,479,549,641,550,3479
24857,936,790,914,739,667,703,984,5733
24860,306,379,481,505,515,462,552,3200
24861,185,229,347,390,364,294,307,2116
24862,462,400,503,481,529,463,651,3489
24866,231,241,158,106,72,74,240,1122
24867,329,347,362,323,341,284,409,2395
24868,1095,1156,1345,1649,2012,2130,1686,11073
24869,402,334,332,286,443,542,351,2690
24870,2828,2590,2774,3191,3372,3314,2874,20943
24871,244,255,234,195,188,265,309,1690
24872,725,647,874,825,699,695,783,5248
24873,315,343,388,498,502,680,600,3326
24874,2847,2846,2623,2275,2458,2684,2729,18462
24878,524,605,453,500,488,407,337,3314
24879,614,695,732,599,704,676,657,4677
24880,421,346,398,442,166,204,356,2333
24881,400,374,459,553,576,604,601,3567
24882,443,476,437,596,649,569,483,3653
24884,347,442,385,314,389,283,265,2425
24887,13,15,14,125,155,165,67,554
24888,103,125,217,242,251,266,167,1371
24892,1763,1435,1431,1544,1548,1511,1513,10745
24894,323,328,324,198,182,120,388,1863
24898,85,109,119,117,124,143,198,895
24901,9200,8979,9049,8436,8896,8581,9128,62269
24910,5408,5608,5350,5616,4948,5435,5383,37748
24915,606,598,575,375,398,469,590,3611
24916,747,717,744,699,721,614,558,4800
24918,1850,1728,1601,1542,1602,1573,1677,11573
24920,268,332,286,399,398,362,346,2391
24924,362,348,252,270,268,361,512,2373
24925,604,637,736,766,860,811,935,5349
24927,190,185,179,220,308,234,365,1681
24931,1341,1347,1543,1741,1511,1454,1544,10481
24934,380,394,341,349,379,402,503,2748
24935,566,552,608,625,655,614,688,4308
24938,1607,1652,1530,1701,1494,1766,1518,11268
24941,1242,1365,1347,1375,1459,1365,1059,9212
24944,479,525,393,397,610,499,401,3304
24945,444,403,455,421,555,545,393,3216
24946,1552,1642,1794,1745,1660,1747,1533,11673
24951,1636,1520,1466,1395,1383,1488,1489,10377
24954,3800,3763,3939,4034,3786,3714,3514,26550
24957,266,340,268,170,296,279,346,1965
24962,109,111,99,124,101,155,186,885
24963,4150,4037,3851,3537,3340,3248,4095,26258
24966,1591,1469,1247,1004,1064,970,1286,8631
24970,4595,4371,4651,4950,4833,5077,4575,33052
24974,240,242,234,280,261,219,299,1775
24976,929,1129,1078,1176,1403,1519,1005,8239
24977,661,594,571,450,436,359,441,3512
24981,554,664,694,823,807,725,631,4898
24983,2038,2251,2610,2756,2630,2516,2443,17244
24984,303,244,219,259,139,103,185,1452
24986,5515,5819,5492,5496,5672,5131,5216,38341
24991,693,658,658,582,773,738,521,4623
25002,15,13,13,123,222,328,112,826
25003,2816,2890,2607,2436,2364,2079,2782,17974
25005,101,136,167,158,202,218,264,1246
25007,900,733,670,559,366,205,604,4037
25008,126,127,340,359,252,237,210,1651
25009,1277,1224,1318,1386,1186,955,1153,8499
25011,1250,1159,747,977,1044,1044,800,7021
25015,4500,4550,4591,4378,4538,4856,4691,32104
25019,619,434,366,479,545,550,575,3568
25021,324,370,334,344,342,312,305,2331
25022,154,146,119,140,59,144,153,915
25024,533,715,591,693,805,771,586,4694
25025,105,131,176,170,166,175,230,1153
25028,374,343,410,335,262,311,381,2416
25030,354,237,406,453,421,454,414,2739
25031,974,923,926,1091,1089,1046,615,6664
25033,1951,1887,1967,1851,1835,2025,2234,13750
25035,1082,1230,1167,1133,1082,1130,1112,7936
25036,593,700,1277,1188,993,693,468,5912
25039,1016,1021,1254,1401,1346,1392,1304,8734
25040,566,521,605,653,570,395,546,3856
25043,1452,1723,1874,1724,1749,1657,1659,11838
25044,261,285,359,334,404,460,384,2487
25045,5064,5450,5266,5640,6016,6182,5801,39419
25047,276,378,310,503,440,389,411,2707
25048,61,39,31,22,13,13,38,217
25049,529,605,865,665,725,936,630,4955
25051,230,254,142,25,78,147,164,1040
25053,4555,4417,4513,4371,4674,4925,4296,31751
25054,533,342,297,225,282,239,426,2344
25057,382,315,238,218,183,62,337,1735
25059,629,474,535,626,524,726,678,4192
25060,369,487,502,412,616,560,618,3564
25061,750,647,455,349,279,295,756,3531
25062,150,132,99,159,143,110,230,1023
25063,1663,1665,1680,1567,1707,1468,1797,11547
25064,9359,9502,9585,9682,9542,9603,9962,67235
25067,938,947,975,1140,1362,1349,1120,7831
25070,1669,1873,1960,1981,2216,1986,1683,13368
25071,12347,11927,11728,12297,11457,10835,11697,82288
25075,631,492,549,588,659,854,976,4749
25076,368,264,282,274,257,280,298,2023
25081,1043,1283,1171,1170,1376,1464,1251,8758
25082,1816,1686,1667,1791,1763,1431,1673,11827
25083,929,635,752,596,714,798,672,5096
25085,998,949,897,958,968,862,830,6462
25086,748,735,761,867,808,758,928,5605
25088,135,124,49,98,88,29,164,687
25090,143,123,129,116,142,93,203,949
25093,182,82,107,128,191,207,207,1104
25102,233,301,284,348,329,336,349,2180
25103,193,205,69,137,173,308,366,1451
25106,399,479,440,656,600,877,642,4093
25107,379,409,396,390,431,480,739,3224
25108,549,616,595,390,433,290,692,3565
25109,458,502,447,450,496,594,661,3608
25110,379,381,568,555,774,653,599,3909
25111,515,748,670,723,701,697,694,4748
25112,141,152,110,89,93,93,166,844
25113,800,858,776,828,896,1095,957,6210
25114,612,630,757,796,529,648,557,4529
25115,125,205,182,300,211,274,90,1387
25118,775,832,1020,1265,1237,1291,998,7418
25119,353,558,584,641,631,622,444,3833
25121,742,678,1024,899,778,1030,972,6123
25123,3359,3408,3295,3602,3478,3090,3535,23767
25124,1548,1389,1599,1350,1201,1199,1214,9500
25125,866,646,800,762,878,950,1011,5913
25126,47,44,43,38,10,0,58,240
25130,3386,3491,3611,3467,3469,3296,3846,24566
25132,195,267,462,538,657,452,276,2847
25133,1165,1031,955,1201,883,899,922,7056
25134,505,432,478,511,419,232,423,3000
25136,1905,1863,1873,2049,2463,2201,1798,14152
25139,398,346,369,248,305,306,440,2412
25140,1488,1334,1158,1153,1127,1050,1012,8322
25141,239,205,211,211,342,328,195,1731
25142,259,282,341,402,400,549,416,2649
25143,8055,7937,8296,8393,8614,9140,8579,59014
25148,451,291,216,118,103,159,332,1670
25149,210,196,251,315,298,417,242,1929
25152,302,323,395,307,326,164,368,2185
25154,610,729,677,805,804,954,868,5447
25156,71,106,104,149,147,164,105,846
25159,5581,5711,5521,5487,5311,5012,5163,37786
25160,143,173,207,237,187,414,303,1664
25161,327,330,280,303,347,463,369,2419
25162,462,520,526,499,489,418,571,3485
25164,1102,1284,1252,1183,1311,1299,1257,8688
25165,500,477,413,451,479,555,612,3487
25168,2220,2182,2142,2425,2603,2160,2503,16235
25169,689,724,700,618,461,266,516,3974
25173,362,327,308,340,327,309,452,2425
25174,613,502,502,539,543,517,420,3636
25177,24171,24605,24609,24606,24830,24503,24084,171408
25180,14,65,67,53,165,179,83,626
25181,1334,1450,1732,2301,2253,2043,1853,12966
25183,0,0,0,0,0,0,73,73
25185,956,1022,467,494,517,621,1042,5119
25186,968,1041,1206,1083,1068,1232,881,7479
25187,841,929,755,678,699,621,719,5242
25193,395,329,457,690,631,643,477,3622
25201,29,24,0,27,31,12,55,178
25202,1224,1159,1300,1164,1043,1321,1370,8581
25203,71,88,98,53,90,96,89,585
25204,166,216,240,300,384,384,211,1901
25205,533,455,305,234,185,268,391,2371
25206,373,348,472,494,474,465,601,3227
25208,998,1058,1074,1033,909,907,992,6971
25209,1386,1207,1139,1001,1290,1373,1227,8623
25211,235,191,182,136,147,227,135,1253
25213,6045,5999,6237,6009,5519,5220,5512,40541
25214,671,654,681,748,559,587,614,4514
25234,1359,1567,1447,1760,1724,1608,1200,10665
25235,868,750,899,802,785,865,949,5918
25239,1802,1883,1831,1711,1798,1562,1732,12319
25241,2092,1612,1450,1475,1429,1433,1710,11201
25243,676,636,687,583,805,1022,899,5308
25244,753,555,634,748,595,683,732,4700
25245,352,622,686,612,696,1028,739,4735
25247,568,527,558,645,698,871,509,4376
25248,2787,2984,3183,3476,3580,3676,3090,22776
25251,599,565,612,600,588,352,429,3745
25252,1318,1205,1020,1200,985,1354,1071,8153
25253,2281,2163,2182,2118,2093,1709,2051,14597
25259,505,536,549,653,742,1157,699,4841
25260,1419,1644,1755,1708,1841,2063,1577,12007
25261,327,309,376,299,317,218,335,2181
25262,984,1107,1231,1193,1316,1211,898,7940
25264,341,335,439,325,382,377,441,2640
25265,1355,1477,1423,1422,1558,1619,1564,10418
25266,807,1017,1073,1119,1054,960,797,6827
25267,643,737,543,571,495,543,758,4290
25268,872,765,731,689,714,677,871,5319
25270,1091,1091,1030,1089,1030,917,972,7220
25271,9732,9673,9424,9361,9381,8863,9304,65738
25275,1797,1933,2256,2152,2248,2294,2287,14967
25276,7904,7718,7715,7246,7120,7354,7752,52809
25285,635,574,557,510,473,456,595,3800
25286,1562,1544,1479,1591,1638,1405,1692,10911
25287,1297,1270,1191,1108,1065,1103,1272,8306
25301,2472,2417,2165,2084,2439,2459,2771,16807
25302,14229,14795,15006,15588,14932,15749,15078,105377
25303,7413,7101,7181,7090,7200,7192,7112,50289
25304,8321,8705,8926,8958,9216,9084,8773,61983
25305,0,0,0,0,0,0,0,0
25306,6512,6428,6356,6372,6425,6228,6417,44738
25309,13561,13409,13158,13495,12275,12053,13356,91307
25311,10456,10523,10059,10058,9980,10472,10815,72363
25312,15253,14543,14632,14509,14630,14661,14886,103114
25313,12295,13027,13583,13198,13127,13327,13436,91993
25314,15716,16101,16507,16294,16250,15281,14542,110691
25315,3175,3361,3345,3299,3454,3650,3255,23539
25320,6387,6324,6700,6405,7230,7193,6084,46323
25401,13934,14675,14922,14987,14970,14694,14622,102804
25403,13432,13586,13783,13436,13051,12437,12591,92316
25404,22602,21859,21870,21508,20504,20167,19551,148061
25405,13363,13551,12350,11616,11424,11456,12029,85789
25411,12386,12850,12628,12747,12281,12782,12633,88307
25413,8346,8514,8280,8327,7617,7720,7508,56312
25414,17562,17254,16896,17147,17581,17585,17024,121049
25419,10198,9998,9454,9209,9669,9078,9251,66857
25420,3685,4058,4027,3948,4012,3970,4024,27724
25422,2081,1717,1784,1786,1914,1608,1700,12590
25425,13160,13505,13391,12757,12184,11910,12835,89742
25427,12812,11823,12362,12630,13699,14185,14322,91833
25428,12558,11078,10761,10023,9615,9049,10776,73860
25430,8228,8214,8427,9007,8721,8937,8112,59646
25431,173,267,329,219,301,261,453,2003
25432,112,71,48,151,225,285,121,1013
25434,2482,2883,2708,2570,2805,2701,2521,18670
25437,377,292,211,201,282,257,212,1832
25438,6741,6932,6846,6364,6295,5904,6266,45348
25442,1748,1519,1671,1734,1714,1951,1925,12262
25443,7439,7442,6904,7075,7024,6999,7445,50328
25444,142,180,196,248,250,299,605,1920
25446,1840,1638,1948,1865,1754,1418,1463,11926
25501,1339,1255,1633,1468,1442,1287,1130,9554
25502,1183,1377,1283,1170,1226,1157,1034,8430
25503,1368,908,768,555,438,758,729,5524
25504,12876,13001,13336,12446,13156,12719,12661,90195
25505,658,559,680,638,397,349,477,3758
25506,5269,4744,4452,4212,4893,4849,5037,33456
25507,853,894,979,1041,1094,1229,987,7077
25508,9711,9968,9472,9394,9567,8994,9837,66943
25510,5061,5394,5294,4990,5162,5500,5074,36475
25511,1149,1005,937,795,1078,985,1092,7041
25512,1020,1160,1238,1128,1319,962,1237,8064
25514,3501,3497,3566,3331,3744,3701,4024,25364
25515,2312,2455,2637,2799,2633,2458,2335,17629
25517,2110,2368,2920,3051,2467,2472,2071,17459
25520,1737,1388,1308,1311,1397,1603,1561,10305
25521,959,915,1032,945,1012,1197,1101,7161
25523,2759,2866,2827,2901,2626,2535,2647,19161
25524,3377,3388,3227,2919,3267,3337,3486,23001
25526,22772,22711,22606,21589,21926,21988,21902,155494
25529,1109,1149,1334,1422,1357,1012,1013,8396
25530,5174,4959,5277,5272,5550,5617,5877,37726
25534,318,160,223,265,231,222,282,1701
25535,3003,3041,3025,3007,2852,2843,2783,20554
25537,1528,1533,1732,1699,1512,1443,1993,11440
25540,178,240,285,275,183,209,290,1660
25541,8914,8482,8763,8730,8785,8871,9350,61895
25545,5262,5289,4997,5292,4758,4199,4512,34309
25547,911,1036,1267,1272,1238,1186,969,7879
25550,8348,8893,8944,8935,9154,9185,9077,62536
25555,1833,1910,1842,2007,2065,2184,2325,14166
25557,1559,1528,1647,1462,1415,1532,1754,10897
25559,2033,1979,2030,2105,2132,1846,2152,14277
25560,8288,8228,8033,8533,8080,8443,7997,57602
25564,1700,2083,1448,1431,1287,1166,1250,10365
25565,702,630,507,559,465,579,651,4093
25567,857,880,765,987,1304,1388,924,7105
25570,6419,6576,6587,6825,7043,7152,6640,47242
25571,1939,1886,1961,2371,2462,2391,2206,15216
25573,1083,1014,1253,1286,932,998,970,7536
25601,5468,5008,5247,5517,5554,6032,5206,38032
25606,1312,983,779,818,816,607,964,6279
25607,897,981,1062,967,1077,1076,1140,7200
25608,1081,1123,1111,1145,1124,1224,1004,7812
25611,1189,1187,896,606,562,525,682,5647
25617,664,744,713,694,683,753,999,5250
25621,2071,2079,2090,2267,2483,2716,2155,15861
25624,240,317,239,222,210,227,480,1935
25625,1504,1411,1457,1704,1616,1611,1452,10755
25628,474,522,575,536,396,296,539,3338
25630,908,899,1015,953,964,904,683,6326
25632,475,504,539,788,1127,1294,834,5561
25634,523,650,670,928,897,821,771,5260
25635,1288,1403,1294,1438,1397,1384,1227,9431
25637,726,809,778,934,982,892,936,6057
25638,987,1056,1365,1373,1435,1327,1148,8691
25639,405,474,540,556,574,657,608,3814
25644,474,464,426,418,389,472,536,3179
25646,994,1023,1110,1011,1025,945,940,7048
25647,931,1049,695,564,767,837,768,5611
25649,1340,1359,1368,892,813,1008,1397,8177
25650,403,450,683,791,789,821,547,4484
25651,671,684,640,542,470,377,737,4121
25652,1205,1220,1238,1456,1550,1709,1608,9986
25653,342,545,644,722,600,650,459,3962
25654,252,315,280,191,189,136,310,1673
25661,6379,6258,6384,6521,6118,5770,6837,44267
25666,868,776,804,944,855,925,654,5826
25669,972,763,624,908,865,865,887,5884
25670,5731,6074,6313,6881,7242,7678,5829,45748
25671,1260,1240,1193,1229,1090,1073,1286,8371
25672,411,451,390,268,218,264,408,2410
25674,2762,2893,2379,2141,2269,2470,3202,18116
25676,1244,1125,1045,1090,924,892,1250,7570
25678,1530,1585,1779,1588,2039,2107,1595,12223
25688,277,395,351,333,337,305,448,2446
25690,310,297,281,235,175,166,249,1713
25692,893,1008,913,798,883,759,1021,6275
25696,247,143,144,93,88,0,295,1010
25699,195,153,126,119,58,34,200,885
25701,21815,23267,23542,23851,23903,24039,23284,163701
25702,7725,7823,8294,8561,8048,8238,7788,56477
25703,7458,6980,6684,6705,6396,6367,6751,47341
25704,16573,17070,16734,16668,16280,16690,16441,116456
25705,21502,20920,20637,20866,20684,20766,20711,146086
25801,33913,34166,34021,34247,33458,33535,33590,236930
25810,308,301,312,175,80,49,261,1486
25811,142,139,247,231,225,292,154,1430
25812,1701,1893,1940,2078,2149,2240,1902,13903
25813,7504,7685,7853,7965,8414,8628,8063,56112
25817,899,766,788,658,564,562,784,5021
25818,165,278,408,553,611,649,472,3136
25820,337,580,577,580,513,526,437,3550
25823,2339,2344,2221,2335,2284,2352,2176,16051
25825,2416,2653,2879,2237,2414,2539,2390,17528
25826,219,169,161,168,185,236,296,1434
25827,2617,2531,2855,2727,2596,2531,2488,18345
25831,1376,1351,1299,1166,1256,1310,1421,9179
25832,4639,4462,4108,4613,4159,4032,3994,30007
25836,655,683,372,254,239,207,488,2898
25837,307,294,170,264,314,280,391,2020
25839,523,563,758,569,550,715,691,4369
25840,7819,7472,7465,7215,7117,7688,8179,52955
25841,578,699,723,701,675,641,575,4592
25843,867,787,685,884,882,790,791,5686
25844,1376,1601,1645,1869,1969,1786,1417,11663
25845,891,771,651,652,466,194,627,4252
25846,273,387,462,523,521,549,363,3078
25848,310,541,535,558,548,593,443,3528
25849,718,474,495,445,484,107,266,2989
25853,0,114,112,125,126,118,182,777
25854,1001,1215,1201,1422,1063,1166,1101,8169
25855,247,224,218,222,206,135,209,1461
25857,215,186,407,479,719,646,308,2960
25862,95,187,252,217,208,261,266,1486
25864,228,275,207,133,192,216,309,1560
25865,1214,1299,1253,1368,1419,1389,1475,9417
25868,238,255,346,487,496,599,432,2853
25870,57,81,101,108,110,53,103,613
25871,577,582,586,530,554,628,695,4152
25873,570,698,850,937,904,927,607,5493
25875,521,504,453,500,494,590,486,3548
25876,67,85,103,146,199,268,128,996
25878,779,945,762,798,800,837,930,5851
25879,846,873,891,703,494,292,359,4458
25880,6579,6262,6421,6620,6842,6696,6928,46348
25882,2190,2652,2573,2702,2799,2755,2033,17704
25901,11381,11888,11546,11336,11303,11070,11920,80444
25902,76,166,327,420,533,657,420,2599
25904,337,278,352,298,252,438,365,2320
25906,269,308,417,416,354,348,287,2399
25907,103,100,119,162,178,186,123,971
25908,173,110,52,98,18,14,172,637
25911,55,14,16,14,135,117,55,406
25913,324,325,455,453,487,281,397,2722
25915,364,370,370,264,249,189,311,2117
25916,242,155,73,142,123,150,202,1087
25917,2152,2053,1670,1744,1922,2264,2139,13944
25918,4174,4183,4352,4140,3741,3702,4430,28722
25920,112,253,231,233,320,417,221,1787
25921,2215,2325,2011,1872,1996,1933,2157,14509
25922,264,305,231,195,209,286,299,1789
25928,416,427,366,384,429,341,375,2738
25932,113,60,101,106,101,161,339,981
25936,82,79,30,33,48,7,43,322
25938,1252,1233,1251,1210,1264,1262,1287,8759
25942,291,227,197,71,87,45,162,1080
25951,5681,5953,5846,5987,6155,5945,6208,41775
25958,774,929,915,868,704,814,851,5855
25962,3555,3648,3878,3792,4001,4181,3806,26861
25969,1118,942,1063,1188,1327,1712,973,8323
25971,1008,1122,1201,1037,953,885,1130,7336
25972,213,247,292,228,212,184,299,1675
25976,2642,2347,2329,2255,2224,2185,2663,16645
25977,165,147,124,117,120,162,155,990
25978,674,623,675,618,615,594,606,4405
25979,804,699,846,721,746,670,893,5379
25981,655,733,1000,1106,1196,1309,951,6950
25984,1883,1797,2115,2307,2092,2142,1886,14222
25985,256,315,286,315,325,315,430,2242
25989,499,582,496,260,219,219,280,2555
26003,42074,42573,42994,43424,43671,43694,43002,301432
26030,602,618,770,601,488,597,516,4192
26031,1646,1612,1628,1553,1657,1832,1755,11683
26032,1067,1163,1269,1409,1389,1393,1243,8933
26033,2675,2850,2814,2593,2673,2952,3044,19601
26034,4699,5063,5067,5010,5040,5189,4905,34973
26035,2726,2512,2934,2804,2694,2535,2491,18696
26036,425,563,601,442,435,357,425,3248
26037,6510,6752,6507,6776,7013,7038,6642,47238
26038,2726,2737,3023,3108,2980,2985,2855,20414
26039,893,921,907,923,1090,1226,1061,7021
26040,1826,1840,1866,1748,1723,1638,2103,12744
26041,16125,15981,15766,16295,16243,16321,16183,112914
26047,6106,6250,6534,6827,6540,5839,6222,44318
26050,1577,1502,1329,1139,1046,1478,1575,9646
26055,1970,2102,1982,1658,1725,1356,1756,12549
26056,213,174,195,195,107,143,93,1120
26059,2690,2437,2563,2729,2610,2768,3082,18879
26060,2005,2111,1822,1789,1780,1916,1881,13304
26062,21205,21020,21046,21068,21586,21706,21801,149432
26070,8142,8079,7786,7933,8122,8248,8441,56751
26074,1273,1218,1206,1152,1100,971,1184,8104
26075,422,477,538,521,441,495,505,3399
26101,30269,30240,30134,29526,29858,29767,29999,209793
26104,16179,16530,17148,17482,17682,18083,16769,119873
26105,11954,12020,12215,12252,12132,12113,12333,85019
26133,1453,1369,1246,1299,1316,1253,1415,9351
26134,1036,1044,1101,975,1021,1021,888,7086
26136,744,852,714,583,534,602,644,4673
26137,594,715,785,843,734,773,939,5383
26138,235,259,68,134,109,232,127,1164
26141,362,225,161,125,84,102,364,1423
26142,2806,2880,2806,2842,2806,2429,2574,19143
26143,4361,4328,4743,4425,4389,4602,4547,31395
26146,1021,998,1022,934,800,684,1003,6462
26147,2112,2234,2308,2288,2032,2042,2188,15204
26148,326,254,199,238,219,223,245,1704
26149,2448,2608,2565,2744,2700,2752,2452,18269
26150,6353,6194,5940,6132,6179,5972,6309,43079
26151,507,552,464,439,784,790,558,4094
26152,114,148,56,47,41,0,56,462
26155,8201,8356,8566,8791,8875,8743,8823,60355
26159,3072,2820,2596,2683,2691,2979,2745,19586
26160,1006,1009,1077,1061,1087,796,960,6996
26161,293,186,262,314,285,325,480,2145
26164,8516,8240,7967,8346,8110,7894,8262,57335
26167,818,966,1105,974,1051,1100,865,6879
26169,616,769,848,887,946,821,842,5729
26170,5921,5911,5694,5923,6034,6204,6137,41824
26175,3462,3503,3624,3470,3536,3420,3326,24341
26178,444,477,547,335,284,368,587,3042
26180,2032,2188,2027,1878,1791,1729,2284,13929
26181,6223,6088,6107,6187,5991,6142,6127,42865
26184,1938,2250,2108,2192,2190,2274,2361,15313
26187,6466,5955,5845,6081,6064,6261,5982,42654
26201,20375,20187,20073,19973,20064,19775,19701,140148
26202,651,687,657,762,641,543,641,4582
26203,40,187,212,251,195,266,198,1349
26205,3125,3302,3065,3079,3406,4242,3690,23909
26206,3196,2903,2788,2781,2719,2862,2976,20225
26208,813,821,855,821,885,946,973,6114
26209,133,160,128,60,74,120,112,787
26215,217,226,406,412,273,141,167,1842
26217,225,353,349,425,429,449,354,2584
26218,3085,2808,2357,2393,2360,2031,2583,17617
26222,446,350,285,330,361,299,454,2525
26224,251,117,226,217,239,201,221,1472
26228,18,19,52,50,75,101,109,424
26230,129,164,174,150,151,137,124,1029
26234,987,1276,1673,1754,1575,1747,1454,10466
26236,120,0,13,11,11,101,29,285
26237,462,563,487,431,287,392,571,3193
26238,928,934,908,625,404,466,739,5004
26241,14407,14645,14671,14408,14068,14235,14591,101025
26250,5478,5296,5134,5218,5336,4894,5570,36926
26253,3566,3310,3227,3079,3136,3050,3490,22858
26254,330,369,481,523,484,462,303,2952
26257,856,773,723,914,998,1154,957,6375
26259,117,232,197,150,119,171,176,1162
26260,1297,1324,1342,1351,1218,1241,1377,9150
26261,2557,2713,2748,3068,3114,2871,2701,19772
26263,281,314,217,152,190,298,316,1768
26264,755,675,688,756,730,705,642,4951
26266,93,85,114,101,207,217,252,1069
26267,437,435,399,355,296,336,369,2627
26268,57,75,74,64,69,51,82,472
26269,1025,1028,1043,1006,1003,1074,1018,7197
26270,613,653,660,719,689,731,755,4820
26271,282,320,329,364,381,366,383,2425
26273,1795,1801,1782,1952,1515,1944,2041,12830
26275,668,698,719,797,643,602,744,4871
26276,209,199,372,390,493,656,356,2675
26278,660,829,864,668,798,676,591,5086
26280,2068,1937,1897,1882,2617,1809,1710,13920
26282,14,0,73,46,56,148,60,397
26283,1733,1886,1919,2201,2003,1719,1734,13195
26285,397,408,358,223,255,256,304,2201
26287,2989,2875,2931,3000,3272,3245,3131,21443
26288,3726,3904,3845,3829,3906,3871,3603,26684
26291,95,75,80,77,94,134,165,720
26292,815,873,782,767,723,668,836,5464
26293,687,666,670,830,691,769,600,4913
26294,974,885,928,1009,1046,1173,729,6744
26296,152,189,235,326,321,269,177,1669
26298,82,71,59,43,24,36,96,411
26301,30249,30408,29932,30048,29735,29077,30435,209884
26320,630,813,801,746,828,830,1000,5648
26321,514,641,576,643,844,706,354,4278
26323,493,414,629,699,671,666,602,4174
26325,293,278,310,374,392,292,320,2259
26327,110,158,143,141,146,46,83,827
26330,14497,14500,14415,13886,14053,14193,14377,99921
26335,1319,1346,1163,1191,1412,1319,1378,9128
26337,1292,1125,1147,1276,1383,1451,1218,8892
26338,838,699,602,587,557,430,629,4342
26339,231,227,247,200,213,366,255,1739
26342,275,296,383,460,491,554,509,2968
26343,130,298,308,403,481,376,445,2441
26346,1074,1006,1101,811,955,898,972,6817
26347,2293,2083,2179,2167,2022,1959,2068,14771
26348,87,76,118,121,140,142,196,880
26349,95,100,167,145,119,104,132,862
26351,4881,4825,4974,4761,5000,5084,5120,34645
26354,10865,11149,10951,10951,11027,10923,11135,77001
26361,255,242,185,115,108,118,263,1286
26362,3375,3523,3382,3527,3405,3386,3378,23976
26366,98,100,114,281,279,143,144,1159
26369,564,840,686,547,593,850,762,4842
26372,797,900,949,763,700,573,686,5368
26374,1153,1421,1472,1608,1651,1733,1375,10413
26376,481,481,444,556,716,793,463,3934
26377,624,609,707,812,765,661,700,4878
26378,4495,4385,4402,4435,4197,4557,3820,30291
26384,835,916,876,883,503,392,520,4925
26385,3754,3348,3655,3768,3953,3736,3872,26086
26386,2170,2307,2477,2772,2666,2853,2411,17656
26404,587,365,468,450,329,248,458,2905
26405,1128,1185,1297,1393,1237,1369,1179,8788
26408,2999,2860,2960,2652,2559,2528,2852,19410
26410,986,986,1041,1207,1253,1402,1037,7912
26411,704,905,772,743,637,582,707,5050
26412,724,641,541,441,310,366,546,3569
26415,4020,4251,4412,4226,3913,3820,4016,28658
26416,7910,7612,7513,7081,7409,7658,7529,52712
26419,1196,1204,1148,1157,1019,1263,1131,8118
26421,186,236,215,267,281,254,262,1701
26422,498,476,383,536,607,543,606,3649
26424,241,340,336,556,536,687,318,3014
26425,1218,1243,1371,1322,1345,1352,1216,9067
26426,7429,7409,7549,6728,6796,6806,7003,49720
26430,598,514,559,665,677,813,466,4292
26431,5619,5681,5836,6107,6019,6285,5950,41497
26435,186,188,159,131,161,110,98,1033
26436,151,115,147,95,56,126,204,894
26437,554,498,648,595,583,602,645,4125
26438,226,275,271,161,198,149,176,1456
26440,1234,1145,1137,965,955,884,1135,7455
26443,348,247,177,162,232,197,258,1621
26444,3629,3784,3916,4015,3486,3603,3639,26072
26447,1484,1406,1236,953,1014,1182,1055,8330
26448,1158,1199,1541,1646,1831,2127,1421,10923
26451,851,787,726,835,915,979,685,5778
26452,8845,8933,9109,9487,9281,9237,9676,64568
26456,3706,3608,3631,4247,4432,4285,3734,27643
26501,21067,20374,20524,19782,19176,19522,19616,140061
26505,38647,38243,38172,37712,37257,36100,38772,264903
26508,33105,32689,31882,32029,31318,30435,29170,220628
26519,2027,1792,1762,1654,1374,1320,1836,11765
26520,951,828,802,771,744,789,778,5663
26521,256,244,269,263,217,289,346,1884
26525,7849,7531,6965,6782,6613,5916,7064,48720
26534,2276,1952,1599,1264,661,647,789,9188
26537,5475,5670,5670,5635,5683,5478,5721,39332
26541,2661,3062,3021,3156,3259,3346,2624,21129
26542,2584,2198,2512,2804,2802,2729,2547,18176
26543,255,256,155,156,245,187,252,1506
26547,2336,2531,2558,2585,2707,2784,2376,17877
26554,41915,41949,41801,41611,40919,40591,41369,290155
26559,1194,1290,1227,1261,1302,1397,1269,8940
26560,252,142,154,91,66,58,227,990
26562,521,527,518,529,734,766,634,4229
26563,487,304,284,318,461,390,381,2625
26568,620,624,558,702,732,582,679,4497
26570,3985,3612,3533,3285,3289,3498,3595,24797
26571,2413,2139,2076,2112,1955,1958,1833,14486
26572,354,407,234,238,85,74,136,1528
26574,570,582,476,553,560,526,664,3931
26575,873,868,1022,934,877,832,827,6233
26576,279,204,276,235,285,314,608,2201
26581,1046,1064,1008,1078,1100,1025,1104,7425
26582,4988,5305,5323,4930,5173,5163,5335,36217
26585,513,554,469,448,596,333,479,3392
26586,198,205,68,0,0,0,209,680
26587,272,384,347,447,531,513,432,2926
26588,2694,2834,2944,2937,2930,3000,2611,19950
26590,526,775,840,893,937,873,791,5635
26591,1181,1391,1501,1615,1820,2018,1511,11037
26601,4984,4886,5055,5509,5633,5658,4898,36623
26610,1262,1081,939,902,871,969,1090,7114
26611,153,130,110,106,141,156,224,1020
26615,274,260,422,342,317,315,245,2175
26617,171,278,256,110,104,109,187,1215
26619,273,462,566,627,732,581,606,3847
26621,883,1030,909,671,680,620,757,5550
26623,1570,1396,1414,1350,1050,1100,1189,9069
26624,2696,2769,2758,2792,2582,2585,2950,19132
26627,272,263,338,280,484,367,447,2451
26629,317,425,362,367,329,353,309,2462
26631,474,468,397,365,260,239,352,2555
26636,422,407,464,467,499,454,487,3200
26638,152,161,180,139,223,206,178,1239
26651,9870,9979,9968,10286,10022,9366,9650,69141
26656,411,327,350,335,404,242,401,2470
26660,330,254,281,302,321,251,255,1994
26662,1208,1210,1323,986,958,802,1154,7641
26676,438,589,568,586,689,656,435,3961
26678,1328,1234,1499,1352,1315,1240,1247,9215
26679,1689,1887,1774,1707,1777,1501,1896,12231
26680,208,185,209,154,181,187,340,1464
26681,1405,1325,1463,1443,1421,1818,1486,10361
26684,137,108,85,89,0,12,116,547
26690,619,579,509,487,670,709,584,4157
26691,380,435,434,431,469,507,417,3073
26704,6247,6077,6046,6337,5935,5790,5663,42095
26705,870,1178,1059,1085,1385,1296,1077,7950
26707,318,415,461,404,434,453,344,2829
26710,2549,2401,2142,2182,2115,2008,2133,15530
26711,2390,2434,1969,2166,2357,2162,2655,16133
26714,258,414,433,347,379,257,482,2570
26716,814,932,876,648,649,820,706,5445
26717,1039,1127,1292,1173,1204,1125,1170,8130
26719,2704,2376,2387,2656,2645,2889,2785,18442
26720,90,176,101,155,190,195,174,1081
26722,879,1007,925,821,739,928,599,5898
26726,12815,13167,13306,12947,13229,13299,13306,92069
26731,271,224,177,198,276,204,382,1732
26739,785,660,708,1019,1132,1043,889,6236
26743,1866,1741,1788,1895,1544,1133,1613,11580
26750,763,839,867,1012,990,1073,891,6435
26753,6185,6430,6497,6315,6329,6315,6254,44325
26755,874,725,1196,975,922,906,833,6431
26757,6338,6347,6621,6851,6928,7163,6464,46712
26761,486,480,508,408,511,468,685,3546
26763,1682,1448,1522,1657,1594,1512,1540,10955
26764,3742,3842,4057,4038,4298,4485,4220,28682
26767,448,445,376,466,506,559,768,3568
26801,1298,1337,1176,899,1060,973,1118,7861
26802,1271,1175,1345,1382,1405,1401,1357,9336
26804,849,699,772,582,566,561,709,4738
26807,2695,2803,2816,2886,2886,2987,2947,20020
26808,903,676,678,765,705,849,967,5543
26810,517,440,488,205,192,172,329,2343
26812,1243,1639,1351,1537,1973,2033,1705,11481
26814,372,389,315,396,471,434,415,2792
26815,760,732,704,702,618,515,646,4677
26817,280,315,411,422,405,317,443,2593
26818,1127,900,885,1061,1183,934,709,6799
26823,318,365,378,159,143,109,198,1670
26833,2480,2383,2244,2411,2393,2187,2309,16407
26836,6694,6585,6527,6659,6544,6992,6578,46579
26845,603,512,561,731,728,564,898,4597
26847,6299,6680,6872,6476,6393,6699,6277,45696
26851,2163,2184,2471,2500,1843,1778,2180,15119
26852,782,775,795,817,911,957,869,5906
26855,629,612,617,694,714,801,826,4893
26865,123,130,159,145,125,270,248,1200
26866,759,833,910,923,956,989,929,6299
26884,569,740,618,621,675,757,625,4605
27006,14036,14136,14168,14162,13802,13764,14150,98218
27007,2241,2195,2224,2192,2101,1874,2162,14989
27009,2344,2402,2680,2884,2997,3038,2647,18992
27011,5499,5745,5385,5242,5232,5777,5497,38377
27012,26050,25699,25703,25998,25957,26509,25461,181377
27013,6105,6086,7057,6605,6053,6066,6057,44029
27014,766,750,662,716,786,724,840,5244
27016,1661,1747,1772,1936,1956,1780,1936,12788
27017,9360,9399,8997,9221,9794,9619,9597,65987
27018,7508,7438,7778,7997,7856,7544,7655,53776
27019,3781,4069,4051,3676,3305,3482,4032,26396
27020,6083,5766,6079,6147,6753,6467,6421,43716
27021,17735,17312,17409,16866,17622,18199,18106,123249
27022,1553,1524,1971,1878,1948,1701,1560,12135
27023,12914,12630,11913,11191,11159,10710,11873,82390
27024,2769,2773,2636,2770,2689,2436,2733,18806
27025,11293,11226,11549,11722,11541,11529,11138,79998
27027,4575,4433,4689,4313,4305,4049,4385,30749
27028,26359,26050,26124,25891,25805,25817,25839,181885
27030,37145,37517,38064,37923,37914,38260,38374,265197
27040,11261,11049,11075,11848,11409,11246,10893,78781
27041,8058,8329,8532,8139,7444,6897,7554,54953
27042,670,618,596,641,615,656,834,4630
27043,6986,6754,6533,6225,6300,6428,6615,45841
27045,8865,8558,8893,8664,8661,9042,8536,61219
27046,2131,2249,2225,2140,2354,2005,2024,15128
27047,968,875,816,1099,1079,1017,1191,7045
27048,8615,9003,8611,8679,8476,8578,8609,60571
27050,4040,4225,4323,4365,4495,3993,3893,29334
27051,8246,8380,8177,7979,7092,6722,7369,53965
27052,10020,10441,9905,10646,10700,11259,10624,73595
27053,2811,2879,2938,3481,3346,3454,3007,21916
27054,2152,2066,1756,2059,2363,2283,2567,15246
27055,14011,14081,14142,13858,13589,13849,14200,97730
27101,18623,18641,17582,17454,17758,16903,18901,125862
27103,35687,37201,36505,36396,33713,32006,33208,244716
27104,29439,28507,28487,28466,28056,28365,28485,199805
27105,40596,41083,41820,40544,41083,40233,39568,284927
27106,47610,46876,45783,44932,45540,45156,45015,320912
27107,47093,46499,47351,46649,46962,47274,46963,328791
27109,2475,2435,2474,2470,2525,2566,2539,17484
27110,2138,2020,1913,1729,1606,1447,2127,12980
27127,37762,37298,36037,35007,33831,33669,34138,247742
27201,69,61,63,37,45,67,63,405
27203,21777,21602,21682,21009,20917,20852,21108,148947
27205,34009,34654,33353,33782,33252,33384,33216,235650
27207,3374,3519,3537,3583,3622,3441,3795,24871
27208,1867,1827,1757,1797,1827,1616,1676,12367
27209,4530,3905,3566,3865,4369,4197,3933,28365
27212,1915,1957,1986,2094,2535,2640,2580,15707
27214,10537,11583,12341,11376,11587,11323,10294,79041
27215,40111,40467,40322,40894,39630,37442,38807,277673
27217,37009,36307,35258,34354,35155,36801,36954,251838
27229,3440,3948,3739,4455,4399,4090,3929,28000
27231,1674,1679,1709,1738,1892,1876,2148,12716
27233,3054,2984,2974,3424,3447,3437,3390,22710
27235,4191,4024,4266,4456,4476,4631,4136,30180
27239,8953,8391,8693,9255,9471,9194,9079,63036
27242,2103,1732,1862,1607,1882,2014,2100,13300
27243,4335,4484,4239,4186,4130,3580,4337,29291
27244,14507,14168,14010,13976,13967,14285,14173,99086
27248,4707,4483,4929,4806,4570,4629,4524,32648
27249,13131,13047,12750,12596,11897,11657,12486,87564
27252,2715,2712,2589,2324,1872,2482,2003,16697
27253,29369,29416,28937,28303,29069,28913,29827,203834
27258,6565,6692,6749,6697,6534,6301,6006,45544
27260,25361,24194,23964,23524,23795,23107,24023,167968
27262,23654,23766,24632,24635,24534,24885,23934,170040
27263,22091,22394,21574,22058,21636,21427,21414,152594
27265,49886,49024,47561,46659,45688,44619,46690,330127
27278,25217,25112,23936,23690,23505,23897,24286,169643
27281,3017,3171,2648,2361,2432,2310,3100,19039
27282,17092,17168,16856,16342,16332,16340,15906,116036
27283,2871,2782,2872,3124,3326,3403,3141,21519
27284,52849,50981,51506,51849,51114,50685,51136,360120
27288,23181,23329,23434,23445,23633,24196,24071,165289
27291,1525,1389,1510,1706,1821,1743,1662,11356
27292,39016,39486,39038,38451,38548,38872,39787,273198
27295,38264,38622,38460,38122,37680,37180,37211,265539
27298,9660,9467,8936,8969,8896,9111,10336,65375
27299,5388,5320,5037,5089,5388,5112,5190,36524
27301,8913,8625,9206,9065,9982,8974,8750,63515
27302,30315,28686,28171,28030,26889,26298,26412,194801
27305,1764,1982,1885,1668,1693,1558,1685,12235
27306,6065,6034,6661,6573,6398,6721,6176,44628
27310,7225,7099,6801,6635,6738,6557,6710,47765
27311,3631,3638,3592,3588,3470,3602,3402,24923
27312,20009,19179,19041,18415,18500,18395,18306,131845
27313,6817,7291,7239,6793,6876,7344,6962,49322
27314,1153,1396,1585,1495,1373,1029,1051,9082
27315,1991,2108,2269,2273,2001,2115,2243,15000
27316,7414,7094,6812,6863,6817,6525,6650,48175
27317,16239,16134,16856,16383,17005,16413,16959,115989
27320,38807,38727,38760,38920,39080,39232,39351,272877
27325,5896,6117,6360,6902,6838,7118,6704,45935
27326,3029,3012,3325,3732,3953,3680,4008,24739
27330,40378,39401,39172,39824,38982,38265,37947,273969
27332,30060,30344,30942,29972,29402,28564,30236,209520
27340,69,68,42,33,26,0,120,358
27341,6171,6287,6003,6324,6105,6292,5360,42542
27343,1947,1635,1569,1615,1644,1476,1716,11602
27344,18617,18546,17926,18409,18552,18588,18022,128660
27349,5467,6227,6784,6589,6232,5787,5511,42597
27350,6141,6334,6500,6936,6328,6647,6530,45416
27355,2741,2678,2724,2583,2376,2725,2660,18487
27356,3231,3384,3219,2903,2749,2860,3205,21551
27357,7701,7410,7106,7120,7434,7336,7894,52001
27358,14583,15075,15101,14998,15048,15060,14075,103940
27360,46925,46623,46792,46756,47157,46690,46084,327027
27370,14429,14185,14336,14002,14754,14809,15052,101567
27371,8825,8902,8892,7996,8225,8286,8132,59258
27376,8748,9108,9400,9810,9873,10162,9386,66487
27377,7562,7752,7447,7777,7332,7397,7104,52371
27379,5509,5566,5427,4999,4882,4881,4661,35925
27401,20816,21227,20727,20668,20643,19789,21932,145802
27403,21751,21711,21944,21680,21602,21986,21958,152632
27405,48131,46326,45904,45319,43758,43400,44567,317405
27406,60297,58381,57048,55645,54292,53792,56458,395913
27407,50032,50279,48443,48545,47955,46986,46242,338482
27408,18258,18059,18039,18279,18291,18174,17296,126396
27409,16669,16902,16249,15889,15240,14836,15621,111406
27410,55099,54195,53699,52812,51890,50982,52388,371065
27455,29553,29398,29294,29384,28989,28767,28706,204091
27501,20662,19201,18121,17425,16741,16247,17571,125968
27502,36288,34428,33385,32139,31178,29921,30831,228170
27503,6246,6244,6327,6597,6389,6242,3471,41516
27504,14735,15074,14891,15230,14983,15279,14566,104758
27505,6063,5980,5331,5636,5213,4946,5896,39065
27507,1497,1348,1429,1114,1466,1535,1929,10318
27508,1651,1658,1802,2230,2441,2374,2053,14209
27509,6158,6095,5253,5049,5084,5476,10167,43282
27510,15494,15168,15389,15008,14762,14539,14644,105004
27511,34585,34393,33897,33613,33341,32881,32029,234739
27513,43436,42637,41090,40929,40296,40414,40755,289557
27514,31764,32446,32295,31746,31576,31928,32110,223865
27516,40515,39231,38971,38026,37212,35376,36139,265470
27517,24099,23613,23473,23853,23701,22794,23346,164879
27518,20657,20923,21348,20896,20030,19169,19630,142653
27519,50044,47083,44115,41366,38661,35620,39178,296067
27520,39172,39363,39804,37689,36657,35873,36357,264915
27521,6397,6620,6426,6587,5967,5673,6035,43705
27522,11624,11520,11928,12001,12132,11551,12335,83091
27523,10942,11578,10829,9901,9390,8691,9552,70883
27524,13820,12489,11978,11674,11372,10992,12338,84663
27525,14679,14184,13166,12918,12972,13060,13338,94317
27526,43455,44119,42278,41460,40323,38369,38894,288898
27527,20648,19510,19298,18291,17799,17128,18216,130890
27529,46779,45519,43809,43259,42161,40949,42128,304604
27530,40459,39504,40378,40861,41043,40340,40117,282702
27531,478,466,485,479,479,503,594,3484
27534,33418,32948,31768,32121,31762,31141,31364,224522
27536,16685,16160,16203,16032,15968,16627,17289,114964
27537,24816,25678,25888,25943,26282,25631,24319,178557
27539,22080,22099,20683,19282,18614,17916,18692,139366
27540,34341,33221,31732,30415,28604,27037,29363,214713
27541,4085,3931,4210,4295,3818,3930,3770,28039
27542,9400,8497,8891,8701,8404,8813,9133,61839
27544,4564,4684,4519,4067,4158,3932,4449,30373
27545,25677,25596,24529,24266,23302,22170,23006,168546
27546,20288,20144,20491,19613,20091,19621,19471,139719
27549,24561,24741,24691,24784,24942,24817,24112,172648
27551,1803,2067,2171,2299,2316,2311,1962,14929
27553,2371,1950,2139,2134,2231,1780,2937,15542
27555,661,603,468,365,338,390,441,3266
27556,162,239,277,261,349,350,346,1984
27557,6830,6284,6303,5921,5736,6529,7509,45112
27559,2300,2341,2169,2466,2208,1772,2288,15544
27560,28312,26187,24959,23491,22148,20828,22623,168548
27562,1806,1565,1650,1722,1770,2052,1938,12503
27563,5034,5270,5354,4968,4312,5211,5008,35157
27565,25568,25210,26553,27392,28253,27346,25255,185577
27568,585,633,602,459,384,383,480,3526
27569,7857,7701,7962,7494,7211,7818,8022,54065
27571,5660,5186,4773,4291,3975,3623,3893,31401
27572,7063,7357,7016,6818,6805,6661,6546,48266
27573,11339,11155,11033,10821,11078,11404,11414,78244
27574,14037,14742,14618,15048,14806,15351,14373,102975
27576,17850,17111,16431,16250,16391,16422,17091,117546
27577,24621,24671,24453,25260,24664,23081,22911,169661
27581,4727,4899,4613,4887,5254,5316,3049,32745
27582,143,162,137,130,111,194,289,1166
27583,6725,6296,6800,6829,6920,6410,6921,46901
27587,61679,59691,56996,53860,52521,49861,53078,387686
27589,8672,8189,8210,8734,9350,8718,8370,60243
27591,19589,20229,20939,21064,20492,20868,19589,142770
27592,16234,15882,15768,16151,14956,14615,15244,108850
27596,17898,17056,16565,16242,15059,14458,15619,112897
27597,22943,23496,23895,24140,23154,22487,22181,162296
27601,10089,9975,9547,9766,9514,8781,9450,67122
27603,51127,50319,48680,46175,45416,43601,47033,332351
27604,44938,43667,42572,41400,40644,40384,42204,295809
27605,4880,4544,4627,4628,4472,4725,4495,32371
27606,46393,44805,44752,44261,44058,42590,43210,310069
27607,29014,28571,28279,28324,27912,27367,25188,194655
27608,11361,11062,11002,10644,10451,10301,10429,75250
27609,33192,32884,32407,32097,32260,32336,32964,228140
27610,73925,73830,71267,68776,67170,65606,65648,486222
27612,37115,36245,35083,35127,34825,34520,35028,247943
27613,43972,43845,44365,43216,42944,42346,42690,303378
27614,32996,32948,33159,32764,31881,30804,31516,226068
27615,43140,42421,41909,42364,41266,40404,42166,293670
27616,50392,48004,46826,46074,45028,44014,42294,322632
27617,17392,16503,15793,15312,14571,13957,15199,108727
27701,22595,21760,20202,20762,20222,20679,21288,147508
27703,47381,47697,47144,45204,42845,41580,41937,313788
27704,35893,36509,35067,34517,34058,32861,34517,243422
27705,49479,47942,48471,48684,46833,45889,46282,333580
27707,50037,48731,47873,46299,45528,44280,45023,327771
27709,1149,909,734,822,658,488,1047,5807
27712,20821,20710,20844,20804,20133,19622,20035,142969
27713,52169,50295,48846,46824,46540,46017,46660,337351
27801,20713,21095,21892,21860,21658,22025,21740,150983
27803,19091,19556,20262,20729,20824,20869,21227,142558
27804,30081,29381,29358,29397,29033,28947,29058,205255
27805,4077,3816,3587,3722,3580,3666,3992,26440
27806,2629,2428,2677,2528,2543,2576,2331,17712
27807,6772,6701,7006,7205,6646,6396,6629,47355
27808,1884,2079,2190,1975,2209,2406,2225,14968
27809,4572,4801,4143,3870,4405,4224,5091,31106
27810,4226,4338,4318,4175,3943,4310,4377,29687
27812,2567,2942,2873,2929,2565,2139,2593,18608
27813,699,664,717,703,695,691,747,4916
27814,2019,1728,1520,1523,1277,1269,1676,11012
27816,2281,2471,2298,2198,2549,2434,2516,16747
27817,6963,6851,6809,6917,7335,7248,7358,49481
27818,1242,1485,1568,1651,1735,1855,1344,10880
27819,246,352,420,371,428,637,330,2784
27820,2571,2797,3093,2960,2544,3156,3088,20209
27821,249,229,228,205,434,480,358,2183
27822,7894,7984,8195,8082,8429,8348,8143,57075
27823,7953,7778,7135,7472,7371,7719,8201,53629
27824,2132,2147,2232,2064,1954,1710,1476,13715
27825,58,62,61,85,71,101,103,541
27826,1263,1308,949,963,885,865,1379,7612
27827,23,41,35,52,51,42,33,277
27828,8454,8123,8345,8807,8035,8257,9071,59092
27829,1644,1876,1906,1934,1972,1823,1930,13085
27830,4787,4808,5030,4708,5312,4676,4755,34076
27831,3626,3533,3550,3871,3590,3088,3908,25166
27832,3070,2849,2638,2428,2969,2848,2847,19649
27834,56723,54990,54641,54699,54429,53301,52914,381697
27837,6561,6602,5945,5928,6254,5677,5903,42870
27839,3552,3793,3758,4145,4387,4382,4001,28018
27840,506,485,437,400,437,530,514,3309
27841,37,38,34,50,54,64,84,361
27842,1324,1421,1486,1559,1358,1082,1493,9723
27843,1570,1486,1585,1389,1335,1039,1157,9561
27844,3235,3110,3415,3199,3233,3256,2950,22398
27845,2881,2811,2626,2712,2736,2225,2394,18385
27846,3361,3460,3423,3228,3067,3194,2988,22721
27847,631,857,764,1003,983,1018,936,6192
27849,1592,1492,1560,1525,1643,1900,1544,11256
27850,6640,6911,7112,7222,6899,7605,7247,49636
27851,5416,5330,5266,5456,5093,4988,5268,36817
27852,3178,3191,2749,2712,2449,2564,2977,19820
27853,268,452,594,659,726,961,673,4333
27855,5985,5880,5861,5717,6139,6377,6456,42415
27856,16797,16781,16322,16898,16597,16169,17141,116705
27857,1129,1328,1225,1243,1436,1368,1298,9027
27858,58254,58779,57994,56930,55793,54875,55781,398406
27860,2039,2441,2670,3001,3176,2598,2246,18171
27861,67,87,106,88,96,104,71,619
27862,648,635,658,738,857,1086,877,5499
27863,12016,11877,12088,12174,11736,12042,11735,83668
27864,4628,4692,5205,4783,4902,4491,4779,33480
27865,2483,2166,2165,1828,1780,1936,1927,14285
27866,688,620,720,701,743,795,855,5122
27869,2212,2267,2378,2251,2558,2220,2258,16144
27870,26985,26918,27218,27436,27352,26965,27236,190110
27871,4220,3878,3991,4416,4178,4452,4619,29754
27872,391,349,379,324,317,398,375,2533
27873,570,493,436,331,424,461,397,3112
27874,3681,4417,4540,4556,4841,5180,4861,32076
27875,568,272,421,543,500,602,517,3423
27876,1306,1562,1558,1596,1606,1806,1302,10736
27878,2084,2037,1805,1685,1898,2029,1931,13469
27879,263,256,272,289,279,233,311,1903
27880,3192,3518,3383,3232,3084,3257,3304,22970
27881,133,159,75,79,79,74,61,660
27882,7527,7227,7368,7120,8121,8423,7413,53199
27883,3201,3507,3551,3365,3474,3186,3565,23849
27884,1108,916,944,792,842,895,1282,6779
27885,1076,1251,1205,1255,1449,1523,984,8743
27886,21303,21370,21424,22146,22263,22522,21591,152619
27888,2577,2574,2405,2619,2534,2849,2560,18118
27889,26818,26959,27331,27250,26911,27335,27468,190072
27890,2500,2505,2602,2514,2646,2412,2521,17700
27891,5076,5233,5346,5228,5583,5194,5227,36887
27892,14195,14281,14543,14575,14854,14461,15182,102091
27893,39294,39858,40023,40788,40667,40790,39723,281143
27896,21001,20895,21185,20323,19778,19314,20130,142626
27897,1793,1797,1785,2018,2151,2623,2265,14432
27909,39940,40050,40307,40468,40605,40574,40699,282643
27910,11828,11586,11975,11945,11839,11400,12007,82580
27915,830,926,949,839,577,502,777,5400
27916,737,531,486,555,316,468,747,3840
27917,1000,902,1107,1063,1171,864,833,6940
27919,1059,929,948,908,1016,1045,1130,7035
27920,1192,1258,1272,1339,882,990,1326,8259
27921,4959,4757,4712,4592,5004,5003,4805,33832
27922,895,992,858,969,958,860,1030,6562
27923,517,456,367,362,262,266,598,2828
27924,2572,2397,2320,2633,2649,3289,3140,19000
27925,4043,4036,4044,4096,4185,4120,4217,28741
27926,1682,1457,1717,1570,1556,1860,1915,11757
27927,735,813,808,857,639,726,542,5120
27928,1888,2136,2469,2368,2389,2720,1986,15956
27929,1248,1026,1165,1300,1261,1359,1166,8525
27932,12278,12473,12382,12535,12970,12974,12562,88174
27935,1612,1600,1488,1494,1338,1414,1698,10644
27936,1223,1163,1013,1073,1046,712,1091,7321
27937,4353,4256,3991,4051,4248,4099,4333,29331
27938,1349,1407,1528,1490,1495,1679,1505,10453
27939,2370,2592,2613,2667,2810,3056,2361,18469
27941,640,646,382,531,601,491,536,3827
27942,951,1015,734,644,837,830,901,5912
27943,481,466,388,264,543,345,504,2991
27944,12066,12100,12231,12235,11998,11737,11909,84276
27946,1047,1415,1656,1760,1683,1528,1207,10296
27947,1729,1595,1482,1324,1291,1137,1230,9788
27948,11071,11173,10891,10795,10423,10885,10862,76100
27949,7193,7154,7017,6995,6996,7115,6947,49417
27950,2148,2071,2126,2298,2196,2272,2006,15117
27953,1331,1365,1302,1052,1273,1137,1021,8481
27954,6788,6334,6300,6358,6864,6806,6111,45561
27956,469,311,178,178,277,280,340,2033
27957,1684,1825,1749,1569,1535,1312,1356,11030
27958,10326,10304,10242,9800,9738,9574,10144,70128
27959,2869,2827,2807,2802,2802,2819,2789,19715
27960,405,486,556,594,591,619,948,4199
27962,7591,7343,7063,7055,6999,7247,7792,51090
27964,653,742,526,468,449,415,545,3798
27965,732,701,694,528,626,605,527,4413
27966,805,967,1274,1105,1064,1200,1052,7467
27967,256,309,245,219,270,360,366,2025
27968,195,270,282,287,339,405,298,2076
27970,2995,3179,3347,3497,3661,3164,3409,23252
27972,229,240,248,251,52,113,244,1377
27973,1146,1246,1187,1310,1255,1135,1323,8602
27974,1289,1370,1518,1513,1446,1401,1285,9822
27976,3558,3591,3398,3417,3182,3050,3449,23645
27978,169,147,243,274,221,162,225,1441
27979,1742,1787,1759,1776,1930,1659,1719,12372
27980,2110,2115,2066,2065,1811,1945,2182,14294
27981,1536,1475,1753,1864,1934,1767,1643,11972
27982,80,65,65,96,67,61,82,516
27983,9814,10188,10722,10545,10848,10252,10416,72785
27985,343,339,321,343,263,315,283,2207
27986,3068,3098,3166,3274,2538,2403,2430,19977
28001,26498,26717,26433,26386,26339,26382,26760,185515
28006,1418,1278,1175,1273,1242,1237,1130,8753
28007,664,687,622,644,667,643,611,4538
28009,1108,1092,982,831,897,1025,1121,7056
28012,21381,20865,20453,20637,20920,20356,20048,144660
28016,12971,12936,12560,13072,13138,13368,13463,91508
28017,701,689,690,691,693,711,695,4870
28018,5241,5408,5511,5910,6179,6031,5562,39842
28019,0,0,0,0,75,81,123,279
28020,1714,1856,1861,2088,2333,2565,2322,14739
28021,13742,13574,12897,12285,12610,12729,13612,91449
28023,15005,14689,14068,14321,13691,13463,14175,99412
28025,51954,51996,51061,50140,49494,49884,49160,353689
28027,61133,58474,56990,56586,55688,53019,55435,397325
28031,26686,25834,25223,24805,23960,22993,24390,173891
28032,3296,3298,3183,2961,2926,2711,3105,21480
28033,3271,3358,2579,2626,2473,2911,2749,19967
28034,17756,17441,18047,17293,17068,16144,16642,120391
28036,16875,16009,15335,15034,14837,13994,14654,106738
28037,19954,18822,18336,18080,17754,16845,18287,128078
28039,79,103,100,90,96,105,116,689
28040,8064,8023,7876,7605,7694,7233,7969,54464
28043,20952,21472,22066,22206,21846,22079,21055,151676
28052,34847,34764,35550,35400,34924,35311,34932,245728
28054,37387,36934,35722,35058,34956,34178,36270,250505
28056,33235,32973,32669,32599,32637,32912,31418,228443
28071,2920,2995,3036,3395,3310,3394,2802,21852
28072,1047,1157,1242,1353,1347,1597,1357,9100
28073,5552,5602,5852,5568,4975,5101,5621,38271
28075,17265,16936,16508,15932,16050,15552,16143,114386
28076,614,812,847,1060,1003,875,722,5933
28077,505,427,382,385,291,273,482,2745
28078,57274,56105,54616,52776,51715,50130,52133,374749
28079,34282,33008,32573,32322,31918,31490,31979,227572
28080,8034,8078,7965,8383,7907,7704,7299,55370
28081,27087,26798,26845,25527,25359,23609,25190,180415
28083,24696,24270,23332,23618,23161,24214,23820,167111
28086,25579,25261,25600,26564,26308,25904,25895,181111
28088,2798,2975,3128,2877,2809,2905,2862,20354
28089,240,237,208,219,222,189,248,1563
28090,7839,7803,8979,8035,8291,8824,8342,58113
28091,2106,1935,2010,2075,2320,2472,2158,15076
28092,37727,38552,38795,38278,38145,38171,38570,268238
28097,5416,5458,5573,5759,5901,6106,5369,39582
28098,3673,3668,3723,3723,3701,3613,3579,25680
28101,749,751,678,628,551,542,698,4597
28102,68,87,80,100,101,102,78,616
28103,10925,10727,10222,10024,9890,10412,10311,72511
28104,29944,30750,30282,29378,28752,27358,28040,204504
28105,44573,42704,41882,40529,39354,38946,39586,287574
28107,7463,7047,7106,7136,6940,6699,6422,48813
28108,101,101,86,76,40,0,54,458
28109,389,361,292,301,290,489,387,2509
28110,53063,51834,52108,51733,50264,49679,50365,359046
28112,26404,27023,26362,26162,26263,25201,26311,183726
28114,7999,7751,7267,7015,6823,6767,7554,51176
28115,35679,34912,34226,33908,33493,33002,34339,239559
28117,37347,36351,36210,36076,34878,34776,35454,251092
28119,3400,3530,3580,3635,2883,2822,2801,22651
28120,19710,20066,20193,20253,20200,20853,19807,141082
28124,5950,6115,5945,6285,5922,6217,6622,43056
28125,2179,2045,2180,2536,2544,2522,2525,16531
28127,7593,7306,7836,8078,8005,7898,7594,54310
28128,7237,7000,6551,6753,6658,6411,7476,48086
28129,5570,5454,5620,5493,5538,5528,5399,38602
28133,2301,2361,2558,2783,2980,2779,2878,18640
28134,10458,10422,10000,9998,9255,9415,9453,69001
28135,6260,6377,6099,6051,5872,5739,6123,42521
28137,3195,3498,2987,3167,3052,2743,3120,21762
28138,9386,9494,9978,9846,10587,10797,10495,70583
28139,19516,19506,19302,18931,19715,19040,20111,136121
28144,25030,25039,25414,25406,25159,24273,24734,175055
28146,27006,26666,26818,26585,26597,26757,27614,188043
28147,25646,25876,25522,25337,25923,26553,24697,179554
28150,28176,28416,28250,28289,28173,27238,28098,196640
28152,25060,24361,24353,25209,25668,25862,24735,175248
28159,3007,3078,3093,3169,3202,3204,3108,21861
28160,3704,3881,3832,3771,3681,3890,3929,26688
28163,5599,5757,6152,5980,5689,5602,5233,40012
28164,14470,14200,13838,13172,13153,12633,14085,95551
28166,9816,9310,8941,9089,8772,8483,8619,63030
28167,2661,2239,2444,2626,2498,2933,2362,17763
28168,10431,10171,10508,11391,10989,10767,10230,74487
28169,131,143,150,133,207,180,173,1117
28170,11171,11237,11377,11356,11888,12242,12355,81626
28173,52656,49606,47234,45200,45304,43243,45097,328340
28174,9360,9329,9305,9259,8371,8562,8608,62794
28202,11993,11602,10562,10383,9565,8504,11195,73804
28203,14820,13657,13143,12345,11921,11010,11315,88211
28204,5847,5841,5526,5231,5235,4801,4796,37277
28205,46507,46904,46071,45160,43299,42087,43931,313959
28206,12627,12305,12030,11962,11354,10561,11898,82737
28207,9621,9666,9729,9360,9178,8682,9280,65516
28208,36328,35340,34641,34474,35156,34533,34167,244639
28209,21842,22221,21820,21578,21224,20372,20317,149374
28210,47169,45485,44532,42603,42313,42607,42263,306972
28211,30126,29566,29508,29400,28349,27899,28523,203371
28212,42613,42007,40451,40012,38553,36215,38457,278308
28213,38650,37556,37493,36935,36484,36581,37309,261008
28214,38170,36328,34937,33696,34146,33949,34721,245947
28215,57230,56339,55171,54896,54362,52280,53629,383907
28216,50908,50505,49144,48172,47086,46512,47208,339535
28217,28331,28415,27577,28097,26723,26328,24204,189675
28226,39052,38606,37557,37412,36844,36210,37286,262967
28227,55225,54415,53483,51870,50574,49700,49635,364902
28244,0,0,0,0,0,0,0,0
28262,43305,42101,41498,40008,39905,37701,37547,282065
28269,77321,76360,76365,74667,72749,72763,71048,521273
28270,32993,32716,32653,32494,32131,31781,31525,226293
28273,36746,34450,33755,32618,31113,30552,31478,230712
28277,67692,67095,64394,60794,59365,59073,59664,438077
28278,24109,22888,22485,21918,20905,19437,19283,151025
28280,0,0,0,0,0,0,10,10
28282,0,0,0,0,0,0,0,0
28301,18264,17991,17781,17749,17903,18099,17165,124952
28303,29441,29197,28717,29284,29486,29557,30909,206591
28304,37234,37207,37499,38400,38048,37548,37147,263083
28305,5845,6123,6002,6179,5931,5905,6073,42058
28306,42293,43200,42410,41324,40524,38952,39683,288386
28307,17714,18110,19382,19622,19690,19368,17631,131517
28308,399,366,371,293,298,408,405,2540
28310,3778,3731,4184,4534,5024,5886,3459,30596
28311,35146,34364,34645,33727,32851,32264,34567,237564
28312,18656,18645,18561,18201,17471,17191,18538,127263
28314,54950,54109,53208,52916,52612,52631,54520,374946
28315,14071,13478,12748,12423,11601,11334,11681,87336
28318,5188,4953,5127,4704,4856,4661,4627,34116
28320,9580,9490,9169,9028,9866,9568,9229,65930
28323,3970,3769,3413,3594,3463,3023,3182,24414
28325,546,503,485,661,557,613,508,3873
28326,20875,20358,18917,17733,16999,16398,17646,128926
28327,15468,15394,15627,15333,14701,14781,15433,106737
28328,28548,28801,28119,28150,27095,27004,27042,194759
28330,459,534,505,368,349,279,346,2840
28332,542,597,524,485,450,309,482,3389
28333,10432,10418,10704,11103,11493,11539,11830,77519
28334,25616,25533,25130,25216,25118,25003,24908,176524
28337,10132,10713,10296,10065,9851,10062,10670,71789
28338,4436,4590,4635,4756,4713,4686,4607,32423
28339,7246,7049,6747,6574,6945,7205,6751,48517
28340,10321,10355,10573,10622,10901,10966,10765,74503
28341,4500,3881,4261,4076,4373,3940,4257,29288
28342,237,252,314,348,369,402,298,2220
28343,1509,1556,1595,1609,1666,1670,1685,11290
28344,3785,3695,3473,3100,2895,2659,3415,23022
28345,11940,12484,12609,12790,12629,13108,12592,88152
28347,2226,2094,1807,1696,1478,1414,1983,12698
28348,34428,33606,33385,33279,32928,32230,33307,233163
28349,3552,4085,4122,4277,3779,3726,3724,27265
28350,220,186,223,398,316,249,305,1897
28351,4498,4078,4152,3932,3866,3599,4759,28884
28352,25851,26029,25861,26153,26233,26513,25641,182281
28356,4970,4945,5166,5038,5036,4919,5018,35092
28357,2840,3401,3145,3133,3079,2810,3125,21533
28358,39812,39398,39648,39108,39058,38974,38738,274736
28360,14886,14986,15775,16156,16183,16405,14263,108654
28363,1486,1446,1507,1373,1516,1409,1202,9939
28364,15002,15391,15311,15169,15767,15427,14809,106876
28365,17459,18148,18545,17615,16839,16157,17144,121907
28366,5076,5584,5676,5095,5226,5650,5061,37368
28367,57,97,97,117,135,101,87,691
28369,2594,2712,2532,2664,2418,2425,2652,17997
28371,7421,6769,6744,6628,6602,7112,6519,47795
28372,13967,13524,13513,13271,12586,12294,14783,93938
28373,2701,2591,2572,2469,2431,2268,2150,17182
28374,17088,16970,16816,16359,15382,14512,15990,113117
28375,121,167,166,112,92,76,102,836
28376,42385,41682,40905,39260,38377,36402,37991,277002
28377,13032,12919,13640,13827,13660,13875,12666,93619
28379,25252,25141,25463,25745,26181,26023,26388,180193
28382,6239,6443,6976,7326,7548,8019,7056,49607
28383,8874,8612,7734,7320,6828,7074,8080,54522
28384,11459,12074,11860,12174,12060,10953,12097,82677
28385,2650,2595,2661,2505,2613,2674,3029,18727
28386,6225,6031,5681,5834,5984,6047,6319,42121
28387,14524,14293,14028,13980,14750,14353,13921,99849
28390,23905,23265,22713,21876,21122,19994,19942,152817
28391,5403,5430,5419,5396,5602,5619,5302,38171
28392,1537,1331,1362,1209,988,1472,1579,9478
28393,1630,1468,1695,1556,1607,1628,2005,11589
28394,5653,5428,5570,5645,5653,5255,5164,38368
28395,2504,2524,2526,1953,2230,1920,2375,16032
28396,2912,2986,2937,3063,2951,2966,2732,20547
28398,7877,7379,7376,7506,7024,7252,8112,52526
28399,1943,1878,2122,2047,2172,2439,2140,14741
28401,23203,22175,22229,22630,22661,23560,22094,158552
28403,40477,40045,39774,38319,37161,35438,36063,267277
28405,31569,30675,29388,29021,28214,28120,29152,206139
28409,32556,31845,31253,30855,30813,30424,31296,219042
28411,34494,33492,32274,32182,31821,30873,31962,227098
28412,37064,37550,36619,35602,35002,34822,35573,252232
28420,3746,3464,3364,3548,3878,3881,3886,25767
28421,1478,1423,1354,1109,1252,1072,1521,9209
28422,7931,7725,7595,6712,6490,6080,6641,49174
28423,2545,2560,2491,2499,2474,2366,2290,17225
28424,38,53,58,61,74,42,128,454
28425,11742,11842,11962,11984,11807,11146,10906,81389
28428,6517,6354,6381,6175,6044,5954,6033,43458
28429,8218,8697,8820,9039,9019,8708,8026,60527
28430,1928,1479,1461,1550,1721,2197,1900,12236
28431,6606,6704,6214,6091,6081,6396,7102,45194
28432,2108,2370,2049,1778,1992,2253,1968,14518
28433,4887,4935,4777,4955,4732,4533,5050,33869
28434,1392,1177,1561,1370,1326,1671,1329,9826
28435,2020,2363,2330,2289,2505,2563,2490,16560
28436,1977,1972,2228,2170,2210,2084,2203,14844
28438,1694,1667,1603,1646,1578,1619,1845,11652
28439,1576,1688,1901,1818,1587,1351,1595,11516
28441,3414,3901,3565,3791,3341,3428,3198,24638
28442,1581,1608,1486,1208,1146,1042,1647,9718
28443,20584,18539,18443,17769,16703,15251,17512,124801
28444,1909,1685,2350,2609,2932,2622,2085,16192
28445,6539,7148,7312,6412,6384,5642,5676,45113
28447,1647,1932,1908,1936,1544,1618,1391,11976
28448,781,1045,1026,1149,1104,1124,1243,7472
28449,1866,1902,1895,1643,1627,1513,1692,12138
28450,2609,2548,2361,2369,2379,2399,2438,17103
28451,31308,30879,29003,28304,27841,26629,27112,201076
28452,1130,977,1054,883,982,612,694,6332
28453,3807,4244,4685,4714,5001,4702,3829,30982
28454,2207,2087,1942,1813,1913,2090,2545,14597
28455,1656,1684,1773,1865,2118,2223,2117,13436
28456,3717,3626,3334,3453,3511,3439,3658,24738
28457,10326,10248,9696,10031,9719,10327,9905,70252
28458,6968,6672,5882,5745,5577,5630,6444,42918
28460,10277,9966,9364,8583,8180,7293,7652,61315
28461,18322,17230,16376,16040,14842,14508,16126,113444
28462,12020,11541,11768,11380,11844,12039,11680,82272
28463,9686,9351,10204,10837,10915,9415,9799,70207
28464,1896,2121,2569,2345,2615,2689,2457,16692
28465,6919,6781,6753,6700,6927,6889,6531,47500
28466,10887,10880,10869,11194,11296,10861,10103,76090
28467,9358,9519,9592,9319,8798,8248,8703,63537
28468,4472,4434,4437,4351,4435,4396,4375,30900
28469,5825,6129,6208,6293,6393,6803,5839,43490
28470,11566,11026,10341,10221,9694,9452,10644,72944
28472,19254,20026,20723,20915,20387,21138,19658,142101
28478,4082,4360,4328,4112,4517,5098,4588,31085
28479,6248,5927,6000,6174,5458,5380,4903,40090
28480,2546,2540,2525,2511,2504,2519,2473,17618
28501,18875,19849,20442,20785,20797,21159,20389,142296
28504,22194,21538,20533,20832,21468,21027,21642,149234
28508,2386,2750,2311,2822,2573,2799,2737,18378
28510,1289,1285,1269,1262,1614,1567,1502,9788
28511,698,672,718,636,587,536,694,4541
28512,3184,3190,3287,3538,3315,3353,2896,22763
28513,10420,10263,9964,10107,9644,10057,10346,70801
28515,2621,2537,2540,2550,2703,2889,2915,18755
28516,11076,11204,11282,11773,11491,11519,11431,79776
28518,8831,8562,8375,8335,8089,7829,7909,57930
28519,308,295,271,246,251,295,404,2070
28520,416,413,426,345,365,360,327,2652
28521,2480,2270,2148,2248,2312,2313,2287,16058
28523,2441,2704,2574,2392,2441,2474,2456,17482
28524,378,352,378,470,429,407,426,2840
28525,3164,3127,3245,2736,2686,2453,3132,20543
28526,2601,2597,2833,2683,2432,2582,2489,18217
28527,1101,1288,1625,1564,1380,1247,1140,9345
28528,650,765,677,492,388,498,644,4114
28529,2192,2354,2421,2653,2411,2370,2193,16594
28530,6823,6588,7173,7408,7203,6830,7332,49357
28531,1488,1637,1671,1457,1244,1178,1207,9882
28532,23310,23840,24519,24882,25002,25018,23320,169891
28533,2118,2110,1960,1986,1851,2118,2952,15095
28537,117,86,134,174,240,258,137,1146
28538,2384,2456,2257,2195,2238,1986,2175,15691
28539,15910,15344,15063,15202,14977,14928,15469,106893
28540,49890,49097,50022,50745,50280,49662,49252,348948
28543,5059,5197,5409,5287,4602,4811,4699,35064
28544,5329,5211,5630,5561,5773,5399,5368,38271
28546,45220,46041,44893,44364,43723,43102,42696,310039
28547,19493,19194,19019,19145,19363,20747,21884,138845
28551,14521,15185,14809,13804,13632,13794,14093,99838
28552,132,138,188,121,164,150,254,1147
28553,438,312,238,384,338,279,454,2443
28554,295,274,267,249,231,164,243,1723
28555,4583,4790,5196,4868,4969,4856,5175,34437
28556,1318,1295,1147,985,905,705,963,7318
28557,15106,14464,14530,14180,14149,13828,14429,100686
28560,27774,27892,28137,28683,29022,28526,28921,198955
28562,39252,38370,37700,36394,35509,34059,36176,257460
28570,21851,22340,21836,21503,21801,21295,21432,152058
28571,2593,2781,2977,3014,2671,2637,2585,19258
28572,7178,7300,7238,6584,6233,6457,6531,47521
28573,2472,2475,2396,2508,2733,2605,2176,17365
28574,17303,16354,16206,15232,14226,13034,15102,107457
28575,523,515,365,259,210,291,316,2479
28577,495,427,453,592,513,502,522,3504
28578,5885,5686,5474,5596,5652,5974,6363,40630
28579,529,548,608,453,404,443,622,3607
28580,12379,12583,12813,12920,13148,13148,12657,89648
28581,244,214,109,151,163,192,214,1287
28582,2152,2440,2266,1753,1688,1692,1588,13579
28583,191,215,214,288,282,298,281,1769
28584,12164,11442,11827,11372,11444,11005,11396,80650
28585,3904,3835,3706,3818,3642,3400,3942,26247
28586,7935,7942,7393,7275,7101,7457,8218,53321
28587,359,353,419,340,346,379,369,2565
28589,207,281,421,429,347,510,180,2375
28590,24695,24658,24698,23983,23896,22843,23407,168180
28594,3709,3708,3689,3682,3649,3639,3655,25731
28601,49179,48910,48619,48428,49304,50445,50026,344911
28602,29521,29442,29683,29659,28895,29052,28981,205233
28604,7103,6599,6702,6604,6743,6785,6249,46785
28605,3556,3595,3783,3749,3670,3665,3412,25430
28606,1602,1949,2126,1684,1577,1660,2158,12756
28607,35073,34551,34151,33938,33255,32442,33059,236469
28609,5955,6230,5981,5896,5749,5595,5864,41270
28610,10306,9867,10601,9820,9762,8754,9913,69023
28611,1499,1436,1226,1272,1045,880,885,8243
28612,12373,12485,12567,12983,12846,12228,12397,87879
28613,23160,23746,23083,23438,23755,23700,22759,163641
28615,2001,1827,1860,1932,1876,2110,1876,13482
28616,448,463,445,349,344,267,493,2809
28617,2713,2986,2746,2562,2581,2424,2261,18273
28618,2139,2080,1822,1871,1795,1781,2352,13840
28619,1364,1331,1164,1272,1217,1251,1520,9119
28621,10669,10942,10878,10683,10987,11123,10472,75754
28622,1517,1810,1949,2142,2427,2399,2527,14771
28623,1464,1645,1485,1488,1413,1538,1653,10686
28624,1553,1791,1657,1821,1551,1360,1639,11372
28625,38524,38422,37803,36732,36639,35032,36189,259341
28626,2725,2472,2499,2303,1950,2187,2714,16850
28627,1233,1264,1502,1624,1523,1583,1152,9881
28628,319,339,365,320,389,361,479,2572
28629,0,7,8,77,99,103,75,369
28630,20239,20224,20738,20632,20232,21040,20041,143146
28631,699,643,633,622,583,658,637,4475
28634,5327,5690,5627,5727,5996,5456,5225,39048
28635,4073,4534,4440,3920,3704,3648,3901,28220
28636,5015,4829,5628,5900,5950,6612,5522,39456
28637,1725,1770,1578,1596,1493,1225,1746,11133
28638,11128,11324,11658,12223,12019,11850,12302,82504
28640,4720,4712,5237,4940,5020,5077,4719,34425
28642,5884,5887,5729,5939,6090,5836,5745,41110
28643,3576,3830,3569,3751,3165,3267,3521,24679
28644,873,906,854,1216,1266,1343,1494,7952
28645,46323,46312,46474,46444,47037,46458,47703,326751
28646,386,534,564,638,647,658,342,3769
28647,169,190,140,92,140,118,89,938
28649,1587,1397,1721,1397,1082,1062,993,9239
28650,11601,11475,11619,12046,11941,11662,11883,82227
28651,6929,7037,7253,6674,6730,7178,7132,48933
28652,141,104,91,99,98,0,46,579
28654,3802,3656,3789,4111,4072,3899,3495,26824
28655,54642,55053,55239,55330,55894,56730,54996,387884
28657,9287,9394,9646,9663,9275,9707,9488,66460
28658,26429,26344,26362,26148,26406,26546,27022,185257
28659,20038,20251,19909,20539,21065,21820,21134,144756
28660,2365,2406,2389,2339,2170,2377,2249,16295
28662,46,0,16,13,13,12,140,240
28663,589,549,692,709,542,466,614,4161
28665,2496,2377,2511,2462,2744,2400,2571,17561
28666,307,455,477,499,285,252,368,2643
28667,537,441,641,477,567,441,559,3663
28668,482,390,432,377,407,529,300,2917
28669,2721,2557,2780,3273,3482,3682,3146,21641
28670,3368,3223,2957,3308,3148,2672,2719,21395
28671,527,551,535,624,658,677,597,4169
28672,0,0,0,0,35,41,35,111
28673,6140,5696,5820,5707,5440,5590,5919,40312
28675,6683,6618,6402,6122,6312,6088,6621,44846
28676,3988,3578,3456,3351,3338,3386,3483,24580
28677,34333,33789,33068,32557,33547,33166,32940,233400
28678,5231,5470,5321,5253,5307,6004,5226,37812
28679,1940,1879,2085,2129,2277,2487,2064,14861
28681,26829,27302,26382,25727,25679,24643,25910,182472
28682,1107,1074,1076,996,1115,1182,1129,7679
28683,1389,1736,1666,1958,1788,1930,1697,12164
28684,2498,2337,2425,2459,2753,2204,2141,16817
28685,1757,1661,1740,1484,1561,1638,2076,11917
28689,1326,1290,1619,1921,1806,1906,1712,11580
28690,8991,8858,9058,9238,9172,9002,9295,63614
28692,3921,3978,3715,3593,3671,3503,4067,26448
28693,1346,1450,1511,1415,1508,1596,1700,10526
28694,7368,7298,7249,7733,8163,7816,7744,53371
28697,13151,12916,12594,12899,12790,12479,12930,89759
28698,1931,2015,2140,2124,2340,2543,2256,15349
28701,3441,3644,3555,4008,4376,4792,3635,27451
28702,648,669,637,568,442,335,366,3665
28704,20036,20391,20605,21536,20637,19351,18821,141377
28705,7094,6915,6634,6713,6712,6742,6715,47525
28707,120,78,80,100,178,200,94,850
28708,593,701,528,665,540,546,754,4327
28709,2469,2416,2112,2003,1776,1907,2225,14908
28711,13592,13121,12727,12599,12857,13677,13209,91782
28712,19251,18802,18649,18048,18081,18424,19347,130602
28713,8678,8698,8782,9011,9243,9256,8686,62354
28714,16379,16350,16392,16466,16680,17165,16753,116185
28715,25995,25243,25851,25488,24336,24739,24582,176234
28716,17163,17025,17173,16858,16872,17387,17477,119955
28717,1735,1965,2274,2334,2044,2029,1729,14110
28718,371,300,320,326,499,428,553,2797
28719,8256,8335,8454,8264,7917,7647,8048,56921
28720,98,68,111,147,147,174,114,859
28721,9962,10352,9849,9488,10042,9718,10063,69474
28722,6731,6624,7081,6866,6714,6370,6371,46757
28723,10836,10151,10339,10563,10809,10565,11329,74592
28725,33,32,33,8,17,40,43,206
28726,2181,2252,2860,3359,3579,3671,3203,21105
28729,3576,3182,2887,2907,2682,2698,2894,20826
28730,9709,9211,9695,10321,9783,9413,9133,67265
28731,8728,7910,8043,7771,7498,7351,7778,55079
28732,17322,16848,15981,15406,15365,14606,16491,112019
28733,0,40,41,57,63,89,21,311
28734,26780,26513,26279,26792,26707,26639,27040,186750
28735,287,255,268,215,188,243,256,1712
28736,805,957,731,1048,951,870,787,6149
28739,19609,20041,20099,20336,20912,21888,19786,142671
28740,1391,1415,1664,1803,1747,1344,1364,10728
28741,3886,3713,3956,3833,3637,3656,3197,25878
28742,2910,2746,3134,3403,2727,2393,2710,20023
28743,2061,2027,2032,1894,1809,1781,2125,13729
28745,838,732,803,724,478,488,551,4614
28746,2168,2210,2229,2484,2355,2496,2388,16330
28747,2315,2174,2209,2380,2603,2262,2198,16141
28748,12376,12551,12151,11706,11806,11071,11334,82995
28749,0,0,0,0,38,40,50,128
28751,3386,3204,3269,3129,3029,3149,2916,22082
28752,30274,30743,30412,30584,31275,31811,30600,215699
28753,10933,11675,11703,11426,11516,12001,11670,80924
28754,9185,8358,8195,7962,7874,7353,7679,56606
28756,4375,4670,4321,4083,4171,4693,4504,30817
28757,183,326,321,316,333,379,280,2138
28759,7287,7175,7124,6875,6865,6943,6922,49191
28761,8185,7748,8176,7794,7157,6566,7816,53442
28762,6819,6878,6679,6810,6780,6472,6857,47295
28763,2498,2571,2596,2391,2641,2537,2725,17959
28766,1114,1043,1153,1241,1370,1481,1262,8664
28768,7287,7619,7253,7166,7349,7135,6813,50622
28771,8138,8108,8130,8137,8261,8328,8558,57660
28772,1323,1311,1435,1600,1112,1343,1239,9363
28773,3356,2999,2664,2701,2452,2442,3378,19992
28774,1035,1315,1412,1407,1113,1173,1013,8468
28775,273,414,365,356,355,445,296,2504
28777,10192,10401,10280,10081,10125,10099,10638,71816
28778,11054,10988,11158,10697,10987,10703,10381,75968
28779,16965,17071,16999,16457,16472,16635,16111,116710
28781,907,938,891,814,806,687,939,5982
28782,6322,6439,6252,6662,6680,7027,6584,45966
28783,1747,1552,1080,1055,1048,1229,1593,9304
28785,7735,7617,7937,8418,7928,7485,7338,54458
28786,20516,20320,20075,20411,20599,20655,20714,143290
28787,20567,19780,19368,19133,18381,17875,19718,134822
28789,5160,5013,4863,4609,4709,4416,5097,33867
28790,3428,3324,3499,3412,3323,3202,3205,23393
28791,15441,15393,14615,15109,15161,14454,14171,104344
28792,33669,33622,33097,32082,31708,31336,32689,228203
28801,14250,14300,14489,14421,14101,13931,15019,100511
28803,31793,31478,30780,29324,29666,28752,28693,210486
28804,21384,21047,20748,20645,20408,20050,20507,144789
28805,17768,18010,17395,17732,17798,18134,17620,124457
28806,40494,40326,39605,38110,37736,37196,38550,272017
28901,5488,5462,5299,5363,5048,5612,5354,37626
28902,1271,1476,1403,1598,1386,1645,1373,10152
28904,8349,8351,8298,8174,8504,8328,8533,58537
28905,2809,2724,3176,2931,2943,2423,3129,20135
28906,18603,18542,18384,18562,19057,19044,18475,130667
28909,1411,1155,1164,1063,761,689,1030,7273
29001,1858,1959,1855,1954,1825,1935,2148,13534
29003,6615,7152,6965,6825,6766,6377,6989,47689
29006,9867,9919,9189,9471,9897,9263,9565,67171
29009,2468,2486,2480,2346,2346,2489,2440,17055
29010,12318,12395,12249,12060,11877,12489,13491,86879
29014,2000,1757,1773,1852,1808,1789,1891,12870
29015,1523,1387,1487,1414,1425,1528,1738,10502
29016,20209,19397,18018,16479,15771,15662,16393,121929
29018,3111,3410,3559,3691,3663,3699,3749,24882
29020,22191,22214,22329,22509,22542,22782,22463,157030
29030,1718,1939,2246,2312,2241,2362,1967,14785
29031,1283,1058,1339,1430,1449,1327,1349,9235
29032,5202,4860,4622,4444,4455,3996,4424,32003
29033,12296,12065,12024,12232,12227,12235,11603,84682
29036,19844,19577,18847,18643,17939,18385,19140,132375
29037,690,828,777,950,725,721,824,5515
29038,2027,2362,2618,2908,2736,2861,2445,17957
29039,4306,3826,4110,4238,4460,4095,4215,29250
29040,9341,10260,10158,9335,10149,9375,8767,67385
29042,5422,5358,5173,5587,5578,5371,5868,38357
29044,4949,5445,5413,5599,5393,5568,5652,38019
29045,23930,22990,21785,21378,20649,19632,21871,152235
29046,173,123,115,279,340,386,237,1653
29047,3410,3420,3717,3697,3902,3704,3683,25533
29048,4669,4796,5277,4903,5026,5356,4864,34891
29051,2146,2083,1647,1756,1434,1627,951,11644
29052,2091,2150,1894,2068,2520,2583,2021,15327
29053,17974,18966,18823,19368,18340,18670,18830,130971
29054,10457,10105,9621,9459,9749,9855,9612,68858
29055,4151,4418,4337,4926,4419,4846,4337,31434
29056,2219,2412,2433,2510,2399,2248,2448,16669
29058,4779,4759,4929,4641,4843,4747,4746,33444
29059,6008,6303,5922,5633,6111,6080,6068,42125
29061,14704,14802,15174,14647,14471,13987,13717,101502
29062,191,170,150,123,107,175,176,1092
29063,37201,36266,34772,34172,33162,32734,32717,241024
29065,692,549,534,786,708,625,677,4571
29067,10938,11464,11615,11071,10691,10194,10949,76922
29069,5196,5040,5137,5353,5322,4922,5020,35990
29070,14946,14689,15000,14876,14541,14961,15330,104343
29072,56906,54539,52518,51055,48560,47653,49566,360797
29073,43402,42345,41749,40827,40799,39217,40775,289114
29074,50,53,113,204,246,292,241,1199
29075,2931,3480,3693,3236,3268,2879,2963,22450
29078,15894,16113,16147,15199,15035,14837,15293,108518
29079,27,10,37,46,116,107,151,494
29080,3143,3159,3257,3194,3036,3097,3240,22126
29081,1203,1430,1259,1050,1139,1466,1352,8899
29082,405,435,430,580,620,620,572,3662
29101,2970,3021,3220,3208,3263,3221,3023,21926
29102,17206,17386,17701,18117,18351,18068,18248,125077
29104,1455,1496,1429,1633,1638,1424,1531,10606
29105,1279,1104,1192,937,1075,1061,1514,8162
29107,3014,3241,3110,2923,2872,2860,3166,21186
29108,20532,20138,20638,21017,20928,20945,20469,144667
29111,2003,1838,1831,1754,1783,1504,1632,12345
29112,4226,3970,4502,4686,4624,4459,4712,31179
29113,1859,2069,2043,2176,1757,1507,1618,13029
29114,1966,2045,2317,2112,2366,2352,2190,15348
29115,29237,29143,28700,28719,29029,29417,31128,205373
29117,978,1054,1045,1104,1209,1294,1160,7844
29118,16598,16027,16190,15950,16223,16254,15861,113103
29122,32,39,47,51,46,37,54,306
29123,7961,8189,8201,7209,7181,7068,7617,53426
29125,2105,2395,2276,2470,2311,2218,3072,16847
29126,2132,2194,2351,2237,2214,2167,2267,15562
29127,8848,8405,7988,7556,7851,8017,8333,56998
29128,5532,5400,5262,5610,5411,5784,5866,38865
29129,3056,2896,3107,3548,3833,3655,3164,23259
29130,6213,6667,7122,7440,7067,6625,6655,47789
29133,1173,1399,1420,1308,1240,1108,1044,8692
29135,8583,8560,8442,8772,8505,8242,8919,60023
29137,2070,2349,2508,2845,2760,2690,2539,17761
29138,10996,11199,11239,10767,10714,10567,10883,76365
29142,4937,5274,5043,5347,5111,5295,4890,35897
29145,901,1056,717,690,664,818,837,5683
29146,1784,1711,1520,1695,1854,2052,1767,12383
29147,0,0,0,0,0,33,0,33
29148,7204,7371,7239,6909,6766,7288,6230,49007
29150,41553,42248,41866,41044,40679,40033,40031,287454
29152,1404,1172,1497,1482,1716,1964,2393,11628
29153,14999,15025,15174,16700,16149,15942,15633,109622
29154,28826,28625,28980,29547,29769,29878,28135,203760
29160,8148,8192,8704,8490,8701,8568,8255,59058
29161,10476,10933,11095,11303,11860,11667,11383,78717
29162,2916,2767,3032,2731,3338,2996,4122,21902
29163,1943,1979,2063,2038,2195,2184,1975,14377
29164,4431,4485,4227,3837,4054,4057,4690,29781
29166,813,922,1079,1014,924,840,904,6496
29168,3638,2744,2852,2686,2659,2991,3582,21152
29169,24232,23646,22594,22364,21985,21138,22845,158804
29170,20385,20463,20926,21101,20480,20517,19988,143860
29172,9745,9112,8953,9085,8627,8834,9293,63649
29175,269,374,515,352,523,654,378,3065
29178,3154,3149,3189,3136,3201,3032,3377,22238
29180,14080,13943,13963,13678,14409,14824,14267,99164
29201,20670,21438,21522,21057,20116,19042,20594,144439
29202,237,266,284,234,179,177,135,1512
29203,39589,38684,38593,40391,40870,41279,39843,279249
29204,20108,20332,20816,20381,20869,20404,19952,142862
29205,25691,25688,26529,26510,26321,26857,24822,182418
29206,19207,18973,18511,19137,19052,19558,17788,132226
29207,11909,11758,11085,10505,9875,9856,11592,76580
29208,777,779,877,844,860,804,695,5636
29209,34003,34069,34386,33381,32098,31894,33324,233155
29210,42129,41973,41296,41047,40528,39755,40356,287084
29212,29211,28665,29050,29043,30158,29399,28798,204324
29223,50501,50892,50912,50639,51255,50065,50141,354405
29225,1301,1260,1065,1029,1050,1141,1228,8074
29229,47054,45092,44315,43933,43109,40834,44229,308566
29301,34627,33078,31934,30123,29851,31061,31051,221725
29302,16456,16705,17285,17475,17569,17973,16571,120034
29303,25041,25351,25359,25416,25602,25753,25058,177580
29306,16176,15664,16181,16173,15703,15827,15861,111585
29307,18387,18757,19170,19317,19756,19795,18751,133933
29316,24442,23558,23652,22273,22144,21890,22281,160240
29320,864,909,800,819,526,294,530,4742
29321,3173,2790,2424,2138,2326,2335,2596,17782
29322,8074,7819,8196,8541,9051,9148,8781,59610
29323,12969,13656,14117,15011,13692,13317,14446,97208
29324,210,206,194,147,188,104,167,1216
29325,15651,15774,15456,15069,14924,15051,15222,107147
29329,242,207,205,199,215,149,278,1495
29330,8894,8584,8564,8216,7904,6926,8401,57489
29331,280,243,277,163,152,164,142,1421
29332,2661,2651,2606,2709,2605,2589,2435,18256
29333,474,369,412,444,569,515,374,3157
29334,13597,13303,12937,12774,12722,11974,11331,88638
29335,5830,5780,5837,5749,6019,5858,5654,40727
29338,0,0,11,11,11,11,85,129
29340,23043,22367,21440,20974,20567,20099,20763,149253
29341,18702,18746,19293,19353,19285,19799,19330,134508
29346,161,175,159,134,102,104,307,1142
29349,29454,30377,29627,29747,29529,29534,30129,208397
29351,1190,1285,1380,1356,1425,1194,1563,9393
29353,4278,4500,4086,3833,3859,4330,4174,29060
29355,888,1042,1003,933,867,835,810,6378
29356,8164,8123,8134,7571,7769,7807,8074,55642
29360,20459,20049,20546,21074,20438,20875,20977,144418
29364,690,656,643,590,575,640,592,4386
29365,10382,10101,9506,9659,9739,9445,10146,68978
29368,89,0,0,16,14,13,68,200
29369,12823,13987,13673,14236,14241,13936,13044,95940
29370,979,935,826,523,661,617,1045,5586
29372,3862,4110,4502,4646,4830,4713,4507,31170
29373,295,215,166,155,158,208,297,1494
29374,3187,3195,3159,3108,3239,3416,3534,22838
29375,79,83,149,156,143,95,95,800
29376,8321,8197,7394,6696,6609,6212,6909,50338
29377,1330,1100,1060,562,532,555,761,5900
29378,187,170,78,118,120,176,207,1056
29379,17659,18301,18612,19433,19267,19262,19186,131720
29384,4637,4501,4573,4657,4066,3826,3945,30205
29385,8257,7530,7223,7360,6664,6205,7221,50460
29388,14896,13842,13946,14182,13962,13867,14470,99165
29401,10395,10593,10775,10746,10814,10872,10895,75090
29403,22258,21665,21904,22031,22115,22137,20818,152928
29404,1558,1511,1350,1129,1370,1306,1348,9572
29405,28750,28963,27910,28248,27904,27698,26328,195801
29406,31990,30783,30996,30103,29487,29371,29314,212044
29407,34663,33884,34362,34658,34438,33986,34827,240818
29409,2630,2506,2179,2178,2167,2072,2100,15832
29410,20608,19585,18883,18475,17893,17420,17816,130680
29412,39439,37908,36849,35493,35533,35652,35850,256724
29414,37028,37210,35682,34605,32617,31622,31883,240647
29418,24546,24598,24173,22875,22298,22325,23540,164355
29420,23772,23159,23806,23084,22614,21776,21834,160045
29423,999,985,575,555,504,491,956,5065
29424,389,411,351,339,352,448,389,2679
29426,1663,1426,1525,1535,1492,1648,1741,11030
29429,3019,2762,3159,3192,3009,3236,2737,21114
29431,7050,6731,6461,6302,6546,6638,6071,45799
29432,3600,3110,2827,2775,2700,2655,2853,20520
29434,601,544,552,456,446,348,537,3484
29435,4007,3916,3508,3676,3700,3843,4122,26772
29436,4220,4533,4247,3999,3974,3915,4471,29359
29437,3077,2302,2313,2231,2157,2125,2380,16585
29438,2284,2456,2373,2385,2430,2464,2408,16800
29439,2381,2312,2217,2299,2215,2139,2399,15962
29440,27454,27677,28168,28033,29100,28936,28469,197837
29445,58994,58048,57656,56629,55376,54926,53588,395217
29446,892,864,895,1272,1209,1260,1138,7530
29448,1833,2190,2164,2061,2526,2397,2356,15527
29449,8402,8082,7908,7705,7746,7896,7749,55488
29450,3750,3794,3332,2894,2828,3076,3105,22779
29451,4373,4306,4272,4245,4217,4211,4205,29829
29452,378,400,383,233,383,348,394,2519
29453,1175,1610,1259,1442,1425,1534,1252,9697
29455,21198,21893,21421,21631,20114,19636,20478,146371
29456,30519,30730,32234,30719,28940,26831,27864,207837
29458,2513,2287,2524,2501,2286,2386,2713,17210
29461,34256,33320,31991,31217,30270,28469,30141,219664
29464,48572,47589,46381,44849,44677,44302,43649,320019
29466,34016,32193,30673,29160,28087,26017,28725,208871
29468,2020,1966,1765,1768,1856,1579,2107,13061
29469,1019,897,733,605,550,604,855,5263
29470,4880,4625,4544,4202,4131,3887,4232,30501
29471,1472,1303,1454,1382,1428,1613,1537,10189
29472,8703,9714,8887,9411,9237,9470,9416,64838
29474,2611,2528,2596,2358,2327,1924,2176,16520
29475,2444,2384,2844,2642,2946,3095,2874,19229
29477,6505,6141,6463,6491,6581,6665,6789,45635
29479,7527,7265,7874,7990,7636,7990,7337,53619
29481,1748,1814,2010,2098,1958,1705,1841,13174
29482,2049,2067,2042,1969,1905,1886,1791,13709
29483,73900,70975,67946,66204,66029,65252,66731,477037
29485,52772,50574,47853,48443,46879,44799,45057,336377
29487,3106,2993,2863,2924,2883,2642,2725,20136
29488,21970,22231,22301,21990,21779,22023,22220,154514
29492,12243,11801,11501,10731,10419,9066,10262,76023
29493,129,131,109,107,98,75,117,766
29501,44198,44511,44683,43971,43004,43241,43220,306828
29505,25220,26215,26079,26598,26174,25718,24279,180283
29506,21163,20815,21354,20683,21246,20573,20960,146794
29510,10300,11121,11246,11320,10970,11784,11060,77801
29511,5303,5299,5117,4778,4483,4208,5146,34334
29512,18533,19023,18793,19061,19051,19411,19514,133386
29516,872,867,936,801,881,911,829,6097
29518,1390,1091,1365,1332,1210,1284,1232,8904
29519,222,236,340,294,231,216,285,1824
29520,14335,14477,14900,14797,14276,13683,14617,101085
29525,2014,1871,1908,1626,1638,1781,2029,12867
29526,43371,40924,40766,40040,38063,38440,39033,280637
29527,25094,25253,24309,24582,24722,23757,22027,169744
29530,2344,2468,2273,2347,2361,2401,2915,17109
29532,20530,20496,20071,19914,20539,20434,20871,142855
29536,16280,17091,17123,17830,17204,17554,17722,120804
29540,5635,5804,5857,5838,6249,5819,5599,40801
29541,10562,9450,9855,8885,8092,8111,9465,64420
29543,515,494,558,605,487,507,606,3772
29544,5141,5321,4854,5225,5048,5368,4909,35866
29545,1860,1736,2067,1983,1803,1583,1657,12689
29546,2998,3129,2944,2648,2581,2611,2834,19745
29547,3447,2665,2078,1855,1916,2034,2917,16912
29550,32180,31664,31586,31845,31525,32694,32284,223778
29554,9391,9188,9132,9301,9122,9438,9332,64904
29555,6168,5930,5595,6357,6398,6341,6440,43229
29556,12084,12283,12509,12299,12718,12461,12870,87224
29560,13564,13325,12891,12960,12438,12791,13664,91633
29563,2529,2603,2723,2482,2640,2581,2676,18234
29564,918,815,761,725,931,1037,985,6172
29565,6938,7112,7781,7672,8001,7495,7127,52126
29566,16387,17032,16489,16118,15869,15951,15179,113025
29567,629,649,627,680,667,730,564,4546
29568,13892,13292,13103,13371,13436,11676,12224,90994
29569,15970,15915,15793,15980,16330,16622,15951,112561
29570,3565,3440,3913,4203,4394,4325,3913,27753
29571,14900,14725,14843,15788,16099,16206,15622,108183
29572,8923,8331,8299,8253,8787,8906,7893,59392
29574,11847,11817,11768,11797,12199,12352,11909,83689
29575,17585,16868,16343,16270,15401,15542,15512,113521
29576,28146,26649,25723,25174,24530,24535,24446,179203
29577,30098,28888,28565,27503,27057,26427,26996,195534
29579,36779,34913,33546,32097,30508,29455,32180,229478
29580,1171,1192,1155,1250,1468,1750,1450,9436
29581,4784,4701,5328,4307,4376,4630,4650,32776
29582,16266,15847,15550,14899,14541,14356,14622,106081
29583,5525,5957,5599,5818,5584,5234,5438,39155
29584,2392,2428,2656,2476,2622,2638,2563,17775
29585,14428,13684,13526,13356,12935,12114,13606,93649
29588,42168,40852,38034,36438,35860,33778,36499,263629
29590,3749,3809,3803,4086,4095,4374,3677,27593
29591,4862,5099,5163,5205,5420,5635,5467,36851
29592,1170,1348,1297,1029,1020,889,1197,7950
29593,1487,1963,2166,2416,2269,2448,1954,14703
29594,128,138,125,122,122,86,121,842
29596,2343,2406,2290,2471,2548,2463,2424,16945
29601,11403,11316,10717,10751,10600,10475,10550,75812
29605,36438,35716,35434,35157,34104,33597,34414,244860
29607,38043,37528,36903,35840,34752,33045,34487,250598
29609,30411,29437,28877,28386,27952,27455,27722,200240
29611,29807,28844,28224,28826,29446,29454,28799,203400
29613,1882,1907,1620,1580,1551,1878,2334,12752
29614,2314,2322,2493,2679,2895,3167,2720,18590
29615,36042,35642,34669,32967,32752,32416,35151,239639
29617,27097,26582,26337,26624,25939,26196,25685,184460
29620,13073,13005,12849,13165,13497,13078,12934,91601
29621,41571,41689,41038,41422,40388,39357,39101,284566
29624,14362,14504,14057,14047,14599,14792,14610,100971
29625,28475,27904,27570,27097,27150,27392,27538,193126
29626,13484,13017,14236,13896,13305,12396,12364,92698
29627,18065,17345,16701,17213,17740,18441,18367,123872
29628,2494,2487,2798,2690,2593,2817,2759,18638
29630,14667,14322,14410,14344,13958,13922,14186,99809
29631,13939,13928,13513,13259,13471,13475,13318,94903
29634,5502,5727,6031,6402,6752,6776,5589,42779
29635,1391,1234,1189,1406,1376,1202,1254,9052
29638,3309,3078,3164,3038,2888,2699,2944,21120
29639,1788,1697,1590,1691,1752,1901,1742,12161
29640,29957,30249,30544,30611,30838,30504,30574,213277
29642,31225,30210,28854,28936,29506,28946,29561,207238
29643,2207,2474,2651,2876,2700,2738,2756,18402
29644,19848,19489,18819,18742,19553,19613,18578,134642
29645,9547,9440,9503,9133,10058,10212,9982,67875
29646,28304,28193,28581,28603,28763,28741,28159,199344
29649,25688,25617,25394,25589,24618,24778,26235,177919
29650,34806,35147,34160,33900,33654,33063,32632,237362
29651,45452,44853,44913,44733,43880,41580,42844,308255
29653,4756,4777,4861,4838,5465,4847,4811,34355
29654,9360,9885,10288,10194,10106,10272,9937,70042
29655,6742,7003,7619,7291,7013,6968,7796,50432
29657,15191,14942,15262,14691,14068,14520,15116,103790
29658,427,339,262,304,292,327,333,2284
29659,83,121,162,152,201,200,118,1037
29661,6176,6012,5783,5469,5725,5987,5648,40800
29662,15598,15374,15199,14604,14590,14714,15090,105169
29664,2101,2140,2089,1765,1599,1693,1808,13195
29665,134,91,50,49,63,35,127,549
29666,6746,7010,6807,6812,6525,6414,6590,46904
29667,220,254,269,246,218,239,269,1715
29669,12219,11874,11448,12296,12056,12246,12387,84526
29670,8894,8806,8821,8558,8852,8534,8673,61138
29671,17788,17712,17474,17210,17133,17262,18030,122609
29672,12368,12233,12262,11535,11449,11479,11868,83194
29673,28331,27984,26794,25872,24737,25110,25348,184176
29676,5145,5057,5155,5203,5221,5384,5201,36366
29678,22214,21922,21926,22277,21871,21648,21676,153534
29680,29610,30122,28597,28807,28232,27102,27285,199755
29681,53864,51721,50750,49692,48191,46203,46979,347400
29682,3554,3642,3670,3965,3678,3592,3818,25919
29683,140,69,442,242,293,355,291,1832
29684,4001,4587,4707,4577,4869,5358,4862,32961
29685,1549,1441,1164,1127,1048,968,1230,8527
29686,653,568,1060,1047,1119,1001,1027,6475
29687,41828,42372,42830,42351,41931,40513,39561,291386
29689,4329,4478,4371,4168,3913,3641,3889,28789
29690,22307,21695,21127,20841,19985,19834,20914,146703
29691,11041,11195,10936,11657,11446,11608,11333,79216
29692,4748,4856,4494,4938,5333,5752,4856,34977
29693,13998,14412,14115,13914,14442,14215,14215,99311
29696,5076,4638,4365,3900,3808,3621,4125,29533
29697,13071,12908,13186,12122,12175,11719,12207,87388
29702,9660,9429,9572,10137,10240,10422,10059,69519
29704,3757,4089,4344,4091,3429,3420,3721,26851
29706,18831,19321,20102,19640,20258,20275,19847,138274
29707,24200,22678,20058,18862,16577,15548,17742,135665
29708,30603,28863,27936,27047,25831,24261,25035,189576
29709,6135,6235,6138,6154,6432,6673,6498,44265
29710,33542,32686,31611,29485,28340,27912,29449,213025
29712,2391,2397,2317,2383,2345,1849,2317,15999
29714,2738,2827,2860,2676,2660,2943,2927,19631
29715,28920,27368,26165,25505,24708,23350,24823,180839
29717,1284,1125,1065,1096,987,946,1251,7754
29718,4122,3889,3887,3972,3694,3726,3856,27146
29720,46788,45583,46110,46633,47480,46826,46041,325461
29724,41,41,12,14,0,0,43,151
29726,1518,1977,1893,1881,1892,2014,1750,12925
29727,1527,1370,1345,1561,1374,1645,1650,10472
29728,10431,10321,10150,9854,10461,10097,10301,71615
29729,2290,2348,2195,2209,2321,2280,2271,15914
29730,53976,53071,52956,52496,52071,51233,52365,368168
29732,56410,55504,54026,54548,54743,54488,53781,383500
29733,1840,1865,1827,1731,1780,1843,1751,12637
29741,2050,1894,1940,2004,1906,1886,2082,13762
29742,2407,2302,2320,2477,2425,2441,2460,16832
29743,1068,978,1017,981,995,788,1071,6898
29745,30649,30659,30313,29857,29556,28835,28919,208788
29801,27543,27546,27374,27047,26158,27006,26778,189452
29803,37139,36692,37074,37092,37249,36959,36843,259048
29805,5849,5868,5832,5724,5756,5820,5864,40713
29809,2480,2628,2850,2354,2211,2344,2206,17073
29810,4718,4666,4967,5008,5116,5070,4990,34535
29812,11712,11384,11337,11295,11308,11247,11864,80147
29816,1099,1244,1536,1566,1331,1282,1033,9091
29817,4632,4660,5490,5640,5751,6134,4913,37220
29819,1619,1573,1502,1331,1302,1675,1523,10525
29821,1556,1508,1243,1113,887,955,1487,8749
29824,8608,8318,8241,8577,8662,8577,8535,59518
29826,125,121,130,142,82,80,164,844
29827,4196,4458,4503,4524,4480,4765,4624,31550
29828,836,1032,1053,1232,1247,1212,1003,7615
29829,11790,10585,10237,9352,8406,7803,8651,66824
29831,3895,3869,3945,3559,3613,4030,4146,27057
29832,5198,5426,5573,5664,5503,5911,5335,38610
29834,1711,1498,1544,1344,1615,1501,1687,10900
29835,6526,6754,6892,6835,7052,6658,6566,47283
29836,449,634,601,598,759,682,482,4205
29838,490,520,525,558,564,424,501,3582
29840,299,259,191,245,170,353,251,1768
29841,33142,32251,31655,32639,32511,31930,32494,226622
29842,7844,8213,8569,9236,8908,7977,7675,58422
29843,1178,1224,1397,1607,1735,1762,1291,10194
29844,126,110,116,88,48,45,123,656
29845,904,963,923,968,1067,1022,1104,6951
29847,4673,4758,4709,4513,4839,4643,5480,33615
29848,644,667,830,981,1000,1098,751,5971
29849,251,171,129,213,163,176,294,1397
29850,412,435,313,274,192,96,111,1833
29851,7080,7310,7025,7228,7190,7265,7524,50622
29853,6229,6658,6401,6407,6504,6695,6580,45474
29856,3193,3336,3561,3698,3701,3369,3255,24113
29860,15981,16004,15665,14547,14476,14453,14450,105576
29899,1191,1181,1152,1177,1078,1181,1244,8204
29902,15675,15297,15366,14956,14187,14413,14779,104673
29904,612,589,263,296,349,470,659,3238
29905,3329,3338,3595,3989,4189,4387,3054,25881
29906,23132,21242,21785,22027,22068,21372,21765,153391
29907,13587,12832,12353,12049,12124,12537,12570,88052
29909,18769,18371,18310,16801,16883,15947,16394,121475
29910,37915,37678,35719,35253,33809,32690,33954,247018
29911,1808,2017,1993,1846,1722,1420,1725,12531
29912,0,0,0,0,0,0,42,42
29915,512,599,648,603,599,322,416,3699
29916,1590,1464,1415,1504,1613,1405,1533,10524
29918,5066,5060,5158,5520,5412,6017,5278,37511
29920,10426,10389,9865,9667,9070,8166,9481,67064
29921,256,255,246,210,225,185,227,1604
29922,861,1101,1263,1119,1208,1137,1214,7903
29923,727,682,575,476,576,517,392,3945
29924,3917,3855,4013,3957,4024,4099,4331,28196
29926,25432,24658,25176,24845,24293,24464,23742,172610
29927,9326,9064,8727,8214,8037,7557,8237,59162
29928,17103,17270,16212,15870,15740,15292,16110,113597
29929,1209,1172,1141,1023,1044,998,1135,7722
29932,315,293,343,247,116,146,269,1729
29934,766,596,984,1086,1283,1401,1172,7288
29935,3775,3405,3125,3020,3180,3077,3685,23267
29936,13677,14061,13757,13953,13684,13270,13354,95756
29939,286,269,281,218,235,302,302,1893
29940,4203,4437,4544,4240,3997,4099,3967,29487
29941,542,525,513,414,500,517,497,3508
29943,310,342,356,472,468,711,477,3136
29944,4726,4847,5038,5451,5435,5303,5118,35918
29945,5378,4918,4439,4589,4455,4679,4841,33299
30002,5866,5835,5925,6123,6405,5811,5861,41826
30004,61418,60229,59106,54714,53642,51238,53033,393380
30005,40526,38887,38030,37014,36215,35006,34442,260120
30008,33900,32905,32050,32366,30991,28927,29822,220961
30009,14934,14759,14586,14584,13706,12741,13722,99032
30011,15631,14600,14997,15328,15099,14985,14402,105042
30012,26807,27233,27479,27342,27376,27570,27258,191065
30013,26487,25947,25496,25636,25141,25525,25183,179415
30014,37656,37433,36913,36840,37899,36211,35037,257989
30016,52584,52641,52159,50852,49267,49874,51140,358517
30017,22891,23676,22776,21151,21135,19887,20160,151676
30019,47792,45624,43422,41483,40979,39653,40447,299400
30021,23780,24196,24878,24504,23212,22379,21989,164938
30022,67903,68274,66674,66120,64632,63640,64359,461602
30024,73917,71960,70891,68650,67734,64312,64614,482078
30025,9777,9312,9393,8756,8889,8475,9270,63872
30028,24113,23276,22423,21234,19120,17665,22182,150013
30030,27549,27322,26470,25701,26103,25940,26473,185558
30032,48724,48787,48419,48693,47003,47667,47222,336515
30033,31511,31276,30312,29604,29527,30085,30763,213078
30034,44266,43922,44085,45359,45723,45694,43113,312162
30035,21385,20854,20708,20154,20637,20464,20396,144598
30038,42433,41692,40144,39490,38068,37544,37233,276604
30039,44632,43646,42092,42049,41311,40818,41517,296065
30040,64312,61657,59099,58225,56177,54706,54653,408829
30041,59660,57584,56880,56176,54612,52669,52749,390330
30043,87045,86259,83409,83855,81716,81595,80241,584120
30044,87791,86523,83574,81764,79381,77440,79701,576174
30045,35075,33602,33912,33063,31777,31613,34402,233444
30046,36549,36466,35815,34744,34255,33543,34523,245895
30047,64431,62325,62321,61805,60898,59694,59660,431134
30052,62755,59699,58850,59226,58780,59406,59451,418167
30054,11260,11472,11692,11826,11829,11665,11985,81729
30055,2780,2397,2432,3080,2743,2782,3018,19232
30056,2322,2303,2242,2229,2225,2327,2500,16148
30058,54918,53971,53237,54053,53773,53715,52945,376612
30060,38472,37334,35690,35761,35259,36117,34562,253195
30062,65557,65206,63984,63806,63193,63035,62136,446917
30064,47949,46678,45705,46401,46330,46816,46076,325955
30066,53666,52930,52859,52060,53953,53427,52936,371831
30067,48404,47556,47196,45206,44729,44241,45182,322514
30068,31968,32068,32394,33185,32775,32705,31595,226690
30070,507,424,351,253,315,212,342,2404
30071,24579,24286,23094,21172,19926,21976,23005,158038
30072,644,648,674,588,615,658,730,4557
30075,54529,54858,54675,55253,53693,52015,52573,377596
30076,44177,43656,43219,41719,41630,41760,42678,298839
30078,33469,35206,34705,34676,33984,34722,33057,239819
30079,2894,2861,2905,3507,3521,3108,2960,21756
30080,55746,54407,54252,53298,51389,49377,49905,368374
30082,26876,26974,26152,24720,25005,26095,25905,181727
30083,56038,54845,53914,52056,50612,48801,50384,366650
30084,36829,35896,36214,35524,35867,35128,35921,251379
30087,37628,36403,35911,35077,36016,35836,36761,253632
30088,28465,27167,27150,27003,27215,27653,25257,189910
30092,34427,33357,33080,31992,31081,31066,31704,226707
30093,55244,56052,55116,56213,54540,52371,53351,382887
30094,33029,32416,31714,31024,30975,29903,31244,220305
30096,69675,69237,69371,67110,66521,63801,62265,467980
30097,46663,44256,43378,41467,40712,39659,41715,297850
30101,57244,57205,54903,55141,55262,53939,54373,388067
30102,38841,37455,36969,35198,34146,33799,37470,253878
30103,16186,16358,16174,16596,15835,15216,14781,111146
30104,4169,3687,4279,4357,4886,5025,4708,31111
30105,2059,2085,2317,2339,2572,2597,2294,16263
30106,19952,19619,19049,18316,18102,17965,20300,133303
30107,14710,13872,13529,12522,13145,12483,12908,93169
30108,7360,7508,7513,7644,7476,7566,7256,52323
30110,12724,12871,12601,12638,12541,12671,13349,89395
30113,6611,6022,6251,6180,5951,6118,6218,43351
30114,52268,51915,51821,50138,48930,47934,49774,352780
30115,38817,37964,37262,38093,37630,36851,35672,262289
30116,23536,23090,22868,22793,23524,24406,23156,163373
30117,36008,35169,34279,34266,34151,34096,34296,242265
30118,2439,2513,2524,2380,2218,2076,2373,16523
30120,39902,39361,37480,37250,37100,36645,38085,265823
30121,23939,22521,22514,21652,21895,21845,22078,156444
30122,26121,23422,22955,23930,22526,22146,21561,162661
30124,2827,2812,2977,2984,2775,2813,2978,20166
30125,24481,24623,25373,24840,25134,24119,24352,172922
30126,39366,39105,40343,40243,38216,36832,37088,271193
30127,62620,61283,60475,60016,61312,61025,60347,427078
30132,37447,36238,35587,33402,32133,29916,34215,238938
30134,42816,44262,44322,43108,43585,43838,43356,305287
30135,63790,62587,62045,61298,60809,60538,61912,432979
30137,1652,1470,1577,1838,1781,1603,1650,11571
30139,4261,4161,4204,4087,4086,4069,3845,28713
30141,22249,21335,21531,21935,21446,22171,22457,153124
30143,21695,21108,20448,21086,20955,21639,21145,148076
30144,54078,53996,52871,51872,50590,48980,52252,364639
30145,7180,7812,8573,8713,9165,9210,8378,59031
30147,4455,4477,4849,5481,5525,5185,4365,34337
30148,558,490,435,413,542,630,453,3521
30149,1867,1791,1398,1396,1372,1315,1569,10708
30152,43842,42814,43044,41689,41249,41007,40393,294038
30153,18506,18045,17425,18382,18379,18258,18411,127406
30157,48147,48513,47978,46413,44761,44072,45123,325007
30161,34480,35087,35024,35367,35392,35099,35058,245507
30164,0,0,0,0,0,0,16,16
30165,41034,40376,39829,38941,38480,38972,39975,277607
30168,26494,27538,26365,25777,26110,26167,24241,182692
30170,2830,3324,3485,3501,3862,3591,2994,23587
30171,3448,3170,3729,3601,3758,3943,3491,25140
30173,5678,5927,5759,5556,5557,6297,6221,40995
30175,5943,6614,6873,6221,6110,5612,6074,43447
30176,7190,7135,7103,7187,7208,6575,7050,49448
30177,1143,1198,1142,1369,1548,1264,1049,8713
30178,2672,3307,3226,3355,3663,3730,3468,23421
30179,16922,17899,17125,16505,16581,16517,16807,118356
30180,36277,34754,34868,34137,32978,31604,34274,238892
30182,2476,2712,2924,3259,3297,3154,2666,20488
30183,5338,5129,5137,5298,5407,5372,5282,36963
30184,7017,7180,7465,7233,6787,6847,6847,49376
30185,4294,3859,3792,4084,3788,3783,3892,27492
30187,7665,8880,9039,8806,8619,9020,8740,60769
30188,59061,57035,54784,54177,51768,51455,52380,380660
30189,36941,37259,36573,36506,37382,37092,36859,258612
30204,12731,12813,12652,12724,13272,13323,13493,91008
30205,2982,3184,3172,2875,2824,3114,3061,21212
30206,2967,2789,2708,2971,3135,3091,2958,20619
30213,30646,30318,29804,28726,28374,26289,29384,203541
30214,29403,29637,29633,29291,29208,29443,28913,205528
30215,34718,33614,32963,32317,31996,31583,33665,230856
30216,2359,2376,2177,2361,1864,2109,2159,15405
30217,9657,9640,9485,9432,9459,9539,9433,66645
30218,1773,1883,1974,2174,2230,2284,1974,14292
30220,4887,4909,5077,5036,5244,5329,5533,36015
30222,3917,3963,4218,4581,4610,5028,4042,30359
30223,37445,36116,36103,35169,36371,36268,36769,254241
30224,23683,24603,24420,25651,24708,24837,25197,173099
30228,40005,40559,38220,36771,35968,35829,38569,265921
30230,8908,8496,8493,8736,8561,8293,9103,60590
30233,22363,22318,22592,22588,23194,23939,23218,160212
30234,2187,2190,2198,2065,2045,1334,1934,13953
30236,47023,46720,45482,44082,46139,46741,46434,322621
30238,38327,37257,36055,36899,35499,32227,34713,250977
30240,29423,28463,28278,28553,28441,28787,30014,201959
30241,25064,25614,25014,24178,24742,24136,23176,171924
30248,24289,23330,22702,22772,23163,23468,23249,162973
30250,778,718,836,995,76,72,679,4154
30251,2349,2772,2786,2806,2552,2361,2342,17968
30252,43256,41595,42631,43451,43146,43380,41428,298887
30253,52663,53974,55082,52256,51403,49037,49380,363795
30256,2359,2466,2212,2524,2312,2597,2826,17296
30257,4703,4534,4730,4540,4036,3838,4138,30519
30258,2824,2811,3032,2743,2922,2775,2622,19729
30259,2775,2764,2961,3128,3296,2681,3041,20646
30260,26934,26884,26417,26660,25183,24065,23244,179387
30263,55931,55013,53458,52604,52419,52034,53008,374467
30265,34025,33553,33695,32344,31702,30506,31713,227538
30268,9942,9682,9820,9736,9085,8677,9090,66032
30269,35499,35220,35018,34879,34804,34838,35069,245327
30273,14325,13843,14029,13866,14651,15097,14709,100520
30274,34553,33709,34554,34607,34151,35704,31893,239171
30275,0,0,0,0,0,0,19,19
30276,14922,14283,14844,14538,13987,13070,13866,99510
30277,22296,22098,21079,21169,20830,20688,20270,148430
30281,69716,68434,66378,65931,64962,62338,66140,463899
30284,75,48,42,55,55,52,55,382
30285,425,484,475,544,642,935,707,4212
30286,23081,23420,23696,23746,23938,23632,23490,165003
30288,9261,9100,9606,10620,10798,9532,8929,67846
30289,59,63,68,52,47,26,82,397
30290,8734,8769,8515,8400,8425,8322,8286,59451
30291,22099,21951,21563,21147,21206,19967,21010,148943
30292,6551,6399,7137,6597,6462,6180,5943,45269
30293,2966,2796,2679,2503,2742,2766,2981,19433
30294,40317,41026,38575,38015,37768,38160,39865,273726
30295,4200,4259,4114,4389,4300,4554,4159,29975
30296,28258,27029,26830,26587,27238,25532,25840,187314
30297,27580,27518,27838,27678,27252,27799,27188,192853
30303,6577,6279,5582,5001,4255,3503,5934,37131
30305,23064,22318,21574,21262,20780,21360,22999,153357
30306,22347,22329,22195,21262,21584,21990,22246,153953
30307,19244,18574,18052,17684,17344,17741,18004,126643
30308,17036,17097,17238,16434,15106,14913,15413,113237
30309,23029,21928,21444,21074,21069,21164,21845,151553
30310,30314,29152,28660,27775,26062,25056,26912,193931
30311,36789,36001,36381,36074,35741,33856,32218,247060
30312,22464,22078,20264,19644,18060,17777,19360,139647
30313,11031,10893,9590,9489,10085,10899,9495,71482
30314,23450,23468,21226,21045,21767,22379,22020,155355
30315,33710,33461,34159,33248,33761,33125,33857,235321
30316,31654,31648,31438,30700,31282,32227,31110,220059
30317,13078,12649,12320,11787,11520,11569,11970,84893
30318,49277,49728,51791,53622,54248,55021,49736,363423
30319,40151,39007,38121,36947,36148,35381,38423,264178
30322,2867,2854,2431,2364,2226,2127,2023,16892
30324,25971,27587,27282,26900,25695,23667,24267,181369
30326,5698,5429,5895,5118,4777,4551,4802,36270
30327,23120,23363,23036,22735,22715,23221,22208,160398
30328,35998,34456,33080,32447,31326,30371,30348,228026
30329,28486,28017,27602,26211,26631,25711,28539,191197
30331,63496,61010,59633,59107,58640,56122,54094,412102
30332,3370,3367,3100,3200,3453,3513,2970,22973
30334,0,0,0,0,0,0,1,1
30336,522,522,628,752,542,661,971,4598
30337,13431,12821,11796,11388,10745,11416,11505,83102
30338,34411,33666,33447,32737,33286,32881,33617,234045
30339,21656,21250,20060,18904,18531,17687,18304,136392
30340,29146,30978,31120,31559,31152,30548,29394,213897
30341,31160,31914,31865,30139,28474,27746,31793,213091
30342,30423,31027,30844,31965,30950,29354,29879,214442
30344,33494,33365,32963,32715,32425,32578,31776,229316
30345,24971,24528,23216,24261,23757,24408,23129,168270
30346,5215,5263,5172,5184,4750,4374,4696,34654
30349,69996,70334,70414,68941,67332,67904,67602,482523
30350,37211,36434,35433,33451,33625,33786,34740,244680
30354,16819,16688,16580,15983,15347,14417,14857,110691
30360,15529,15744,15501,15476,15225,15133,14536,107144
30363,3066,3189,3229,2845,2491,2048,2680,19548
30401,13227,13747,13381,13457,13663,13588,13500,94563
30410,1544,1879,1901,1836,2135,2276,2168,13739
30411,4733,5221,5505,5234,5397,4913,4371,35374
30412,105,84,94,78,73,78,80,592
30413,1959,1928,1667,1505,1557,1559,1575,11750
30415,6555,6054,6622,7641,7441,7044,6780,48137
30417,10817,10750,10771,11009,10977,11179,11090,76593
30420,1097,1285,1101,1291,1355,1083,1460,8672
30421,3804,3612,3857,3648,3348,2974,3381,24624
30423,194,191,158,166,80,43,120,952
30425,1280,1315,1315,1433,1299,1239,1198,9079
30426,780,894,845,894,919,817,1100,6249
30427,12136,11862,12066,11550,11700,11183,12864,83361
30428,2949,2391,2111,2238,2111,2441,2766,17007
30429,196,163,211,303,325,274,205,1677
30434,5348,5590,6082,6009,6160,5972,5728,40889
30436,11838,11797,11460,11600,11597,11863,11961,82116
30438,42,48,63,63,65,49,74,404
30439,10928,11032,11084,11039,10900,10695,10877,76555
30441,1876,1710,1882,1825,1904,2155,1663,13015
30442,7719,7363,7308,7305,7012,6962,7698,51367
30445,3947,3439,3253,3574,3297,3264,3285,24059
30446,1545,1601,1811,1722,1872,1599,1357,11507
30448,27,44,79,80,109,125,81,545
30449,163,93,115,107,72,76,119,745
30450,2232,2235,2350,2259,2499,2608,2583,16766
30451,31,42,25,28,41,39,33,239
30452,1177,1270,1184,1479,1473,1466,1567,9616
30453,10121,10474,10360,10058,9969,10534,9703,71219
30454,762,597,383,412,197,320,538,3209
30455,563,455,416,438,463,472,597,3404
30456,2253,1969,2035,2271,2192,2221,2119,15060
30457,6280,6267,6295,6333,6506,6521,6424,44626
30458,43039,43683,42366,41829,41574,40360,41139,293990
30460,1361,1104,1112,804,510,252,427,5570
30461,14396,13427,14191,13720,13617,13471,13390,96212
30464,66,103,95,94,86,65,78,587
30467,11993,12217,12139,12413,12412,12716,12600,86490
30470,326,392,476,428,547,587,517,3273
30471,5490,5198,5142,4893,4506,4279,4702,34210
30473,2232,2531,2805,2801,2893,2928,2972,19162
30474,17135,16918,17027,16788,16694,16255,16594,117411
30475,0,0,0,0,0,0,52,52
30477,2947,3068,3065,3400,3142,3280,3070,21972
30501,28488,27743,28071,27169,25900,27293,28048,192712
30504,25245,23601,23086,22659,22075,20390,22463,159519
30506,43500,42886,42801,41560,42387,42979,41667,297780
30507,29805,29735,28555,29839,29310,29177,28399,204820
30510,8424,8486,8203,8268,8228,8473,8291,58373
30511,3918,3722,3476,3337,3467,3253,3186,24359
30512,19851,18969,18903,19192,19432,19583,19490,135420
30513,11036,11102,11441,11216,10394,10759,11172,77120
30516,1436,1712,1667,1585,1968,2200,2054,12622
30517,12832,12423,12403,13374,12582,11270,11963,86847
30518,49192,48445,46611,45866,46466,45039,45211,326830
30519,45128,42904,42073,40881,40455,39484,39812,290737
30520,4866,4590,4479,4681,4191,3869,4426,31102
30521,4901,4708,4281,4148,4600,4930,4944,32512
30522,857,790,678,767,836,774,1092,5794
30523,12110,12084,12326,12436,12466,12761,12904,87087
30525,6724,6635,7125,7501,7612,7953,7364,50914
30527,4370,4659,3947,3975,3813,3747,4043,28554
30528,23528,22883,22927,22817,22757,22636,22679,160227
30529,10121,9687,9900,10412,10737,11165,10920,72942
30530,6695,6792,6839,6947,7446,7250,6752,48721
30531,10621,10591,10659,11445,11595,11194,11279,77384
30533,25201,25412,25932,26185,25314,25194,25296,178534
30534,29045,28773,27856,27968,27537,26758,26685,194622
30535,7572,7388,7698,7353,7221,7211,7042,51485
30536,8052,7802,8129,8042,7807,8219,8363,56414
30537,1393,1585,1694,1580,1577,1422,1249,10500
30538,2433,2666,2554,2514,2697,2219,2854,17937
30540,18746,18508,18285,17982,17921,17618,17297,126357
30541,1613,1520,1549,1707,2055,1867,1603,11914
30542,36649,35837,34717,33420,32810,31312,31946,236691
30543,4282,4434,4763,4108,3941,4320,4487,30335
30545,809,771,676,666,646,584,936,5088
30546,6498,6411,6594,6580,7074,6801,6496,46454
30547,3090,3024,3277,3517,3522,3520,3268,23218
30548,17563,18217,17075,15934,15578,14465,15870,114702
30549,23126,22908,23020,22398,21950,21524,22500,157426
30552,1805,1884,1737,1518,1648,1360,1697,11649
30553,7503,7107,7105,6911,7283,7233,7232,50374
30554,7668,7456,7630,7771,7819,7854,8535,54733
30555,2207,2360,2268,2030,2199,2179,2061,15304
30557,4561,4554,4778,4401,4220,3876,4975,31365
30558,5869,5948,5956,5231,5896,6425,5456,40781
30559,4675,4410,3961,3911,3883,4361,4333,29534
30560,4672,4429,4075,4478,4881,4290,4599,31424
30562,1194,1083,764,685,766,917,1128,6537
30563,6265,6347,5861,5438,5188,5102,5373,39574
30564,3833,3980,3717,3714,4371,4283,4463,28361
30565,4355,4514,4308,4088,4002,4144,4758,30169
30566,7507,8234,8351,8539,8609,8784,7906,57930
30567,3506,3245,3042,2985,2830,2656,2981,21245
30568,2281,2452,2331,2300,2106,1869,1877,15216
30571,3815,4107,4001,3951,3838,3773,3682,27167
30572,1074,1506,1833,1537,1263,906,1260,9379
30573,247,236,226,98,68,80,163,1118
30575,1098,809,897,1124,1659,1775,1375,8737
30576,2430,2209,2229,2432,2395,2431,2521,16647
30577,22317,22533,22951,23003,22525,23442,22230,159001
30581,0,0,0,0,0,28,73,101
30582,5361,5504,5114,4875,4176,4435,4567,34032
30601,22932,22605,22062,21349,20414,20437,20835,150634
30602,2639,2647,2454,2562,2670,2813,2409,18194
30605,41295,39717,39682,40159,39582,38693,39952,279080
30606,41696,41937,41582,40963,40575,39587,40225,286565
30607,11552,11878,11649,11865,12094,11751,10895,81684
30609,2215,2168,1659,1659,1751,1788,1956,13196
30619,1284,1254,1336,1429,1576,1314,1440,9633
30620,12440,12460,12669,12043,11700,11437,12486,85235
30621,5276,5445,5368,4882,4324,4696,5109,35100
30622,10634,10027,9966,10222,10016,10156,10344,71365
30623,268,250,247,182,96,69,154,1266
30624,3187,3159,2964,3141,3031,3157,2611,21250
30625,2447,2407,2247,2309,2090,1880,2438,15818
30627,2087,2058,2061,2080,1944,1843,2273,14346
30628,7783,6911,6684,7127,6433,7193,6556,48687
30629,4521,4431,4202,4346,4399,4578,4531,31008
30630,1993,2347,2093,2286,2670,2754,2438,16581
30631,1952,1828,1775,1859,1672,1754,1767,12607
30633,8851,8792,9096,8399,8705,7755,8474,60072
30634,1870,1652,1928,2164,2445,2527,2281,14867
30635,15003,15521,15786,15839,16296,16696,16109,111250
30641,2108,1764,2130,2069,1965,2047,1810,13893
30642,11380,11278,11110,10792,10711,10461,11001,76733
30643,16849,17052,17022,17064,16019,15714,16382,116102
30646,6293,6612,6696,6735,7079,7534,6946,47895
30648,3181,3247,3393,3371,2833,2657,2988,21670
30650,11399,11205,11729,11805,12238,11868,11708,81952
30655,24638,23928,23581,22953,23156,21604,24136,163996
30656,15363,16036,15400,15905,15378,15941,15133,109156
30660,1317,1104,1141,1123,1086,1098,1191,8060
30662,8995,8713,8480,8517,8849,8526,8537,60617
30663,3163,3465,3012,3226,3110,3212,3032,22220
30664,29,32,22,11,12,21,38,165
30665,114,116,105,113,65,101,80,694
30666,9829,9837,9526,9287,8596,8492,8659,64226
30667,1102,941,900,943,1001,818,1035,6740
30668,1561,1710,1689,1891,2096,1977,1924,12848
30669,3276,3381,3578,3464,3614,3884,3313,24510
30673,7525,7659,7759,7767,7752,8035,7897,54394
30677,18094,17226,16841,16711,16576,16453,17065,118966
30678,1441,1317,1245,1426,1286,1292,1294,9301
30680,41082,40151,39414,39230,38799,38293,37837,274806
30683,6513,7226,7128,6788,7398,6890,6749,48692
30701,39321,39969,39738,39365,39890,39883,40053,278219
30705,33440,33804,33511,34139,33934,33449,33566,235843
30707,15685,15840,15710,16162,16435,16576,16483,112891
30708,233,289,403,273,357,500,293,2348
30710,6642,6676,6362,6292,6543,6878,6661,46054
30711,3561,3391,3820,3761,3528,3574,3569,25204
30720,28582,28372,28613,28466,28363,28992,26895,198283
30721,53704,53308,52727,51763,51841,50140,53601,367084
30725,4383,4090,3899,3638,3309,3991,4647,27957
30726,0,0,0,0,0,0,56,56
30728,20490,20191,19598,19519,19281,18661,19612,137352
30730,1819,1883,1951,1689,1627,1767,1993,12729
30731,2601,2572,2276,2220,2142,1781,2428,16020
30733,2444,2207,1969,1789,1810,1232,2080,13531
30734,3636,3091,3214,3436,3113,3069,3466,23025
30735,5819,5713,5577,5893,5945,6194,6153,41294
30736,42090,41754,42075,41467,41739,41839,41029,291993
30738,3542,3924,3879,3669,3426,3453,3799,25692
30739,5893,5548,5505,5674,5989,5717,5571,39897
30740,8153,8524,8762,8816,8514,8681,8600,60050
30741,29792,30280,30715,30809,30631,29909,29290,211426
30742,7902,7991,7536,7220,6978,6831,7460,51918
30746,1423,1281,1232,1245,1416,1055,1223,8875
30747,15996,15881,16469,16942,16454,16612,16859,115213
30750,4905,4672,4812,4563,4687,4321,4125,32085
30751,11,67,76,74,104,101,91,524
30752,8227,9016,9147,9235,9326,9464,9800,64215
30753,6807,7130,7052,7206,7789,7779,6697,50460
30755,8486,8498,8823,9072,9007,9654,9590,63130
30756,125,200,241,217,227,189,74,1273
30757,2426,1904,1982,2365,2399,2313,1787,15176
30802,6143,5625,5678,5463,5928,5501,6321,40659
30803,842,770,700,655,662,614,741,4984
30805,2730,2779,2735,2452,2130,1913,2734,17473
30807,75,132,105,92,97,106,92,699
30808,4035,3939,4504,4627,4710,5186,4615,31616
30809,44679,43528,42124,41342,39972,38162,38168,287975
30810,2000,2103,1990,2122,2173,2275,2138,14801
30812,351,393,471,440,460,437,363,2915
30813,37820,36061,34833,33290,31189,29659,30415,233267
30814,8295,8563,8305,8280,8236,7331,8150,57160
30815,39982,40952,40487,41845,41247,39078,39640,283231
30816,1811,1975,2245,2263,2006,2284,2109,14693
30817,7504,7441,7557,7595,7679,7605,7676,53057
30818,695,722,443,524,406,429,555,3774
30820,1270,1221,1271,1417,1227,1054,1205,8665
30821,767,928,1051,938,1061,964,882,6591
30822,870,1110,936,820,975,818,526,6055
30823,1909,1703,1711,1668,1707,1376,1800,11874
30824,17461,17458,16957,17024,16999,16516,17201,119616
30828,4292,4150,4066,4016,4058,4304,4368,29254
30830,14378,14282,14380,14040,14444,14515,13966,100005
30833,3384,3368,3450,3544,3969,4207,4043,25965
30901,15849,15977,16609,16148,16838,17309,16445,115175
30903,799,732,601,493,357,340,585,3907
30904,24765,24970,25656,26108,26221,26450,25666,179836
30905,8029,8057,7740,7185,6820,6789,8955,53575
30906,59945,59755,60111,60634,61149,61256,57748,420598
30907,51665,52364,50902,49959,49460,51027,50913,356290
30909,43080,41036,40507,38822,37964,37754,41585,280748
30912,215,252,217,254,247,241,296,1722
31001,4657,4719,4802,4745,4706,4453,4816,32898
31002,2581,2639,2922,2868,2984,2628,2910,19532
31003,130,154,177,152,172,188,112,1085
31005,18253,17440,17359,15848,14355,13474,15102,111831
31006,4429,4480,4525,4799,4942,5111,4923,33209
31007,1037,957,1214,1105,1141,976,1117,7547
31008,17861,17949,18146,18002,18144,17868,18453,126423
31009,1446,1503,1529,1545,1338,1236,1477,10074
31011,862,906,1051,1088,1033,902,923,6765
31012,2782,3038,2769,3055,3052,3181,2683,20560
31014,13747,13382,13852,14095,14215,14277,13756,97324
31015,21808,22090,22287,22347,22152,22028,21938,154650
31016,1496,1503,1398,1139,1101,1274,1517,9428
31017,1581,1700,1662,1666,1707,1572,1985,11873
31018,2697,2527,2852,2926,3102,3231,2837,20172
31019,2368,2288,2294,2265,2359,2441,2318,16333
31020,2159,2271,2246,2383,2367,2251,2541,16218
31021,28060,27849,27838,27992,28702,28501,28549,197491
31022,1609,1568,1580,1399,1251,1331,1424,10162
31023,14108,14180,14368,14377,14479,14818,15383,101713
31024,20165,20404,20377,20505,20573,20720,20039,142783
31025,1285,1405,1333,1601,1657,1649,1226,10156
31027,9341,9999,10566,10796,11039,11157,10012,72910
31028,5779,5443,5340,5201,5540,5646,5912,38861
31029,17109,17062,16873,16559,15989,15480,16287,115359
31030,18124,18425,19168,19756,19834,19614,18977,133898
31031,6098,5894,5965,6697,7065,7216,6576,45511
31032,14298,14162,14282,13740,13179,12595,13993,96249
31033,2084,2107,2019,1921,1682,1449,2660,13922
31035,1350,1533,1379,1431,1330,1266,1364,9653
31036,12682,12783,12454,12514,12551,12396,12998,88378
31037,4728,4650,3917,3810,3654,3489,4313,28561
31038,708,727,922,774,711,560,761,5163
31039,0,0,0,0,0,0,74,74
31041,810,958,1139,1135,1092,1396,988,7518
31042,1686,1808,1956,2144,2101,1970,1841,13506
31044,3409,3265,3039,2546,2686,2773,2911,20629
31045,55,59,85,77,83,74,73,506
31046,3098,2921,2936,3230,3434,3315,3343,22277
31047,13432,12232,11506,10869,11071,10374,11193,80677
31049,1913,1659,1695,1721,1621,1804,1806,12219
31050,1053,1353,1181,1146,903,891,965,7492
31051,181,200,200,202,161,176,187,1307
31052,8441,9196,8814,8373,8274,8465,8652,60215
31054,1744,1758,1856,1770,1698,1680,1671,12177
31055,8222,8253,10099,10033,9379,8435,8245,62666
31057,2153,1955,1955,2078,2107,2585,2182,15015
31058,1384,1474,1491,1401,1844,1645,2123,11362
31060,2245,2281,1844,1884,1932,2031,1915,14132
31061,44149,43916,44312,43970,44340,44635,43755,309077
31062,474,496,308,278,255,235,495,2541
31063,5430,5414,5393,5609,5499,4831,5666,37842
31064,9350,9275,9027,9252,9099,9172,9450,64625
31065,864,833,1022,852,921,937,1118,6547
31066,1667,1629,1409,1042,1091,983,1147,8968
31067,242,307,258,258,193,214,222,1694
31068,4995,5216,5271,5254,5387,5384,5425,36932
31069,19439,20399,20918,20853,20206,19611,18948,140374
31070,938,993,1087,1171,1512,1726,998,8425
31071,1030,1111,1308,1316,1419,1456,1199,8839
31072,1426,1354,1375,1494,1710,1722,1326,10407
31075,2818,2782,2528,2561,1985,1846,2496,17016
31076,3429,3360,3400,3196,3203,3194,3064,22846
31077,1363,1307,1246,1043,1068,1173,1275,8475
31078,3034,3110,2918,3310,3308,3275,3566,22521
31079,2237,2226,2135,2141,2036,2230,2398,15403
31081,255,258,282,265,47,50,251,1408
31082,10329,10179,10166,10146,10065,9732,10408,71025
31083,339,333,242,247,279,297,362,2099
31084,8,75,97,88,96,128,129,621
31085,1065,1156,1413,1153,1313,1230,1043,8373
31087,8883,9015,9001,9271,9463,9492,9656,64781
31088,50799,50600,49303,49883,50323,50848,50163,351919
31089,4444,4696,4736,4746,5107,5469,4838,34036
31090,781,628,581,610,643,751,1038,5032
31091,4850,4925,5350,5354,5119,4804,5189,35591
31092,6985,7010,6420,6612,6464,6589,7420,47500
31093,30742,30606,30258,29558,28575,27383,28087,205209
31094,1126,1026,1141,976,719,855,1114,6957
31096,6968,7178,7242,7310,7389,7641,7395,51123
31097,1501,1238,1247,1215,1036,1250,1302,8789
31098,3439,3241,3456,3278,3150,3305,2888,22757
31201,8774,8737,8721,9049,9176,9250,8761,62468
31204,29454,29428,30264,29913,30395,30474,31482,211410
31206,28902,30218,29590,30595,30332,29663,29072,208372
31207,1075,1120,1320,1277,1323,1195,974,8284
31210,33887,32414,31849,32074,31568,30079,30968,222839
31211,15803,16251,16038,16078,16174,17541,16282,114167
31213,0,0,0,0,0,0,0,0
31216,16371,16796,17278,16655,16127,16585,16109,115921
31217,17471,18193,18500,18762,19512,19592,18408,130438
31220,13891,12847,13286,13695,13963,14037,13839,95558
31301,4468,4432,5014,5414,5264,5408,4591,34591
31302,8602,9389,8972,8777,8689,8219,7853,60501
31303,2030,2436,2132,2136,2253,2545,1999,15531
31304,0,0,0,0,0,0,132,132
31305,6916,7509,7806,7195,7297,7028,5989,49740
31307,1163,1115,961,651,392,416,998,5696
31308,7258,7734,7521,7035,6452,6861,7305,50166
31309,826,883,890,953,1078,845,1210,6685
31312,17902,16529,16144,15309,15190,13983,16443,111500
31313,41642,41362,41015,41339,40706,40290,40302,286656
31314,1636,1567,1592,1549,1600,1818,1931,11693
31315,8442,8436,8460,8376,8531,8819,7488,58552
31316,12160,11820,10942,10179,9479,9008,9749,73337
31318,283,488,478,372,360,332,341,2654
31320,8313,9001,8779,9153,9280,9002,8794,62322
31321,6929,7272,7000,6082,6406,6393,6326,46408
31322,24546,23965,22979,22431,21012,20025,21137,156095
31323,1278,1289,1576,1573,1627,1632,1762,10737
31324,23905,22319,21390,21428,20717,20193,20495,150447
31326,19858,19679,19808,20171,20062,20000,19269,138847
31327,244,187,0,121,111,139,195,997
31328,3438,3393,3480,3329,3224,3323,3306,23493
31329,9562,9316,9225,9406,9057,9560,9034,65160
31331,6747,6264,6181,6627,6509,6687,7856,46871
31401,20253,20612,20027,20177,20254,19939,21696,142958
31404,31771,31473,31798,31634,31355,31457,31024,220512
31405,37042,36100,36224,37016,36453,36050,37207,256092
31406,35691,35099,34960,34607,34865,33512,33965,242699
31407,11831,10829,9542,8686,7118,6280,7244,61530
31408,10729,10611,10354,10170,10315,10465,9952,72596
31409,692,592,495,389,290,167,652,3277
31410,23777,23649,24100,23603,24102,24373,23654,167258
31411,8003,8113,7880,8034,8082,8114,8384,56610
31415,12463,11881,12139,12172,11366,11646,12091,83758
31419,58640,58451,57023,54730,53818,52173,50954,385789
31501,15394,15084,15207,14868,15346,15895,15576,107370
31503,20395,20541,20943,21445,21432,20807,21116,146679
31510,9962,10335,10440,10143,9875,9670,9848,70273
31512,2444,2744,2789,2787,2284,1935,2248,17231
31513,16324,16410,16602,16456,16686,16407,16084,114969
31516,14665,14810,14510,14585,14293,13778,14735,101376
31518,743,640,584,519,766,640,704,4596
31519,3094,3499,3168,3144,3259,3350,3569,23083
31520,22167,22478,22150,21289,21585,22391,22336,154396
31522,15956,15600,15042,14846,14570,14493,14447,104954
31523,14171,13863,13945,14026,13932,12763,13229,95929
31524,0,0,0,0,0,0,0,0
31525,29240,28738,28736,28726,28217,27835,28247,199739
31527,677,588,621,693,844,877,805,5105
31532,815,911,913,1005,1071,1135,727,6577
31533,16531,15885,16426,16206,16625,16354,17494,115521
31535,12165,12262,11983,12349,12506,12041,11264,84570
31537,10855,11090,11014,10913,10753,10820,10097,75542
31539,14418,14320,14239,14181,13980,13700,14468,99306
31542,2847,3062,2526,2678,2289,2277,2811,18490
31543,4583,4517,4256,3971,4374,4181,4796,30678
31544,595,624,580,490,608,905,994,4796
31545,15802,15880,15715,16010,16115,16272,16133,111927
31546,8272,8189,8272,8218,7990,8024,8095,57060
31547,1403,1071,1172,952,927,826,1293,7644
31548,20720,21052,20928,20880,20608,19810,20020,144018
31549,2162,2233,1556,1615,1883,2282,2239,13970
31550,691,655,726,612,885,978,780,5327
31551,1190,916,1080,1089,1138,1251,1020,7684
31552,911,1011,1083,1031,1039,1285,932,7292
31553,4800,4567,4912,5213,4477,4408,5237,33614
31554,8592,8252,8038,7906,7265,7652,7076,54781
31555,2948,2822,3209,2894,2847,2873,2868,20461
31556,37,74,102,116,155,157,67,708
31557,2844,2815,2874,2847,2999,3502,3043,20924
31558,21351,21017,20852,20964,20171,20187,20373,144915
31560,2650,2774,2663,2693,2856,2669,2842,19147
31561,300,320,325,560,306,264,298,2373
31562,2431,2349,2166,2229,2244,1976,2177,15572
31563,1416,1422,1340,1479,1138,1285,1324,9404
31565,1778,1801,1764,1462,1929,2208,1841,12783
31566,4064,4513,4407,4503,4527,4103,3471,29588
31567,588,689,937,1119,1086,1221,782,6422
31568,858,744,758,1009,988,949,1273,6579
31569,5645,5430,5596,5425,5706,5871,5580,39253
31601,34567,34575,34718,33968,33958,32329,32730,236845
31602,35430,34843,34475,34255,33643,33585,34702,240933
31605,21238,21540,21616,21588,20985,20468,20188,147623
31606,4020,4142,3860,4054,3775,3713,3861,27425
31620,10221,10227,10843,10693,10629,10753,10690,74056
31622,2214,2221,2127,1874,2004,2137,2178,14755
31623,90,77,152,105,74,65,120,683
31624,1348,1159,1073,955,1001,981,1273,7790
31625,1592,1420,1529,1574,1331,1181,1171,9798
31626,3122,3243,3325,3555,3732,3556,3463,23996
31627,234,289,232,207,208,263,239,1672
31629,587,557,545,819,931,915,902,5256
31630,516,481,503,487,478,892,419,3776
31631,510,576,514,701,698,651,559,4209
31632,11673,11190,10725,10778,10277,10158,10295,75096
31634,5826,5682,5611,5740,5835,5672,5844,40210
31635,6169,6298,6264,5949,5825,5373,6560,42438
31636,10112,10357,9662,9616,9771,9577,9539,68634
31637,3176,3236,2957,3009,2783,2615,2848,20624
31638,965,1051,1076,1007,827,948,1045,6919
31639,9924,9904,10123,10441,10141,10227,10537,71297
31641,1797,1854,1653,1753,2001,2261,1831,13150
31642,4716,4874,4820,4894,4861,5019,4898,34082
31643,8848,8791,8894,8696,9107,8918,8709,61963
31645,5697,5791,6288,6039,5559,5239,5147,39760
31647,3907,3639,3283,3257,3411,3300,3535,24332
31648,1176,1142,1281,1139,1096,786,1040,7660
31649,1257,1092,1196,1373,1496,1542,1056,9012
31650,3586,3268,3303,3157,3275,3233,3311,23133
31698,771,895,1156,1396,1667,2001,2223,10109
31699,581,497,373,324,296,353,621,3045
31701,19199,20299,21099,21467,21677,21538,20552,145831
31705,32979,32974,33874,34946,34725,33846,35565,238909
31707,25733,26113,25542,25386,25700,26637,25299,180410
31709,16434,15887,16039,15712,15395,14812,16019,110298
31711,787,937,795,810,1027,1106,867,6329
31712,1042,1024,949,1002,983,1124,1263,7387
31714,5879,5965,6338,6276,6606,6657,6474,44195
31716,2818,2723,2664,2817,2761,2791,2896,19470
31719,9294,10090,10121,10626,10738,11177,10977,73023
31720,396,463,462,494,447,400,455,3117
31721,20736,20732,20328,19775,19728,19754,20095,141148
31722,366,409,397,530,529,461,494,3186
31730,8947,9520,9283,9526,9105,9715,9682,65778
31733,1487,1536,1637,2079,1842,1717,1580,11878
31735,899,925,883,821,828,540,817,5713
31738,2205,2174,2100,1835,1996,1825,2102,14237
31743,561,496,567,419,447,512,630,3632
31744,2764,2802,2683,2747,3122,2820,3202,20140
31747,132,108,129,147,158,159,281,1114
31749,2597,2722,2762,2903,3319,3615,2783,20701
31750,18676,18571,18827,19001,19222,19181,18687,132165
31756,804,850,765,1303,1249,1176,966,7113
31757,10353,10516,10763,10392,10248,10692,10451,73415
31763,24203,24014,24064,23881,23293,23350,23304,166109
31764,1383,1374,1392,1395,1447,1818,1296,10105
31765,3003,3089,3025,2806,2862,2532,2647,19964
31768,23094,23308,23965,23784,23338,23902,23617,165008
31771,5992,5691,5911,6207,6293,6141,5666,41901
31772,722,726,599,541,568,501,482,4139
31773,3196,3150,3099,3406,3328,3696,3729,23604
31774,6796,6675,6317,6101,6150,6321,6714,45074
31775,3129,3153,2837,2835,2827,3081,2979,20841
31778,2329,2392,2612,2317,2267,2711,2562,17190
31779,9766,9446,10013,9940,10328,10280,9927,69700
31780,1816,1974,1907,2204,2298,2437,2285,14921
31781,1981,2037,1945,1921,1829,1631,1752,13096
31783,1064,1065,1003,986,1073,1128,1107,7426
31784,789,773,829,764,847,765,781,5548
31787,1434,1248,1433,1192,1673,1722,1488,10190
31788,11024,11198,10990,10317,10575,9969,10602,74675
31789,1088,1184,1255,1736,1703,1667,1236,9869
31790,1848,1932,1889,1974,1800,1793,2078,13314
31791,12064,11844,11817,11637,12008,12479,12354,84203
31792,25008,24540,23982,23915,23646,23327,23835,168253
31793,10653,10655,10429,9098,8558,7925,9043,66361
31794,25572,25448,25590,26239,26905,27053,27153,183960
31795,2472,2493,2379,2431,2317,1874,2010,15976
31796,1056,963,1115,1185,1377,1270,1112,8078
31798,601,896,955,869,789,740,983,5833
31801,2507,2313,2109,2360,2208,2277,3008,16782
31803,6298,6665,6985,6686,6306,6242,5662,44844
31804,5958,5787,5820,6005,5351,5355,5934,40210
31805,2858,2703,2942,3353,3111,3140,3191,21298
31806,5040,4991,4875,4802,4818,4718,4962,34206
31807,3090,2940,2620,2489,2116,1729,2483,17467
31808,6650,6858,6835,6752,6455,6192,6679,46421
31810,198,160,128,217,189,193,225,1310
31811,5634,5322,5596,5018,5549,5764,5103,37986
31812,538,433,497,399,448,580,565,3460
31814,212,223,115,254,230,248,272,1554
31815,3285,3320,2923,2817,2746,3420,3675,22186
31816,5486,5489,5497,5632,5376,5459,6091,39030
31820,9795,9705,8750,8546,8916,8809,8473,62994
31821,304,182,296,442,447,379,250,2300
31822,5818,6008,5781,5638,5680,5228,5429,39582
31823,970,884,844,721,913,735,754,5821
31824,1868,1916,1989,1858,1878,1835,1838,13182
31825,2406,2515,2907,2857,2846,2205,2312,18048
31826,2738,2761,2862,3065,2476,2451,2350,18703
31827,2303,2407,2583,2690,2828,2849,2134,17794
31829,828,979,1215,1101,1406,1483,1370,8382
31830,2686,2441,2187,2115,2110,2204,2191,15934
31831,3419,3121,3350,3349,3163,3245,3095,22742
31832,130,193,110,127,181,313,217,1271
31833,7133,7317,7833,7777,6980,6719,6900,50659
31836,808,838,803,881,906,1175,1154,6565
31901,7304,7966,8178,8048,7650,7996,8638,55780
31903,20559,20900,22654,22594,21748,20989,20128,149572
31904,33643,33419,32962,32416,31007,31342,32871,227660
31905,20993,21172,20030,20069,19459,18384,16044,136151
31906,21408,21674,21939,20567,20729,21170,21757,149244
31907,57410,57542,57084,56859,57265,56912,55332,398404
31909,38559,37879,35345,34763,33801,32413,35177,247937
32003,29247,30350,29656,28738,28493,29276,27126,202886
32008,5144,5177,5948,5470,5159,5127,5309,37334
32009,3481,3506,3349,3138,2937,2895,3325,22631
32011,14142,14601,14162,14541,14034,14455,13854,99789
32024,19442,19015,19395,20526,20287,19192,18733,136590
32025,22914,23128,22680,23341,22463,22529,22380,159435
32026,1717,1615,1320,889,1016,1719,1959,10235
32033,4587,4573,4793,4679,4618,4352,4118,31720
32034,33189,32266,31636,31477,30605,30126,31008,220307
32038,9264,8869,8597,8197,8274,9393,9228,61822
32040,7214,7008,7221,6981,7497,7738,7604,51263
32043,24908,24241,24671,25160,24462,23791,24632,171865
32044,2004,1907,2029,2112,2071,2011,2060,14194
32046,9345,9251,9605,9129,9580,9370,9410,65690
32052,9575,9023,8694,8806,9217,9675,9223,64213
32053,3341,3733,3831,3970,3673,3315,3869,25732
32054,11669,11526,11779,11668,11850,12096,12307,82895
32055,16770,16371,16956,16543,17163,16852,16570,117225
32058,4514,4206,4317,4732,5197,4986,4416,32368
32059,2622,2647,2593,2197,2208,2177,2377,16821
32060,22974,23377,22922,22853,22524,21360,21363,157373
32061,403,338,191,165,189,121,283,1690
32062,2558,2623,2548,2117,2140,2414,2449,16849
32063,14051,14023,13878,14185,13794,13930,13429,97290
32064,6860,6832,6866,6841,6848,6844,6860,47951
32065,37862,36474,35949,35947,33901,31590,32770,244493
32066,7532,7428,7335,7119,7082,7158,7312,50966
32068,52300,51177,50917,48490,48758,49811,50815,352268
32071,3579,3201,2811,2602,2731,2174,3671,20769
32072,210,189,203,194,62,71,324,1253
32073,39378,39016,38509,39458,40087,39431,38920,274799
32079,369,351,327,293,299,311,433,2383
32080,21976,21560,21538,21450,20841,20455,20165,147985
32081,9836,7306,5923,4670,3880,3516,4524,39655
32082,30516,31350,30325,29538,29094,28635,28996,208454
32083,3559,4302,4253,4713,4808,4831,4690,31156
32084,33844,33118,32180,30993,30710,30526,29729,221100
32086,27265,26757,26694,25200,25031,24503,24546,179996
32087,5767,5753,5644,5561,5553,4858,5518,38654
32091,14923,15186,15129,14968,14438,14677,15472,104793
32092,31189,29437,28869,29960,28308,26134,28242,202139
32094,2452,2728,2595,2178,1968,2074,2724,16719
32095,7887,7581,7142,6625,7055,6457,7302,50049
32096,2073,2300,2539,2587,2585,2571,2635,17290
32097,16977,16165,16106,15765,16018,15452,15616,112099
32102,2188,2484,2063,2040,2030,2300,2565,15670
32110,7681,8269,7813,7538,7407,7442,7600,53750
32112,8493,8651,8632,8421,8058,7973,7713,57941
32113,5266,5699,5746,5419,5170,5594,6627,39521
32114,31385,31891,32005,32630,33221,33691,32084,226907
32117,24498,24459,24421,25306,24564,24616,24170,172034
32118,16820,16489,15977,15841,16392,16427,16961,114907
32119,22192,21644,20934,20630,20063,20563,20189,146215
32124,5452,5277,5456,5119,5066,5138,5986,37494
32127,30205,30142,29804,29978,29075,28806,29413,207423
32128,18147,17731,16895,16858,16744,17224,16910,120509
32129,20923,20540,20669,20300,20354,20276,20104,143166
32130,5520,4996,6105,5779,6528,6674,5474,41076
32131,4723,4571,4615,4407,4597,4641,4701,32255
32132,7074,6568,7002,6671,6421,6580,7265,47581
32133,82,148,92,77,80,72,137,688
32134,7685,7483,7452,7914,8397,7874,8084,54889
32136,7574,7277,7358,7496,7540,7449,7080,51774
32137,39910,38878,38214,36076,36548,36552,37821,263999
32139,1047,975,1003,1132,1077,838,1129,7201
32140,837,791,928,1023,1034,1555,1741,7909
32141,18226,18653,17797,18026,18492,18316,17603,127113
32145,5733,5139,4714,4904,4762,5089,5456,35797
32147,517,214,101,69,247,226,593,1967
32148,10715,10851,10212,10630,10713,10488,11201,74810
32157,423,431,529,450,488,407,407,3135
32159,30570,30588,29898,29313,29698,31605,28867,210539
32162,54936,54241,52224,49812,43460,36887,45180,336740
32164,45817,44621,43909,44960,43200,41420,41616,305543
32168,24902,25714,24777,24369,25333,25126,23642,173863
32169,10694,10103,10340,9914,9983,9926,9816,70776
32174,49085,48142,47619,46686,45625,45493,47552,330202
32176,14730,14348,14164,13991,14508,14561,14339,100641
32177,25628,26503,26613,26650,27408,28585,27132,188519
32179,7410,7001,6865,6871,6924,7118,8156,50345
32180,4058,4099,4243,4104,4313,4236,4218,29271
32181,2222,1872,2154,2186,2434,2460,2551,15879
32187,1641,1538,1670,1996,1891,2340,1713,12789
32189,6035,5929,5800,6043,6052,5582,5807,41248
32190,1163,985,758,550,448,865,1170,5939
32193,1034,1069,1184,1191,1051,798,825,7152
32195,3437,3296,3064,3060,2904,3120,3328,22209
32202,6078,5965,6081,6271,6127,5933,7915,44370
32204,7281,6945,6603,6340,6384,6692,6906,47151
32205,28913,29003,29068,29730,28612,28623,28225,202174
32206,16820,17141,17255,17197,17140,17805,17669,121027
32207,34770,33953,33476,32511,31990,32780,33306,232786
32208,30640,31399,30170,29677,30229,31544,30879,214538
32209,34192,32222,33519,35279,34511,37017,34305,241045
32210,61973,61928,60495,58455,57704,57080,59080,416715
32211,34434,32709,31225,30944,30265,30080,30501,220158
32212,2702,2567,2293,1856,1370,1830,1959,14577
32216,38358,37190,35589,34407,34458,32564,34876,247442
32217,18938,19167,20074,19662,20200,20150,18817,137008
32218,57754,56937,56734,56025,55200,54445,53473,390568
32219,11413,11229,10946,11033,11929,11777,11886,80213
32220,13884,13199,13628,14620,14163,13287,12946,95727
32221,30957,30899,30216,28687,27760,27484,27918,203921
32222,10014,10538,10292,9902,10171,9365,8691,68973
32223,24424,25067,24788,24533,24543,23867,23980,171202
32224,39113,37976,37563,35939,37153,36745,38934,263423
32225,53545,52037,51807,53130,53143,52659,52485,368806
32226,16580,16568,16959,16439,15372,14754,15761,112433
32227,2518,2244,2594,2800,3006,3282,2149,18593
32228,394,315,183,187,178,151,314,1722
32233,24755,24244,23382,23240,23134,22590,23673,165018
32234,6100,6737,6182,5929,5439,6148,6606,43141
32244,60694,60244,60912,61482,60796,60398,57369,421895
32246,51598,51424,50078,49747,48285,46657,48789,346578
32250,26235,26035,25829,25894,25903,25986,25356,181238
32254,13040,12896,13042,13133,13807,14447,13570,93935
32256,42388,41609,40377,40024,39862,38246,38483,280989
32257,37498,36938,36387,36113,35542,35988,36430,254896
32258,28855,28732,28595,27455,26253,24816,26759,191465
32259,45503,43649,41192,39063,37163,36380,36917,279867
32266,6817,6683,6733,6702,6886,6921,7037,47779
32277,28645,29590,29129,28884,30361,30115,29517,206241
32301,29860,28918,29062,28465,28199,27233,29321,201058
32303,49584,47909,47734,46671,47953,48457,47359,335667
32304,46660,47826,47789,47417,46695,47567,46145,330099
32305,20547,20626,20739,20448,19938,19722,20073,142093
32308,23281,22799,22440,22326,21363,20223,21586,154018
32309,31352,31097,31358,31679,31077,30327,30159,217049
32310,16827,17048,17119,16980,17602,17456,17402,120434
32311,19984,20103,19338,19400,18437,17541,17493,132296
32312,31985,32377,31686,31913,31586,31104,31869,222520
32317,14669,14206,13617,13325,13656,13703,14067,97243
32320,3637,3481,3514,3428,3465,3569,3858,24952
32321,6083,6266,6626,6577,6660,6653,6460,45325
32322,4268,4317,4487,4352,4264,4124,4007,29819
32323,334,372,409,190,135,148,217,1805
32324,4626,4668,4713,4843,4870,5214,5445,34379
32327,27616,27694,27611,27457,27113,26544,26953,190988
32328,3122,3080,2893,3245,3192,3288,3149,21969
32330,592,593,821,863,946,993,804,5612
32331,4292,4750,4713,4947,5133,5026,4242,33103
32332,1704,1593,1657,1656,1691,1876,1642,11819
32333,10526,10346,10549,10284,10215,10146,11330,73396
32334,2202,2029,1676,1731,1639,1638,1904,12819
32336,1425,1644,1524,1548,1357,1388,1391,10277
32340,11042,10689,10928,11205,11326,11389,11808,78387
32343,3256,3234,3200,3107,2996,2813,3044,21650
32344,12574,12605,12764,12785,12762,12829,13193,89512
32346,1866,1625,1653,1435,1653,1736,1693,11661
32347,8047,7890,8150,8101,8471,8530,8057,57246
32348,12513,12536,12044,12252,11719,11849,12442,85355
32350,1259,1356,1623,1832,1814,1676,1417,10977
32351,19088,19453,19715,19337,19663,19207,17486,133949
32352,6361,6537,6210,6770,6442,5956,6638,44914
32355,237,255,245,246,253,188,312,1736
32356,125,116,149,78,56,75,129,728
32358,1978,1963,1839,2025,1906,1936,2145,13792
32359,1438,1458,1460,1565,1806,1727,1721,11175
32361,154,165,114,85,157,158,252,1085
32399,0,0,0,0,0,19,2,21
32401,23380,23507,23355,23577,23395,24156,22647,164017
32403,3444,3128,3330,3425,3885,4161,2995,24368
32404,38076,37723,37514,36940,36090,36463,38425,261231
32405,32341,32588,31455,30995,30653,30359,29980,218371
32407,10118,9318,9699,9164,8882,8180,9347,64708
32408,16085,15200,15997,16244,16418,15268,15352,110564
32409,10075,9507,8717,8635,8056,8346,8691,62027
32410,987,1061,1074,1065,823,862,740,6612
32413,14022,13853,13528,12419,12328,12399,13128,91677
32420,1843,2016,1905,2033,2057,1832,2144,13830
32421,5251,5091,4988,4776,4414,4220,4497,33237
32423,974,971,1267,1083,1343,1352,1264,8254
32424,7304,7394,7544,7892,7946,7997,7994,54071
32425,14000,13739,13889,14083,14164,14098,14268,98241
32426,791,785,794,752,822,787,942,5673
32427,1031,1081,1064,1333,1445,1379,1475,8808
32428,17019,17147,16945,17119,17015,17211,17412,119868
32430,1028,1053,880,879,1020,1075,1199,7134
32431,3816,4060,4154,4086,4414,4589,4983,30102
32432,46,55,62,53,0,0,89,305
32433,16515,16735,16379,16321,15484,15441,16025,112900
32435,7442,7443,7122,7515,7162,7414,6651,50749
32437,1055,688,838,838,754,555,679,5407
32438,4183,3839,3441,4068,4046,3664,4060,27301
32439,8866,8259,8107,7853,8238,7534,7715,56572
32440,7711,7813,7881,7961,7455,7204,7563,53588
32442,3326,3638,3759,4132,3582,3744,3699,25880
32443,2852,2735,2564,2760,2849,2492,2921,19173
32444,20913,20397,19971,19205,19254,19073,18985,137798
32445,2744,2672,2925,2995,3121,2958,2644,20059
32446,11856,11149,11098,11041,11582,12147,11075,79948
32447,155,158,215,293,339,388,78,1626
32448,8720,9242,8805,8530,8325,8320,8684,60626
32449,591,736,858,722,659,573,478,4617
32455,4747,4797,4846,4361,4431,4216,4736,32134
32456,7713,7488,7276,7404,7554,7577,6966,51978
32459,14075,12875,12446,12372,11977,11314,11457,86516
32460,5967,5836,5946,5805,5858,5781,5856,41049
32461,21,18,26,28,28,41,13,175
32462,3348,3467,4163,3800,3938,3903,3412,26031
32463,188,156,118,101,97,127,114,901
32464,4320,4470,3990,3877,3716,3691,3994,28058
32465,8492,8591,8844,8723,8655,8701,9232,61238
32466,6198,6740,6083,6089,6239,6065,5641,43055
32501,11571,11293,11766,11768,12277,11964,11730,82369
32502,2786,2530,2639,2962,2895,3194,3298,20304
32503,34645,33909,33965,34382,34416,35007,32011,238335
32504,22940,23250,22593,21859,22055,21710,21441,155848
32505,25715,25864,25086,25408,25619,26838,28213,182743
32506,34865,34561,35572,35694,35414,34560,33846,244512
32507,28928,28419,28548,27787,27496,27704,28996,197878
32508,6717,6878,6882,6950,6524,6475,5852,46278
32509,727,695,710,687,668,654,660,4801
32511,1180,1146,1198,1106,977,889,1145,7641
32514,44610,42692,41701,38689,38406,37062,37399,280559
32526,36905,36367,36203,35457,35105,34991,36297,251325
32530,0,51,100,98,95,328,38,710
32531,5490,5262,5033,5472,5079,5317,5296,36949
32533,27419,27595,27212,27434,26962,26892,26493,190007
32534,14937,15293,14384,14199,13264,13078,14029,99184
32535,5504,5641,5605,6015,6334,6465,6326,41890
32536,22316,21894,20932,20663,19921,19249,19709,144684
32539,27836,26324,25842,25243,25090,24442,25079,179856
32541,17221,16823,16505,16158,15558,15809,15565,113639
32542,3396,3309,3248,3245,3542,4245,3457,24442
32544,2140,1913,1745,1717,1862,1741,1818,12936
32547,34666,35645,35334,34365,34201,33868,32485,240564
32548,20744,20298,20394,19868,19808,20030,19343,140485
32550,7315,6976,6702,6092,5957,5975,5867,44884
32561,9208,8888,8755,8843,8714,8622,7899,60929
32563,24629,24046,23912,23985,23863,23005,22406,165846
32564,2678,2477,2500,2807,2792,2903,2881,19038
32565,4868,5326,5278,5530,6100,6007,5719,38828
32566,35952,35559,35265,35373,34005,32576,33671,242401
32567,3330,3259,3297,3285,3420,3293,3510,23394
32568,2940,3065,3066,2981,2836,2631,3122,20641
32569,12068,11510,11147,10869,10638,10591,11235,78058
32570,29555,29390,29603,28021,28004,27884,28817,201274
32571,32745,31972,31318,30346,30282,29690,28881,215234
32577,4182,4333,4193,4487,4744,4751,4625,31315
32578,31957,31806,31221,30428,30374,29600,30108,215494
32579,10332,10298,10337,10160,9944,10231,9997,71299
32580,3976,3904,4002,4244,4197,4247,3662,28232
32583,29614,28227,26416,25870,24415,23962,25586,184090
32601,18819,18808,19212,19360,18997,18468,18585,132249
32603,7844,7598,8272,8714,8396,8604,6741,56169
32605,23327,23291,23162,22701,23302,22715,22925,161423
32606,24454,23739,23860,23244,22510,22287,21833,161927
32607,29744,30424,30231,30504,30023,30002,29750,210678
32608,47160,46128,44474,43916,43101,43720,45842,314341
32609,17974,17650,17583,17768,18778,18843,18756,127352
32612,7903,7486,6826,6564,6707,6725,5458,47669
32615,15061,14697,14880,14997,15365,14281,14295,103576
32616,789,744,503,430,614,753,872,4705
32617,4605,4164,4066,4351,4045,3904,4109,29244
32618,7775,7681,7782,7648,7008,7408,7732,53034
32619,4520,4354,4151,4566,5170,5587,4730,33078
32621,5755,6061,5934,5697,5495,4997,5584,39523
32622,1109,1244,1204,1272,1245,1312,1294,8680
32625,1565,1630,1487,1671,1570,1920,1838,11681
32626,8204,8140,8352,8440,8702,8805,8133,58776
32628,5154,5437,5379,5415,5220,4881,4850,36336
32631,454,493,416,275,303,88,291,2320
32639,27,46,36,50,189,217,397,962
32640,10875,11162,11041,11102,10547,10104,10510,75341
32641,13761,13686,13161,12691,13054,12978,14291,93622
32643,11073,10958,10578,10443,9903,9960,10936,73851
32648,371,468,459,337,429,443,437,2944
32653,13870,14161,14204,14122,13580,14099,12844,96880
32656,14235,13902,13528,13565,14100,13399,14014,96743
32658,222,220,192,182,109,217,308,1450
32664,588,597,467,373,356,319,510,3210
32666,6101,6250,6708,6527,6478,5893,5916,43873
32667,3446,3580,3126,3546,3641,3709,3794,24842
32668,4315,4533,4817,4799,4696,4334,5082,32576
32669,11630,11394,11612,11190,11478,11147,11623,80074
32680,9894,9443,9716,9765,9810,10091,10223,68942
32681,76,157,145,138,150,147,136,949
32683,243,134,341,337,321,318,151,1845
32686,5913,6112,6444,6106,5823,5312,5003,40713
32692,242,334,306,263,285,296,295,2021
32693,12379,12899,13106,12770,13203,12701,12154,89212
32694,2335,2611,2653,2766,2416,2519,2142,17442
32696,11589,11161,10923,10904,10616,10649,12071,77913
32697,425,461,397,249,228,287,253,2300
32701,22069,21522,21365,21426,21844,21639,21577,151442
32702,2758,2787,2675,2448,2662,2593,2705,18628
32703,49218,48469,48292,47824,46987,44477,46207,331474
32707,35511,35681,35490,34681,34690,35173,35335,246561
32708,44605,43715,43320,43157,42716,42326,42012,301851
32709,1989,2285,2254,2271,2796,2858,2566,17019
32712,44194,44222,42691,42401,41354,40556,41769,297187
32713,19903,19707,19621,19506,19424,19328,19491,136980
32714,35011,35361,34729,35085,34763,35048,34862,244859
32720,30847,30557,30937,31190,31760,30703,29700,215694
32724,34228,32996,32404,31623,31551,31615,31826,226243
32725,47113,45532,44417,45736,45165,45290,44905,318158
32726,21767,21441,20288,19962,19680,20121,20029,143288
32730,4980,5289,5669,5485,5543,5347,5354,37667
32732,4827,4168,4143,3799,4043,4544,5589,31113
32735,3979,4044,3776,3384,3317,3681,3903,26084
32736,9864,9342,8839,9617,8478,9041,9736,64917
32738,44439,44894,44956,43347,43369,42800,43830,307635
32744,3613,3588,3269,3333,3294,3362,3588,24047
32746,41892,41247,40167,41032,40677,39666,40571,285252
32750,23630,22903,23311,23173,22761,23254,22713,161745
32751,21387,21620,21108,20666,20264,20549,19928,145522
32754,10388,10094,10443,10156,10158,9667,11313,72219
32757,25705,25066,24352,23380,22867,21646,23746,166762
32759,2769,2156,2775,2797,2969,3172,2871,19509
32763,22579,21951,21218,21188,21006,20934,21263,150139
32764,3281,3416,3430,3576,3603,3644,3120,24070
32765,61426,60485,59879,58153,57953,56515,56349,410760
32766,16699,15905,15632,15355,15387,15501,15698,110177
32767,3062,2898,2641,2799,3400,3024,2622,20446
32771,51310,49908,48740,47609,47212,46269,49481,340529
32773,30348,29738,29172,28698,28361,28724,28787,203828
32776,12026,11049,10587,9902,9358,9863,10262,73047
32778,20359,19523,19342,19468,19289,18516,18617,135114
32779,30450,30400,30189,28555,28563,28229,27556,203942
32780,34956,34423,34513,34562,34722,34290,34628,242094
32784,12247,11395,11378,11335,11389,10798,11432,79974
32789,25145,25039,24979,24635,24808,25671,24557,174834
32792,51397,51343,50142,49308,47716,46540,46914,343360
32796,21398,21090,20966,21099,20854,21429,20139,146975
32798,2475,2785,2518,2623,2450,2504,2550,17905
32801,12235,11718,11540,11237,10112,9690,12050,78582
32803,17529,16669,17230,17680,18245,18974,19020,125347
32804,17721,17565,16607,16826,16581,17106,17312,119718
32805,22104,22111,22338,22001,22369,22018,21810,154751
32806,26797,27057,27025,25598,24748,24950,24820,180995
32807,31888,31473,32410,32604,32265,33229,31465,225334
32808,51507,51555,50332,50146,51794,50869,46334,352537
32809,27857,27612,26215,25126,24741,25435,26773,183759
32810,36015,35240,35374,33503,32269,31132,32210,235743
32811,39748,39556,37479,38301,37385,38799,35825,267093
32812,36083,36943,36968,36753,37164,36250,32844,253005
32814,7532,7477,6910,6061,5181,4866,6151,44178
32817,35265,34583,33312,33015,32798,31973,35105,236051
32818,51824,49004,46390,45957,45955,45836,43911,328877
32819,27620,27248,26628,25461,24925,24432,24976,181290
32820,9422,8641,8701,8767,8652,7970,7974,60127
32821,16870,18008,16821,16355,15685,14839,21423,120001
32822,57441,56512,57055,56111,54772,53918,53029,388838
32824,41857,39150,38037,36515,36212,36061,37401,265233
32825,58189,58324,60006,59099,58250,55325,53024,402217
32826,35206,33249,31698,29990,27126,25411,29347,212027
32827,8953,7650,7040,6576,6261,5714,6362,48556
32828,63788,61636,60897,58491,58633,57707,57881,419033
32829,21156,19968,20211,20542,20142,19119,17822,138960
32830,11,12,7,7,6,0,26,69
32831,3300,3379,2981,2768,2518,2273,2542,19761
32832,21413,18216,16204,16194,15043,12847,13787,113704
32833,9537,9968,9771,9014,9621,9306,9241,66458
32835,42960,42750,41797,43477,44329,43067,39633,298013
32836,17631,18351,17961,17137,17717,17217,16647,122661
32837,53657,52871,52620,53184,51812,52779,51219,368142
32839,51706,50989,47934,46052,44036,43055,50279,334051
32901,24946,24594,24929,24700,24533,25095,24521,173318
32903,13697,13642,13152,12954,13363,13195,12869,92872
32904,29054,28229,27564,27160,26395,26195,26710,191307
32905,23520,23146,22914,22301,21424,20793,22084,156182
32907,43141,42223,41335,41735,41425,42401,41870,294130
32908,11323,10586,10789,11068,10828,10106,10892,75592
32909,30380,31219,31351,30393,30944,30430,30120,214837
32920,10018,9909,9891,9868,9884,9887,9848,69305
32922,16043,15434,14723,14945,15207,14780,14916,106048
32925,1457,1371,1233,1293,1320,1439,1222,9335
32926,22422,22670,22902,23047,22820,23346,22752,159959
32927,25168,24179,24441,25480,26517,26971,28092,180848
32931,14114,13996,13897,13958,13793,13829,13567,97154
32934,17952,17692,17948,17723,18248,17930,17338,124831
32935,40438,40398,39960,39920,39151,39550,39082,278499
32937,26319,26254,25512,25312,25124,25282,24969,178772
32940,36475,35293,35093,33752,32363,31605,31999,236580
32948,7733,7862,7457,7449,7484,6805,6773,51563
32949,2602,2671,2734,2513,2412,2314,2248,17494
32950,3977,3795,3752,3917,3939,3803,3982,27165
32951,11326,11357,11185,11329,11542,11605,10673,79017
32952,20302,19995,19612,20289,20300,20497,19881,140876
32953,23426,23783,23331,22097,22112,21601,22754,159104
32955,38137,37745,36845,35927,35983,35251,36374,256262
32958,26817,26400,26053,25752,25247,25258,25366,180893
32960,21046,21322,20514,20097,20123,20383,20037,143522
32962,24468,23820,22466,21484,21730,21223,22716,157907
32963,14591,14354,14392,14894,15395,15335,14911,103872
32966,16262,15531,15598,15510,15180,15235,15626,108942
32967,19942,18957,19386,19901,19439,19833,19518,136976
32968,14225,14353,14716,13812,13224,12587,12830,95747
32970,285,420,474,570,535,486,303,3073
32976,8418,8337,8555,8804,8852,9172,9079,61217
33001,192,198,191,211,243,198,315,1548
33004,16526,16077,16226,15570,14818,14482,15588,109287
33009,40835,40835,40327,39889,39499,38951,39341,279677
33010,47581,46306,46727,46108,45600,45339,46187,323848
33012,76384,76227,74950,73805,74418,73543,72248,521575
33013,33430,34206,34377,32382,32220,32561,33852,233028
33014,40187,40487,40108,40517,40816,39809,40654,282578
33015,68143,67051,66808,65038,63733,60639,63544,454956
33016,50138,49863,48980,48450,46394,46270,45342,335437
33018,49283,49157,47315,46903,46409,46171,46117,331355
33019,14923,14696,14085,14195,14685,14587,15107,102278
33020,44188,43751,42132,41219,41257,41615,41329,295491
33021,48301,47832,47767,47400,48005,47832,45921,333058
33023,70910,69570,68105,64849,63587,62393,63576,462990
33024,73034,71860,71144,69630,67043,65286,63916,481913
33025,65059,60994,59104,57766,56388,55642,59039,413992
33026,30474,30274,30056,29747,29525,28858,28498,207432
33027,60995,59500,59274,57479,57114,55611,57663,407636
33028,28537,28902,28225,27547,26566,26694,26696,193167
33029,46724,48397,47284,47086,45984,45075,45235,325785
33030,35279,34645,34426,33500,32808,32238,34110,237006
33031,7087,7436,6504,6411,6552,5980,5859,45829
33032,43281,40961,38672,37028,35227,32660,34088,261917
33033,55956,55392,52834,51131,50018,47887,49028,362246
33034,22315,21946,24473,26083,27587,29448,18613,170465
33035,17430,15158,14010,14123,12762,11832,13497,98812
33036,3293,3331,3924,3849,3671,3469,3035,24572
33037,11071,11519,12032,12226,12510,13013,11612,83983
33039,526,362,306,307,205,43,122,1871
33040,35357,33712,33674,33254,32543,32004,32891,233435
33042,6707,6821,6325,6339,6039,5659,5829,43719
33043,4977,4805,4591,4026,3821,3906,4313,30439
33050,9417,9228,9150,8901,8923,9013,8922,63554
33051,696,739,615,629,565,543,796,4583
33054,31180,30880,30706,29662,29426,29190,29061,210105
33055,45974,46217,45773,46013,43781,44141,43194,315093
33056,34751,35023,35250,34550,35217,34426,35059,244276
33060,35593,34918,34365,34330,32853,33658,32154,237871
33062,21464,21958,22120,22329,23033,23735,23948,158587
33063,53732,53899,52637,52564,52264,52319,51019,368434
33064,59265,57115,56224,54879,54866,53968,52969,389286
33065,55860,56087,55249,53614,51600,50451,51921,374782
33066,17131,16576,16523,16200,15859,15761,15760,113810
33067,28131,26663,25987,25288,24952,24877,26458,182356
33068,51465,50973,50288,50207,49007,49004,49824,350768
33069,27191,27428,26659,26013,24914,24064,25700,181969
33070,5433,5539,4665,4739,5053,5171,5344,35944
33071,38968,39227,38308,38355,38877,38420,36964,269119
33073,32019,31381,31209,29678,29344,28209,29168,211008
33076,33068,31810,31501,31107,30840,30649,29751,218726
33101,0,0,0,0,0,0,0,0
33109,636,602,523,508,482,150,594,3495
33122,151,0,0,0,0,0,1,152
33125,58144,56139,56018,53435,52821,54211,52677,383445
33126,52835,51383,48139,47311,46880,46057,46867,339472
33127,31904,31817,30174,30131,29801,31080,28909,213816
33128,7367,7665,7568,7458,7652,7769,7562,53041
33129,12579,13148,13719,14198,13086,13270,13833,93833
33130,25503,23757,24658,24338,23717,23100,26108,171181
33131,16041,16228,15839,14540,13082,11546,14917,102193
33132,11433,10610,10390,9976,8424,6851,11165,68849
33133,34228,33714,33929,33141,33553,32708,31926,233199
33134,41340,42020,40970,39367,37554,36689,37456,275396
33135,38867,37799,35559,35470,35709,35352,36066,254822
33136,13687,13376,13262,13248,13162,13024,13791,93550
33137,23520,22789,21069,20221,19737,18848,19410,145594
33138,30195,30047,29516,29292,28101,27578,27571,202300
33139,38027,38035,37536,38066,38665,38491,38613,267433
33140,22222,23381,23483,22197,21424,21076,21210,154993
33141,39738,38244,37463,36953,36319,36196,35249,260162
33142,54571,55865,54939,54178,55089,53523,52606,380771
33143,32499,32710,32709,31129,31110,30310,31407,221874
33144,27856,27588,26602,26009,25976,24869,26903,185803
33145,32477,32332,31127,30774,31124,32113,29758,219705
33146,15505,14914,14983,15383,15510,15647,14995,106937
33147,45676,44136,43537,43414,44278,44039,46933,312013
33149,12935,12888,12774,12560,12385,12158,12389,88089
33150,27588,27988,28759,27227,27929,26505,27811,193807
33154,14666,14645,14440,14209,14078,13930,13971,99939
33155,46602,47169,48407,46977,46603,44260,43788,323806
33156,33030,33018,33806,32114,31537,30904,31315,225724
33157,68396,68540,67927,67553,66756,65413,63226,467811
33158,6893,7325,7319,6777,6719,6712,6694,48439
33160,39759,39235,39141,37674,36968,36817,40053,269647
33161,56385,55217,54772,54036,52622,51462,53710,378204
33162,47394,48065,47280,45773,45754,44527,43539,322332
33165,56771,57210,56175,56275,55492,55301,56149,393373
33166,24328,24522,23534,22899,21993,21559,23038,161873
33167,20061,20019,20064,19766,18835,19096,18846,136687
33168,29291,30045,28651,27990,27739,26272,25792,195780
33169,41037,40197,38365,38545,38309,37532,39353,273338
33170,14535,13308,13399,12034,12096,11340,12253,88965
33172,41456,40534,39898,38958,36940,37490,37664,272940
33173,32696,32996,34648,35354,35455,35504,33141,239794
33174,32580,31596,31000,29409,29094,27630,32524,213833
33175,54462,54443,54237,52348,53933,53548,53206,376177
33176,50819,51384,51830,51207,50661,51235,50170,357306
33177,57570,57688,56736,56355,54808,55118,53191,391466
33178,47417,45404,44218,42701,41780,40788,39489,301797
33179,44451,43978,43018,41977,40591,39394,41332,294741
33180,32365,32796,32103,32972,32159,31573,30840,224808
33181,18612,18027,17881,17665,17509,17489,18413,125596
33182,18393,17761,17339,16264,15317,14639,16929,116642
33183,38469,38067,37303,37166,35708,35615,35949,258277
33184,22071,21926,21474,21229,20877,21185,21075,149837
33185,30910,29514,29300,29029,28271,28088,27189,202301
33186,70882,72078,71441,71426,70969,69034,67137,492967
33187,18837,17421,16577,17159,15995,16328,16315,118632
33189,26363,25821,24697,23110,21812,23750,23828,169381
33190,14980,13479,12991,11878,11647,10027,11593,86595
33193,50063,50653,48273,45852,44175,44973,46044,330033
33194,7340,7899,8585,7438,7581,6904,7742,53489
33196,48092,46579,46577,44429,44702,43902,43620,317901
33301,13565,13463,13211,13536,13459,13157,14586,94977
33304,18852,19026,19101,18562,18120,18075,17724,129460
33305,12255,12010,11991,12155,11292,10749,11927,82379
33306,3267,3349,3540,3403,3243,3160,3397,23359
33308,27661,28757,28581,26616,27548,28781,28217,196161
33309,37936,36971,36394,35279,35254,35896,33705,251435
33311,68664,67235,65688,65304,63598,62566,63786,456841
33312,54714,55294,53453,52915,53571,50833,49343,370123
33313,61117,59725,58515,56934,57469,57527,56039,407326
33314,23768,23341,22910,22150,21445,21156,21885,156655
33315,13465,12982,12851,12206,11494,11525,12153,86676
33316,10015,10465,10448,10854,11098,11048,10044,73972
33317,36801,36532,35734,35414,35691,35539,35372,251083
33319,47191,47173,46740,46473,45335,44748,44420,322080
33321,47039,46181,45661,44326,44235,43959,44327,315728
33322,38996,38112,37700,37226,35852,36208,37858,261952
33323,19995,20144,19962,19696,19212,18502,18929,136440
33324,46119,45933,45751,44952,44706,43641,42847,313949
33325,29622,29916,29777,29796,28417,27177,27570,202275
33326,33558,33481,33538,32073,31655,30484,31257,226046
33327,23895,24258,22970,21627,21296,21281,22658,157985
33328,29233,29157,28440,28789,28101,27775,27415,198910
33330,14314,13457,13520,13595,13150,13164,14107,95307
33331,24151,23703,23703,23769,23127,22710,23204,164367
33332,11350,10599,10571,11791,12328,11770,11199,79608
33334,30307,29242,29063,28709,28296,28512,28749,202878
33351,35386,35515,34709,34570,34708,35224,32890,243002
33401,26501,25810,26233,24979,23587,23198,24879,175187
33403,12537,12430,12239,11726,11841,11165,12042,83980
33404,28039,27662,26884,26909,26755,26634,27489,190372
33405,20972,20265,20452,21058,21256,20561,19155,143719
33406,25709,26026,25355,26057,25896,25526,26312,180881
33407,30311,30142,28101,28165,29351,29970,29659,205699
33408,17652,17476,17429,17578,17689,18168,16921,122913
33409,31318,31118,31081,30467,29651,30347,29140,213122
33410,36019,34742,34333,33249,32979,31857,32570,235749
33411,68557,68659,66683,64015,63313,61413,65245,457885
33412,13654,13186,13043,13395,14600,14091,14414,96383
33413,15865,15286,14847,14661,14293,14013,15162,104127
33414,58530,56497,54865,54474,53682,53073,53718,384839
33415,49938,47651,47037,44429,43742,42975,44963,320735
33417,31873,32478,31425,30642,30644,29389,29156,215607
33418,37716,37514,36169,36588,35775,36100,36017,255879
33426,21739,20163,20578,20211,20081,19970,20082,142824
33428,39853,39872,39583,38943,38504,39055,38548,274358
33430,21843,21128,21286,21359,21316,21815,21427,150174
33431,18535,18380,17801,18026,17651,17339,18290,126022
33432,20284,20178,19925,18972,18958,18616,18715,135648
33433,42445,43127,43450,42991,42538,42101,41722,298374
33434,20438,20723,19987,19728,19322,19030,19260,138488
33435,34304,34193,33592,33336,32668,33355,32104,233552
33436,43911,42844,41955,42616,41700,40449,41896,295371
33437,38644,38426,37755,36952,36181,35660,35938,259556
33438,384,304,337,436,494,354,459,2768
33440,20048,19756,20096,19359,18690,19176,19743,136868
33441,26959,26761,26567,26505,26714,25983,26838,186327
33442,29192,29647,29381,28723,28699,28721,28075,202438
33444,22980,22440,21904,21377,20165,19998,20221,149085
33445,31141,30461,30276,30135,30655,30344,29754,212766
33446,22881,22853,22891,22184,22086,22571,22088,157554
33449,11843,11845,11132,10223,9449,9461,10817,74770
33455,22804,21700,21033,20131,20002,20041,19980,145691
33458,53987,52303,51400,50580,49514,48437,49396,355617
33460,31427,31740,31378,31330,30497,30538,30790,217700
33461,44102,43353,42994,41250,40826,40642,40748,293915
33462,33183,33197,33206,32180,31473,30049,30879,224167
33463,59303,57691,57143,56864,55310,54809,53766,394886
33467,51099,51195,51122,51606,51134,50208,48808,355172
33469,15429,14922,14637,13915,13555,13822,14449,100729
33470,25888,26455,26734,25566,26204,26305,26551,183703
33471,7729,7910,7825,7443,7049,7371,6818,52145
33472,19540,19558,20094,19627,19115,18158,19100,135192
33473,9954,9189,7149,6098,5628,3975,6265,48258
33476,7897,8113,8062,7879,7767,8328,7669,55715
33477,13910,13559,13368,12414,11947,11860,13074,90132
33478,12409,11926,12334,12370,11797,11877,12704,85417
33480,9844,9796,9667,9559,9605,9855,9549,67875
33483,11566,11854,11787,12131,12692,12945,12093,85068
33484,24651,24023,23870,24028,23595,23806,23443,167416
33486,24118,23249,23194,22200,21899,22132,21720,158512
33487,18336,17426,16954,17412,17113,16781,16421,120443
33493,5395,5306,5161,5028,4954,4901,4926,35671
33496,22210,22007,22301,22354,22675,21857,20969,154373
33498,14105,13749,13740,14582,15417,15473,14557,101623
33503,98,108,215,64,17,8,108,618
33510,27450,27988,26715,26703,26792,26910,27610,190168
33511,54641,53491,53841,51807,51784,52332,52003,369899
33513,11936,12970,12248,11889,11946,12269,12086,85344
33514,2224,1697,2034,1980,2227,2233,1811,14206
33521,469,491,546,517,634,574,599,3830
33523,17736,17885,18869,18455,19710,20559,18313,131527
33525,19163,18295,17789,17728,18494,18471,18439,128379
33527,15172,15129,15680,15281,14986,14712,15203,106163
33534,16205,16320,14282,14214,14344,13505,12839,101709
33538,4651,4459,4585,4890,5244,5914,4789,34532
33540,8741,9283,9946,9473,9498,9380,8752,65073
33541,19374,19927,20142,20971,20983,21820,19759,142976
33542,19826,20532,20901,21178,20957,21204,20824,145422
33543,24117,23490,22483,22234,22220,22214,21898,158656
33544,25477,25388,24374,23914,23806,21790,22800,167549
33545,16967,15821,15091,13599,12365,11862,13996,99701
33547,24084,22670,21807,21061,20024,19142,19813,148601
33548,6473,6389,6474,5797,5989,6075,5807,43004
33549,16602,16025,15408,15276,16024,16665,16132,112132
33556,21932,21712,21402,20628,21212,20281,22015,149182
33558,21405,20735,20557,20550,19754,19581,20064,142646
33559,17426,17570,16768,16952,16176,15386,15427,115705
33563,26912,26892,26746,26297,25178,25436,25488,182949
33565,17877,18445,18555,18477,18416,17944,17975,127689
33566,20511,19534,19941,20488,20593,20481,19522,141070
33567,12305,11992,11682,10787,10118,9788,11505,78177
33569,25418,24724,23994,23894,23528,23344,23074,167976
33570,25698,24698,22451,21066,19713,19670,20758,154054
33572,16168,15951,15440,15317,14594,13884,14117,105471
33573,20836,20330,19647,19566,20258,19871,19172,139680
33576,3974,3568,3723,3845,3931,4315,3784,27140
33578,46431,44473,43222,39691,36632,34261,36693,281403
33579,30198,28295,26518,26188,23680,20969,25723,181571
33584,25104,25385,25495,25274,25706,25175,25392,177531
33585,1197,1158,1550,1392,1375,1262,1058,8992
33592,10119,10237,10364,10876,10498,10764,10091,72949
33594,35340,34795,34258,33482,32759,32992,32677,236303
33596,29386,29579,29547,29771,29207,29432,29283,206205
33597,9076,7938,8026,7931,8117,8119,8026,57233
33598,14827,14341,13881,13285,12662,11562,13665,94223
33602,14151,13269,12456,11524,11484,11046,11515,85445
33603,19710,20267,20015,20095,18805,18857,19100,136849
33604,38460,37851,37740,37907,37801,37448,35485,262692
33605,18319,18330,17725,16468,16381,16207,17073,120503
33606,18527,18534,17945,17690,17173,17444,17746,125059
33607,25103,25509,25760,24289,24140,22655,23541,170997
33609,17187,17293,16829,16963,17197,16912,15999,118380
33610,42342,42133,41883,40469,41120,40041,39222,287210
33611,32155,31075,31277,31187,30147,29959,29478,215278
33612,45980,45358,44552,46167,44965,45125,44601,316748
33613,33549,31259,32016,31066,31389,32207,31990,223476
33614,47755,48076,47901,48125,47421,46629,46449,332356
33615,46297,46860,46788,45317,45916,45729,43453,320360
33616,15006,14827,13662,13673,13478,13094,13560,97300
33617,45466,43534,42441,43738,42831,42453,41443,301906
33618,26123,25790,25559,24843,24522,24607,25570,177014
33619,37034,36451,35333,34486,34483,33745,34581,246113
33620,5178,5150,4772,4282,3765,3429,5158,31734
33621,2384,2141,1860,2130,1862,1863,1643,13883
33624,38513,39931,39109,38931,39780,39469,37457,273190
33625,26024,25377,25255,25164,24563,24742,24645,175770
33626,29178,29066,28390,27623,26533,26050,27557,194397
33629,26022,25382,24362,23700,24430,24427,23638,171961
33634,20264,19816,19920,19659,19186,17889,20225,136959
33635,17166,16655,16579,15937,15322,14976,15741,112376
33637,15608,15241,15819,15532,15326,15108,15351,107985
33647,63542,61924,59933,59375,59098,57577,55034,416483
33701,15170,14848,14404,14168,13727,13260,15014,100591
33702,29829,29762,30479,30219,30125,30517,29664,210595
33703,24141,23885,23598,23571,24271,24456,23680,167602
33704,16398,16387,16563,16752,16925,16149,16098,115272
33705,27154,27082,25865,26400,25829,26820,26435,185585
33706,16220,16130,16064,16030,16051,16110,15901,112506
33707,24833,24846,24572,24718,24752,25123,24599,173443
33708,16194,15869,15286,14910,14757,14565,15447,107028
33709,26883,26807,26243,25210,24607,24615,26023,180388
33710,33977,33125,33040,32494,32565,32648,32780,230629
33711,19639,18899,18916,18910,19303,19774,19162,134603
33712,25769,25530,25312,25353,25261,25606,25066,177897
33713,31805,31421,31068,30668,30045,29833,29812,214652
33714,19499,19260,19152,19039,18930,19006,18531,133417
33715,7108,7187,6828,6561,6510,6660,7407,48261
33716,17090,16565,16073,15138,14840,13873,15424,109003
33744,173,169,133,131,129,132,148,1015
33755,24860,24737,24333,24324,24550,24610,26146,173560
33756,31910,30839,30624,30048,29839,29567,31275,214102
33759,17840,17762,17410,17294,16742,17223,17820,122091
33760,17401,17034,16946,16039,15092,15576,15133,113221
33761,19579,19523,19045,19000,18986,18771,18167,133071
33762,7210,7278,7062,7295,7370,8059,8499,52773
33763,18096,18839,18897,19083,18702,19260,17887,130764
33764,25754,25178,25459,25311,25394,25403,24045,176544
33765,14338,13623,13496,13409,13888,14020,13275,96049
33767,8065,8202,8510,8705,7873,7461,8007,56823
33770,25687,25022,24707,25740,25200,25039,25281,176676
33771,28475,28269,28234,27470,28431,28697,29839,199415
33772,22242,21643,22234,22669,22093,21819,22981,155681
33773,17366,17440,17485,18003,17302,17532,16826,121954
33774,18751,19269,19239,18407,18772,17432,17712,129582
33776,12746,12740,12574,12943,13460,13710,12402,90575
33777,16380,16549,16704,16835,17171,18088,17140,118867
33778,14377,14444,14240,14507,14740,14536,14263,101107
33781,25180,25777,25937,25515,26007,25679,25922,180017
33782,22918,21898,21671,21928,21153,20400,20850,150818
33785,5711,5641,5545,5570,5656,5727,5533,39383
33786,1671,1747,1766,1538,1609,1626,1669,11626
33801,35695,34941,33975,33614,32288,32998,33741,237252
33803,28901,28192,27775,26976,27818,27657,27094,194413
33805,24087,24223,24931,24060,23131,23681,23153,167266
33809,28687,29024,28990,28934,29874,30017,28929,204455
33810,48891,46998,47675,47995,48057,46999,44254,330869
33811,21216,20793,20677,20011,20050,19542,20980,143269
33812,12824,14077,13683,13896,13661,13400,13166,94707
33813,35630,33238,32155,31118,31590,30826,31698,226255
33815,14274,14104,14303,14389,13662,14055,14267,99054
33823,30488,30238,29351,28428,29046,28780,28874,205205
33825,26187,25488,25848,25908,25888,25019,24942,179280
33827,2993,2727,2702,2771,2612,2543,3036,19384
33830,27385,26961,26273,26635,26274,26190,27542,187260
33834,7981,7693,7742,7841,7554,7733,7448,53992
33837,23717,22324,20696,19842,19794,20075,20234,146682
33838,3822,3695,3607,3611,3618,3596,3515,25464
33839,2787,2835,2972,2880,2944,2581,2756,19755
33841,9005,9056,8769,8819,9140,8769,8722,62280
33843,12967,12583,12111,12726,12137,11908,11093,85525
33844,34703,34612,34001,34536,32669,32230,33804,236555
33847,156,184,236,212,199,241,227,1455
33848,1067,1492,1452,1727,1210,1111,851,8910
33849,909,1089,744,797,1049,1061,856,6505
33850,8033,7709,7559,7279,7036,6868,7519,52003
33851,974,888,898,863,745,856,907,6131
33852,20182,20409,20915,20050,20669,20689,21790,144704
33853,12063,11864,11678,11044,10781,10723,11161,79314
33854,77,109,88,108,155,145,194,876
33855,15,15,15,16,16,0,43,120
33856,449,511,501,465,351,399,487,3163
33857,1597,1560,1696,1796,1937,1760,1728,12074
33859,10200,9950,9888,10807,9975,9869,10582,71271
33860,23132,22607,22310,22487,22793,22989,22886,159204
33865,426,611,745,692,806,719,786,4785
33867,417,418,344,373,350,369,106,2377
33868,11490,12208,12547,12596,12876,12679,11720,86116
33870,21036,20655,20400,21626,21952,21838,20601,148108
33872,16134,15702,15058,14204,14306,14480,14158,104042
33873,13841,14244,13828,13421,13229,13706,14742,97011
33875,10245,10239,10051,10621,10197,10667,11108,73128
33876,4510,5285,5173,4916,4713,5101,4968,34666
33877,504,368,347,317,221,194,276,2227
33880,37192,37327,37577,36076,36329,36672,37798,258971
33881,31396,31356,30954,30224,30428,30148,29345,213851
33884,29577,29845,29765,28995,28925,28198,28763,204068
33890,5180,4993,5361,5449,5825,5795,5060,37663
33896,9137,8980,8497,8746,7591,7433,6633,57017
33897,17854,16609,15870,15846,14599,14521,14117,109416
33898,16368,16144,16231,15409,15488,15212,15355,110207
33901,20108,19475,18924,18928,18529,18075,19500,133539
33903,21738,21263,19883,19222,18987,20464,20776,142333
33904,32494,32029,30999,29636,29933,30913,30613,216617
33905,35997,33950,32491,30339,30511,31310,31203,225801
33907,22991,21379,21309,20032,19895,19392,22138,147136
33908,35728,35361,34627,33418,34013,32555,38251,243953
33909,26748,25644,24411,24072,22633,21063,23119,167690
33912,16555,16121,16381,16418,16041,15880,15392,112788
33913,19673,17883,17789,17529,17868,17641,17103,125486
33914,36854,37610,37226,37707,37842,37906,35848,260993
33916,22130,21720,22068,23037,22819,22816,20134,154724
33917,29254,29743,29379,29694,29759,29371,28666,205866
33919,28784,28441,29066,28364,28509,29290,27837,200291
33920,5218,4957,5125,5281,5439,5613,4947,36580
33921,1065,1145,1230,1172,1186,866,1720,8384
33922,3434,3509,3596,4231,4133,3908,4055,26866
33924,233,178,164,180,225,180,761,1921
33928,23428,22635,20556,20312,20235,19774,20830,147770
33930,789,847,989,1022,884,1223,1075,6829
33931,10263,10158,10289,10156,10509,10624,10005,72004
33935,19242,18943,17549,18303,19356,19180,20383,132956
33936,20619,21040,21176,22185,22197,22552,18994,148763
33944,491,331,450,359,590,238,298,2757
33945,0,0,40,36,33,30,57,196
33946,2052,2084,1878,1676,1801,1725,2125,13341
33947,8739,8473,8342,8183,8466,8852,8180,59235
33948,16570,16065,15457,15860,16168,15942,15958,112020
33950,20697,19958,19674,19723,19618,19281,20699,139650
33952,31044,30025,29835,29083,29968,29089,28382,207426
33953,6454,5855,5654,5058,5031,4773,5522,38347
33954,8329,8936,9107,10199,9806,9930,9290,65597
33955,10912,10195,9897,9824,9329,10243,10060,70460
33956,3667,3900,3741,3451,3435,3202,3776,25172
33957,7044,6899,6761,6655,6604,6610,6469,47042
33960,698,827,1050,1077,1043,1027,854,6576
33965,1539,1631,1116,1011,983,750,1648,8678
33966,9431,8660,8348,8622,8786,9307,8251,61405
33967,23600,23729,22793,23778,24228,23701,22799,164628
33971,24681,24657,23774,23443,22705,21533,19730,160523
33972,15479,14339,13298,12502,10967,10581,10880,88046
33973,14281,14177,13254,12837,11406,11405,10798,88158
33974,17560,16640,16816,13826,11703,10053,11982,98580
33976,17625,17180,16631,14885,14014,13109,12534,105978
33980,12038,11849,11048,10701,9787,10142,10322,75887
33981,9716,9857,9634,9641,9306,9301,9534,66989
33982,11108,10528,10320,10095,9837,9846,9176,70910
33983,15223,15376,15425,14625,14229,13786,13954,102618
33990,32586,31557,31037,30027,29797,29045,28173,212222
33991,20230,18626,17794,16711,15885,16225,18010,123481
33993,23312,22468,22576,22250,21285,19275,20628,151794
34101,0,0,0,0,0,0,10,10
34102,11191,11464,11246,10647,10754,10645,10460,76407
34103,12763,12247,11912,12412,12352,13103,12150,86939
34104,24227,24757,24325,24638,23901,24672,23691,170211
34105,16196,15685,15465,15381,14450,14266,13933,105376
34108,16595,16548,16992,17098,17185,17314,16874,118606
34109,24349,24767,24728,24496,24459,22442,23338,168579
34110,23113,22052,22094,21430,20822,19778,20762,150051
34112,25700,24979,24974,26141,26422,26522,27002,181740
34113,18852,18523,18339,17948,18078,19034,17971,128745
34114,15609,14319,13580,14325,14120,14056,13653,99662
34116,35256,34956,34445,33537,31798,30939,30005,230936
34117,14970,15015,15408,14983,15229,16124,14250,105979
34119,29568,28297,25218,24351,23713,24481,25756,181384
34120,31238,28748,27890,26567,27325,25215,26147,193130
34134,13865,13425,13705,13629,14188,14141,14112,97065
34135,42580,41640,39473,38434,37330,36990,37315,273762
34137,149,214,237,223,129,187,227,1366
34138,130,418,421,472,523,485,359,2808
34139,752,720,943,424,373,334,561,4107
34140,260,330,285,297,261,239,273,1945
34141,56,55,104,122,129,192,232,890
34142,29287,29450,28824,26130,25075,23496,27304,189566
34145,17361,17148,16921,16702,16570,16573,16407,117682
34201,4025,3806,3580,3960,3832,3593,3682,26478
34202,21733,21871,20452,20918,20802,20509,19816,146101
34203,36583,36866,36694,36806,35824,36678,34862,254313
34205,30823,29855,30264,29687,29971,31272,29656,211528
34207,34260,33683,31800,30082,29230,28667,29728,217450
34208,38366,37714,35170,34315,34069,32496,33121,245251
34209,34324,33345,32883,33008,32610,31908,31816,229894
34210,17462,16271,15906,14925,15323,15318,15916,111121
34211,5358,4627,3820,3070,2494,2766,2775,24910
34212,16827,16032,15663,15213,15443,14986,15146,109310
34215,316,477,622,657,873,990,768,4703
34216,1133,1224,1223,1559,1389,1514,1503,9545
34217,5026,4991,5115,5079,5142,5421,5007,35781
34219,21769,20609,19589,18073,16642,15316,17135,129133
34221,42159,40753,41684,41287,39306,39279,39457,283925
34222,11161,10843,11521,11055,11470,11082,11952,79084
34223,16667,16882,16861,17231,17322,16858,16875,118696
34224,15783,15690,15604,15432,15443,16109,15394,109455
34228,7158,7072,7003,6658,6612,6706,6888,48097
34229,7505,7647,7275,6970,6997,6900,7192,50486
34231,29687,29042,29910,28730,29592,29035,30268,206264
34232,34433,33261,32993,33171,31574,31630,30969,228031
34233,17536,17849,17782,17556,17363,17094,16653,121833
34234,21405,20519,20349,20296,20509,20173,19788,143039
34235,14426,13716,13735,13462,13922,14551,13640,97452
34236,12157,11843,11111,10571,10337,10895,12394,79308
34237,17456,17264,17525,17390,17033,17330,16304,120302
34238,18429,18606,17709,17205,17153,17247,17500,123849
34239,14993,15310,15436,15615,16809,16165,15038,109366
34240,11463,11227,11197,11835,11715,11976,11501,80914
34241,14074,14052,13523,13781,13930,13995,13590,96945
34242,7566,8025,8109,8534,8673,8987,8865,58759
34243,29158,27819,26683,26018,26315,25402,26115,187510
34251,5247,5348,5373,5819,6031,6007,6351,40176
34266,31040,31543,30946,30842,30640,30741,31055,216807
34268,68,25,199,187,214,230,220,1143
34269,4087,3498,3732,3683,3774,3698,3615,26087
34275,18040,17377,16470,16309,16020,15960,16245,116421
34285,18462,18361,18338,18019,17910,17762,17599,126451
34286,20726,21428,21423,20700,20157,19390,17970,141794
34287,25450,24274,25498,24627,24037,23284,23859,171029
34288,10825,10749,9839,11039,11001,10709,10856,75018
34289,2329,2042,1963,1459,1405,1039,2199,12436
34291,5901,5533,4946,4678,4487,4684,7125,37354
34292,15784,15536,14828,14368,13645,13179,13516,100856
34293,35624,34343,33475,33236,32840,33121,33001,235640
34420,14639,15004,16251,16322,16994,17332,16287,112829
34428,9522,9195,9702,9988,9630,9369,9109,66515
34429,7430,6961,7156,7569,7919,8232,8563,53830
34431,7803,7883,7857,7738,7616,7725,7815,54437
34432,13346,12828,12726,12975,12845,12649,12273,89642
34433,5364,5060,5305,5947,6013,6557,6647,40893
34434,8416,8089,8017,8520,8071,7862,8191,57166
34436,8036,7589,7091,7124,7252,7255,7938,52285
34442,14693,15025,14772,15068,14066,13612,14568,101804
34445,0,0,0,0,0,18,44,62
34446,16397,16901,17724,16921,17492,17863,16326,119624
34448,10413,10204,10505,10944,11158,11368,10797,75389
34449,2627,2560,2490,2803,3051,3159,2809,19499
34450,10709,10510,10381,10092,10867,10832,10293,73684
34452,11180,11268,11192,11255,11548,10935,11919,79297
34453,10708,10915,11390,10829,10579,11251,10112,75784
34461,10077,10262,9620,9863,10021,9989,10562,70394
34465,17244,17491,16722,15807,15822,15613,15870,114569
34470,18425,18580,18470,18722,18196,19135,17838,129366
34471,25419,23968,23857,24689,24454,24739,25152,172278
34472,29246,28087,27063,25861,25929,26915,25968,189069
34473,20310,19533,18688,17895,17280,16066,17029,126801
34474,15894,16210,15903,15100,15691,15225,16062,110085
34475,12607,13552,13245,13564,13275,12539,12177,90959
34476,22141,22517,22150,22582,22764,21802,20862,154818
34479,13941,13031,13167,13241,14013,14353,13032,94778
34480,18685,20024,19173,18785,18388,18462,19068,132585
34481,18536,17908,17599,17390,16529,16442,17536,121940
34482,23801,23058,23109,23041,22964,22173,22500,160646
34484,3811,3818,3632,3176,2976,2211,3069,22693
34488,10106,10372,10951,10429,10723,10526,10291,73398
34491,26153,25209,26705,26684,27256,27440,27454,186901
34498,569,514,481,572,565,617,513,3831
34601,21186,21410,21199,20986,21691,21645,22336,150453
34602,7331,7118,7470,7654,7457,7321,7346,51697
34604,10510,10304,10201,10495,10327,9887,10003,71727
34606,25940,26117,25874,25903,25331,25527,26208,180900
34607,8772,8430,8330,7668,7815,8084,8133,57232
34608,33554,32628,32323,31874,32131,31205,31099,224814
34609,38775,38684,37710,37643,37921,37866,37129,265728
34610,13276,12527,12014,11708,11553,11584,12907,85569
34613,17801,17308,17780,18136,17970,17816,17814,124625
34614,6857,6832,6607,6835,6085,6298,6692,46206
34637,7981,8014,7386,6410,6167,5487,6297,47742
34638,25073,23962,23088,22234,20556,18506,20048,153467
34639,26816,25779,25323,24985,24146,24359,24092,175500
34652,23592,24037,23583,22541,23506,22720,24147,164126
34653,34516,32273,31879,30502,30684,30537,30756,221147
34654,22502,21717,21724,21772,21619,22235,21716,153285
34655,38844,38566,37790,38613,37625,37511,38464,267413
34661,194,356,364,278,249,220,297,1958
34667,32610,32159,32247,33097,32000,31468,32144,225725
34668,44664,44051,42187,43069,42317,43097,42619,302004
34669,12192,11940,12321,12585,12533,12755,12648,86974
34677,21374,21136,21123,21268,20712,20633,20842,147088
34679,75,63,54,10,11,0,99,312
34681,894,1186,1240,1471,1808,1588,1294,9481
34683,32292,31688,31958,31822,32110,32297,31268,223435
34684,28148,27849,27039,27046,27372,26570,25847,189871
34685,18434,18429,17816,17169,17624,17524,17286,124282
34688,7245,7510,8249,8628,7936,7717,7274,54559
34689,27173,26589,26215,25660,25933,25590,26132,183292
34690,12152,12697,13019,12557,12696,12404,13137,88662
34691,19758,19261,19732,19479,20685,21668,21079,141662
34695,17695,17679,17456,17466,17572,17530,17496,122894
34698,37854,38185,38220,37580,37665,37975,37240,264719
34705,2707,2560,2830,2873,2673,2778,2500,18921
34711,55442,55510,54626,54609,53748,52207,51847,377989
34714,19463,17776,17684,14766,14577,14916,14685,113867
34715,16478,16071,15228,15266,15359,15280,15455,109137
34731,10926,10490,10884,11033,10533,10935,10815,75616
34734,4069,4712,4785,4001,3996,3915,3835,29313
34736,15834,15161,14609,14748,14191,13773,13961,102277
34737,2427,2430,2403,2384,2379,2563,2523,17109
34739,421,385,564,763,944,1062,793,4932
34741,45820,44926,43399,43203,41694,41542,40828,301412
34743,40282,39499,38996,37575,36340,35275,33632,261599
34744,50225,46941,45925,44675,44902,42681,44142,319491
34746,41043,39984,37307,34727,33630,32523,35022,254236
34747,16598,15940,15294,13372,13690,12750,13692,101336
34748,38861,39256,39441,38524,40141,39402,38246,273871
34753,5592,5759,5477,5248,5435,5409,5353,38273
34756,3652,3548,3549,3253,3115,2799,3006,22922
34758,37311,37021,34310,33208,30408,30254,30879,233391
34759,35558,33320,31739,32221,31411,29095,30170,223514
34760,851,801,819,809,736,548,875,5439
34761,42941,41895,40547,39269,37882,37200,37500,277234
34762,396,406,390,373,642,760,622,3589
34769,22523,21314,21358,21141,20909,21800,21399,150444
34771,14281,13047,12620,13632,14212,13445,14280,95517
34772,29182,27889,25777,23642,22734,22137,22770,174131
34773,3739,3509,3738,3379,3432,2731,2983,23511
34785,26163,21993,19201,17903,17480,18520,17406,138666
34786,38249,34328,31740,30904,27543,26776,28092,217632
34787,55845,53496,50440,47990,46101,44162,46083,344117
34788,17401,16912,17473,18002,16827,16958,17519,121092
34797,796,1087,1189,1092,1184,991,1293,7632
34945,5774,5495,5159,5003,5048,4522,5514,36515
34946,6753,6134,6023,6108,6418,6376,6025,43837
34947,13276,12501,12239,11922,12291,12134,12186,86549
34949,7239,7143,6959,6435,6077,6051,7103,47007
34950,15099,15120,14980,14888,15770,16051,15436,107344
34951,14993,14891,14492,14087,14880,14902,14115,102360
34952,38951,38026,37284,37958,37535,37339,38285,265378
34953,66911,65295,64479,61457,60648,59517,61494,439801
34956,9970,10585,10255,10781,10865,10211,9874,72541
34957,22071,21848,21605,21616,22304,23255,22257,154956
34972,20053,20712,20230,20461,20050,20283,20180,141969
34974,22941,22051,23144,23317,23917,23739,23661,162770
34981,5787,5418,5334,5100,3802,3932,4239,33612
34982,23833,24770,24914,25949,25470,26353,24544,175833
34983,41469,39922,39980,39681,38875,38189,38480,276596
34984,15023,15524,14669,14196,14160,14008,13764,101344
34986,24100,24610,24690,24754,23887,23013,23297,168351
34987,7167,6607,6297,6439,5940,5511,6118,44079
34990,28134,27687,27680,27793,27331,27355,27707,193687
34994,16955,17471,16762,17083,16548,16273,15967,117059
34996,11039,10208,10267,10099,10328,10040,10649,72630
34997,42971,42507,42151,41169,40650,38625,40405,288478
35004,10418,9974,9759,9542,10080,9766,10427,69966
35005,7708,7687,7923,8150,8353,8411,7942,56174
35006,3099,3201,3126,3104,3403,3104,3121,22158
35007,26630,26499,27001,26722,26757,25954,26225,185788
35010,20826,21153,21019,21050,21055,21289,20816,147208
35013,43,54,22,42,41,42,124,368
35014,4077,4035,4023,4767,5140,5151,4546,31739
35016,15997,16348,16135,17245,16507,16628,16778,115638
35019,2358,1918,1594,1612,1763,2069,2117,13431
35020,27134,26729,26604,26675,25924,26898,27139,187103
35022,19416,20020,19998,19431,19053,18276,18888,135082
35023,25049,25407,25405,24959,25278,25286,25436,176820
35031,8306,8046,7939,7764,7681,7485,7933,55154
35032,76,61,63,68,89,69,66,492
35033,3532,3467,3508,3540,3276,3693,3403,24419
35034,4804,4656,4390,4839,4936,4952,5541,34118
35035,1203,1426,1556,1468,1465,1397,1581,10096
35036,294,256,280,208,233,264,297,1832
35040,16646,16059,16064,15679,14828,14384,14965,108625
35042,5813,5932,6313,6139,6172,6340,5831,42540
35043,10584,10101,10004,9346,8674,8265,9234,66208
35044,8076,7816,7396,7794,7850,7849,7713,54494
35045,14795,14121,14524,14358,13993,13770,14870,100431
35046,5028,5032,4909,4908,5203,4823,5108,35011
35049,3726,3980,4123,4270,4306,4308,3996,28709
35051,8753,8868,8996,9383,9179,8835,8787,62801
35052,263,255,189,163,115,149,277,1411
35053,2614,2906,2966,2726,2836,2743,2617,19408
35054,3974,3774,3942,4297,3979,4123,4101,28190
35055,20520,20290,20276,20244,20543,20278,19427,141578
35057,13090,12529,12943,12434,11904,11849,12630,87379
35058,9441,9565,9897,9180,9020,8802,9936,65841
35060,306,344,297,303,289,431,414,2384
35061,1381,1357,1438,1499,1272,1507,1465,9919
35062,7670,7482,7608,7236,7076,7537,7944,52553
35063,3879,3900,3851,3793,3701,4006,3866,26996
35064,11392,11415,11400,11628,11605,11592,11458,80490
35068,8201,7966,7879,7764,7141,7114,7232,53297
35070,276,235,252,328,292,313,265,1961
35071,15815,15763,16042,15968,16256,15683,15661,111188
35072,4647,5036,5078,5009,4991,5332,5193,35286
35073,2213,2506,2426,2488,2618,2438,2382,17071
35074,0,101,112,103,111,137,93,657
35077,12676,12190,11991,12525,13478,13090,13142,89092
35078,2207,2106,2223,2355,2422,2443,2082,15838
35079,8647,8861,9309,9478,9170,9401,8810,63676
35080,16882,16381,16238,15821,16333,15821,15881,113357
35082,0,0,0,0,0,0,7,7
35083,3611,3670,3629,3608,3411,3226,3268,24423
35085,8646,8832,8555,7906,8588,9286,8933,60746
35087,1688,1448,1459,1448,1379,1394,2115,10931
35089,1795,1744,2081,2098,2621,2829,2238,15406
35091,3010,2932,2871,2793,2760,2549,2719,19634
35094,14281,14735,14556,14953,14465,14389,14212,101591
35096,7866,7786,7756,8234,8332,8680,7815,56469
35097,2082,2047,1896,1798,1733,1800,1748,13104
35098,1208,1485,1548,1652,1624,1455,1375,10347
35111,16781,16284,16593,16691,15915,15680,16140,114084
35112,306,351,443,732,352,610,801,3595
35114,8053,7953,6920,6906,6666,6748,7172,50418
35115,14532,14386,14581,14676,13928,13787,14118,100008
35116,4113,4110,4202,4204,3995,4241,4240,29105
35117,5359,5217,5548,5550,5574,5491,5367,38106
35118,3182,3046,3040,3239,3103,2887,3138,21635
35119,92,160,74,71,72,88,116,673
35120,14311,14796,14942,14674,14663,14097,13842,101325
35121,15135,15080,14670,14918,15059,14648,15570,105080
35124,24374,23805,23135,23188,22839,22515,23020,162876
35125,10855,10205,10998,10332,10477,10336,10456,73659
35126,21507,21253,21510,21741,20971,20439,21725,149146
35127,10284,10270,10196,10315,10277,10157,10099,71598
35128,10187,10336,9523,9527,9154,9136,10197,68060
35130,2959,3101,3045,2981,3141,3165,3233,21625
35131,4388,4189,3822,4196,4575,4466,4159,29795
35133,3058,3399,3574,3490,3959,4138,3907,25525
35135,1618,1856,1610,1734,1662,1671,1812,11963
35136,1960,1879,1691,1695,1996,1843,1796,12860
35139,159,260,246,182,198,134,150,1329
35143,3432,3239,3236,3131,3010,3478,3281,22807
35146,12560,12572,12180,12120,11897,11473,10948,83750
35147,5861,5766,5938,5961,6049,5926,5468,40969
35148,2822,2855,2779,3123,3293,3273,2702,20847
35149,561,472,649,630,452,417,630,3811
35150,17526,18260,19612,19594,18936,18766,18472,131166
35151,7172,7346,7307,7621,7481,7332,7632,51891
35160,26350,26320,26177,24935,25342,25291,26822,181237
35171,3826,3963,3879,3591,3776,3526,3281,25842
35172,3032,2688,2867,3163,3463,3405,2986,21604
35173,26597,26887,26092,25294,24991,24886,25176,179923
35175,5888,5578,5814,5017,4999,5141,5041,37478
35176,811,850,847,824,859,887,921,5999
35178,4042,4199,4204,3539,3452,3345,3378,26159
35179,9601,9660,9177,9334,9171,9670,8958,65571
35180,14380,14444,13913,14377,13511,13297,13794,97716
35183,901,749,618,502,536,561,706,4573
35184,5963,6037,5966,6719,6628,6512,5841,43666
35186,5056,4955,4662,4461,4690,4591,4931,33346
35187,4,22,28,24,16,17,32,143
35188,3280,3296,3229,2300,2500,2471,2715,19791
35203,3106,3193,3379,3457,3382,3349,3798,23664
35204,9911,9941,10655,10899,10881,10751,10337,73375
35205,21124,21141,20206,19755,18840,18411,19686,139163
35206,16476,16938,16761,17619,17797,18277,17177,121045
35207,9506,9239,8994,8963,9584,8877,9010,64173
35208,14529,13693,14042,14167,15294,15515,14855,102095
35209,29599,29463,29283,28683,28437,28511,29544,203520
35210,14269,13763,13190,14117,13974,13442,13952,96707
35211,24101,24637,25601,26414,26505,27510,26236,181004
35212,12579,13372,13525,13046,12875,12232,11539,89168
35213,13412,13925,14029,13988,13599,14092,13185,96230
35214,18008,18114,18399,18962,18735,19422,19592,131232
35215,49475,48062,46911,46629,46884,47215,46951,332127
35216,36047,36098,36523,36494,35954,35688,36408,253212
35217,13152,12980,13017,13290,13854,14056,13729,94078
35218,7065,7379,7042,7494,7952,7998,7353,52283
35221,4715,4987,5031,4975,5342,5677,4834,35561
35222,8698,8488,8372,8120,8492,8583,7884,58637
35223,10723,10660,10704,10536,10668,10725,11043,75059
35224,5416,6051,6061,6185,6560,7126,6094,43493
35226,34755,34514,33288,32299,31427,30688,31471,228442
35228,10135,10146,10257,9903,9810,9849,10419,70519
35229,1195,1122,1396,1420,1309,1395,940,8777
35233,1503,1393,1194,917,626,594,1308,7535
35234,5298,5264,6433,6066,6109,6492,6311,41973
35235,18585,18730,19073,19873,20363,19840,19484,135948
35242,51902,52466,51331,50052,49551,48321,49545,353168
35243,17585,16870,16908,16826,17207,16953,17328,119677
35244,33562,33470,33128,32586,32218,31413,32390,228767
35254,1284,1351,1176,1094,820,845,1403,7973
35401,37272,36746,36621,36782,37089,36195,39878,260583
35404,21218,21397,21484,21276,22048,22185,21251,150859
35405,43724,43981,43643,42602,42068,40873,37661,294552
35406,16727,15639,15314,14963,14132,14312,13864,104951
35441,1000,1067,1042,1018,933,1138,1060,7258
35442,5847,5515,5420,5485,5242,5484,4972,37965
35443,2192,1992,1614,1769,1680,1740,2009,12996
35444,4028,4001,4019,3894,3935,4014,3699,27590
35446,1912,1956,1690,1675,1842,1825,2234,13134
35447,3110,3159,3253,3365,3467,3624,3460,23438
35452,3275,3337,3451,3571,3380,3789,3880,24683
35453,11108,11373,11330,11288,10728,10975,11127,77929
35456,3437,2989,2849,2983,3132,3057,3759,22206
35457,36,52,46,83,106,0,82,405
35458,915,739,488,394,307,350,594,3787
35459,1156,959,906,798,915,878,872,6484
35460,569,336,281,303,386,483,834,3192
35461,1996,1875,1987,1812,1772,1906,1952,13300
35462,4462,4442,4924,4750,5198,5241,5061,34078
35463,1341,1455,1421,1618,1801,1582,1749,10967
35464,691,536,600,851,848,834,654,5014
35466,5221,5492,5174,5501,5540,5311,6075,38314
35469,199,172,126,117,81,96,221,1012
35470,4939,5255,5308,5528,5227,5281,5468,37006
35473,15993,15734,15712,16094,15245,14501,14909,108188
35474,6717,5983,6062,5666,5783,5224,6180,41615
35475,15457,15797,15482,14315,14070,13811,14507,103439
35476,7668,7586,7416,7111,7170,7572,8106,52629
35477,210,223,184,136,192,115,335,1395
35480,1237,1307,1444,1234,1082,1025,1343,8672
35481,3611,3808,3901,3748,3934,3734,3668,26404
35490,4188,4156,4178,4182,4329,4465,3857,29355
35501,9919,10439,10754,11077,10931,10453,10424,73997
35503,8574,8387,8520,7742,7831,7652,9068,57774
35504,12665,12710,13055,13536,13405,14411,13596,93378
35540,2319,2337,2459,2502,2043,2108,2415,16183
35541,3305,3259,3220,3109,3538,3239,3597,23267
35542,1218,1264,1352,1377,1349,1183,1021,8764
35543,1374,1573,2047,1752,1786,1746,1137,11415
35544,643,797,813,1151,1021,975,673,6073
35545,86,89,94,74,50,51,100,544
35546,3978,3719,3653,4011,3831,3818,3901,26911
35548,1762,1766,1706,1830,1736,1723,1558,12081
35549,4345,4213,4338,4679,4601,4531,4341,31048
35550,5579,5065,5000,5180,5638,5710,5605,37777
35552,867,1000,895,973,1130,1096,1044,7005
35553,4356,4584,4587,4596,4639,4639,4680,32081
35554,991,1027,1130,1142,997,1235,1186,7708
35555,9695,9807,9934,10003,9738,9856,10177,69210
35559,18,16,18,35,25,75,57,244
35563,4871,4603,4520,4416,4312,3985,4340,31047
35564,2078,2186,2215,2185,2266,2362,2361,15653
35565,13166,13115,12539,12391,12437,12562,13485,89695
35570,11606,11343,11530,11432,11484,11442,11145,79982
35571,753,885,809,814,969,874,895,5999
35572,1215,1101,996,1351,1187,1288,1131,8269
35574,1480,1323,1169,1176,1225,1124,1507,9004
35575,976,1037,1038,1027,923,1212,1018,7231
35576,2906,3033,2914,2739,2860,2965,3217,20634
35577,47,32,32,24,38,29,38,240
35578,5969,5810,5719,5489,5610,5687,5833,40117
35579,3244,3340,3367,3166,3197,3092,3136,22542
35580,4016,4310,4060,4315,4504,4143,3791,29139
35581,4989,4917,4849,4982,5351,5215,5778,36081
35582,3954,4022,4154,4055,4060,4067,4093,28405
35584,399,454,362,519,655,496,460,3345
35585,1479,1389,1154,1224,1258,1353,1418,9275
35586,4068,4032,4313,4482,4456,4469,4469,30289
35587,1230,1376,1336,1297,1227,1063,1025,8554
35592,5059,4831,4731,4420,4375,4693,4664,32773
35593,1847,2206,2118,2313,2106,1840,1931,14361
35594,7094,7276,7400,7615,7790,7898,7794,52867
35601,33275,33493,33982,34236,33794,33513,34434,236727
35603,31045,31058,30577,30396,30687,30604,30545,214912
35610,2133,1931,2084,2177,2042,1950,2252,14569
35611,25464,25405,25442,25791,25171,25346,25251,177870
35613,23820,23796,22953,21373,20926,19903,20546,153317
35614,8673,8561,8658,8342,7779,7157,7456,56626
35615,180,94,77,0,0,0,68,419
35616,4332,4276,4153,4245,4141,3966,4043,29156
35618,1962,1887,1820,1852,1878,1718,1870,12987
35619,4374,4586,4799,4992,5340,5543,5135,34769
35620,8749,8397,8350,8361,8451,8457,8868,59633
35621,3297,3208,2908,2821,2812,2638,2852,20536
35622,7488,7897,7340,7109,7207,6734,7388,51163
35630,33478,33352,33561,33178,33283,32553,32629,232034
35633,21465,21085,20584,20624,20329,20424,20877,145388
35634,9317,9638,9814,9227,9108,9466,9711,66281
35640,25434,25359,25681,25913,25080,24902,24267,176636
35643,3086,2907,2775,2777,2964,3146,2941,20596
35645,13992,14731,14812,15463,15774,15725,14060,104557
35646,4317,4249,4154,4146,4061,4163,4635,29725
35647,874,1008,1055,1019,1158,1042,1030,7186
35648,3067,2919,2971,3111,3379,3495,3635,22577
35649,113,126,105,93,93,60,68,658
35650,14442,14325,14535,14166,14130,14372,13971,99941
35651,1512,1562,1647,1392,1279,1175,1312,9879
35652,8338,8274,7969,7882,7507,7596,8190,55756
35653,11908,12155,12260,11916,12097,11848,11150,83334
35654,8174,7675,7893,8195,8292,8696,8685,57610
35660,9067,9074,9067,9046,9060,9098,9042,63454
35661,16861,17519,17720,17926,17601,17614,16617,121858
35670,6720,6848,6842,7485,7578,7786,7676,50935
35671,2018,2033,2042,2061,2175,2175,2107,14611
35672,6104,6009,5950,5798,6293,6121,6445,42720
35673,7365,7625,7855,8060,7715,7777,8199,54596
35674,18041,17674,17948,17685,17889,18106,18475,125818
35677,1445,1462,1545,1620,1589,1590,1921,11172
35739,5458,5666,6036,5990,5471,5357,5146,39124
35740,3413,3383,3433,3413,3272,3339,3482,23735
35741,2950,3057,3032,3087,3211,2681,2933,20951
35744,2466,2863,2836,2895,2626,2528,2570,18784
35745,216,186,220,239,205,213,288,1567
35746,697,664,605,768,803,920,856,5313
35747,5571,5433,5575,5703,5801,5562,5901,39546
35748,6719,6532,6192,6030,6584,6427,6276,44760
35749,21063,20446,19989,20362,19910,19858,20575,142203
35750,12206,12179,12007,12267,12165,12102,12783,85709
35751,193,230,368,377,440,268,265,2141
35752,2876,2646,2044,1898,1727,1789,2047,15027
35754,5182,5364,5181,5243,5284,5449,5362,37065
35755,619,630,671,554,527,464,586,4051
35756,12582,11649,10545,9747,9044,8133,9016,70716
35757,15036,14070,14252,13997,13080,12939,12840,96214
35758,45052,44472,43926,43105,41817,40469,41875,300716
35759,7410,7501,7033,7213,6750,5845,6406,48158
35760,4762,4848,4975,5141,5277,4986,5065,35054
35761,12087,11736,11443,11025,10718,10258,11630,78897
35763,16908,15282,15235,15178,14958,14259,14216,106036
35764,741,711,643,681,559,765,653,4753
35765,3342,3395,3467,3604,3467,3648,4013,24936
35766,132,118,137,154,185,270,150,1146
35768,11334,11853,12180,12310,11982,12090,11581,83330
35769,9786,9830,9642,9682,9518,9354,9537,67349
35771,3851,3527,3722,3708,4084,3995,3645,26532
35772,4396,4600,5107,4682,5076,5125,4908,33894
35773,12497,12160,12582,12601,13727,13768,13018,90353
35774,126,130,173,133,156,179,165,1062
35775,507,564,531,514,666,595,636,4013
35776,3895,3790,3672,3876,3776,3703,3395,26107
35801,23598,22813,22111,22253,21915,22242,21509,156441
35802,21562,21349,21212,20752,20839,20808,21297,147819
35803,26645,27282,26543,26306,25394,26557,25471,184198
35805,21464,22523,22449,22145,22550,22388,22498,156017
35806,21216,20629,20143,19260,18779,17918,18951,136896
35808,1592,1662,1570,1475,1580,1713,1946,11538
35810,29631,30303,31133,31080,31415,31131,30617,215310
35811,28014,27871,28010,26993,25977,25533,25955,188353
35816,13547,14205,14122,14274,14605,14386,15228,100367
35824,7208,6386,6132,6066,5467,5228,6070,42557
35896,677,680,608,636,612,643,636,4492
35901,20016,19573,20216,20451,20196,19810,20045,140307
35903,17106,17709,17316,18189,18023,18102,18088,124533
35904,14494,14274,14071,13519,13598,13867,14194,98017
35905,6433,6663,6730,6281,6594,6762,6410,45873
35906,9959,10064,10103,10059,9874,9901,9897,69857
35907,8422,8391,8388,8339,8209,8104,8345,58198
35950,21342,21456,21779,21496,21137,20491,20826,148527
35951,12143,11712,12549,12839,14177,13958,13098,90476
35952,7283,7185,7578,7675,7863,8248,7727,53559
35953,7602,7066,7044,6548,6736,6894,7319,49209
35954,11447,11982,11996,12487,13089,12494,12416,85911
35956,9144,8916,8826,8716,8437,8504,8842,61385
35957,16553,15989,16048,15906,15770,15431,15693,111390
35958,3239,3010,2885,3162,3031,3758,3582,22667
35959,4677,4709,4420,4479,4336,4484,4836,31941
35960,10388,10187,10345,10364,10080,9877,10087,71328
35961,7041,7169,6459,7162,6733,6604,6514,47682
35962,9691,10237,9189,7925,7767,7628,8300,60737
35963,1284,1852,1836,1681,1497,1416,1704,11270
35966,3896,3967,3822,3602,4698,4156,3914,28055
35967,16485,16502,16543,16265,16396,16234,16630,115055
35968,4410,4054,3804,3483,3718,3643,4575,27687
35971,5280,5214,5344,5794,6075,5976,4914,38597
35972,1300,1014,1194,1134,1079,1291,1139,8151
35973,2925,3427,3439,3281,3924,3575,2870,23441
35974,1384,1261,1437,1482,1515,1601,1589,10269
35975,580,628,956,1119,1209,1112,1058,6662
35976,17138,17168,17025,16523,16388,16410,16272,116924
35978,5574,5685,5661,5321,5002,4726,5390,37359
35979,1279,1566,1477,1316,1518,1684,1398,10238
35980,4820,5566,5451,5972,5394,5485,5161,37849
35981,1903,2052,2842,3044,3098,2936,2141,18016
35983,3534,3675,3866,3837,3430,3252,3738,25332
35984,1752,2012,1946,1962,1931,2053,1889,13545
35986,7789,7446,7205,7551,7584,7912,7744,53231
35987,2702,2704,2725,2637,2773,2699,2666,18906
35988,2103,2142,2034,2060,1895,1741,1940,13915
35989,3498,3153,3160,3274,3074,3233,3573,22965
35990,164,154,102,59,14,18,38,549
36003,1763,1716,1864,1978,1764,1781,1975,12841
36005,1680,1652,1844,1699,1508,1741,1522,11646
36006,1342,1439,1407,1636,1330,1408,1313,9875
36009,2357,2584,2585,2685,2777,2580,2566,18134
36010,4781,4750,4831,4654,4752,4877,4677,33322
36013,488,554,475,510,445,493,562,3527
36016,4853,5002,5148,4985,5054,4859,5150,35051
36017,2861,2614,3038,3106,3072,3186,3318,21195
36020,1047,1075,950,1100,1088,1079,1123,7462
36022,11615,11709,11409,11733,11163,12451,13092,83172
36024,5083,5082,5032,5250,5178,5519,5428,36572
36025,7110,7185,7503,7059,7109,6446,5729,48141
36026,962,785,732,790,848,713,1089,5919
36027,16159,16633,16217,16347,16224,16619,16261,114460
36028,1811,1870,1846,1784,1841,2147,1746,13045
36029,1094,854,964,786,847,827,723,6095
36030,352,393,377,431,360,366,491,2770
36031,178,135,87,58,57,0,156,671
36032,2405,2290,2403,2207,2213,2314,2339,16171
36033,4132,4287,4107,3996,3900,3973,4299,28694
36034,589,638,663,760,795,871,807,5123
36035,1729,1685,1784,1766,1856,1867,1913,12600
36036,1867,1848,2047,1889,1966,1896,2003,13516
36037,13842,13848,13937,13711,14131,14128,14074,97671
36038,49,68,88,108,90,78,57,538
36039,126,167,193,233,338,243,253,1553
36040,3530,3645,3535,3735,3730,3956,3976,26107
36041,1436,1403,1259,1029,944,761,1318,8150
36042,1806,1464,1233,1359,1143,1487,1500,9992
36043,3637,3382,3348,3114,3380,3239,3666,23766
36046,1363,1554,1809,1715,1587,1742,1490,11260
36047,1162,1086,1253,1182,1299,1311,1396,8689
36048,1430,1330,1329,1365,1534,1543,1459,9990
36049,5597,5613,5847,5798,5874,5900,5706,40335
36051,2154,1751,2260,2170,2199,2030,2304,14868
36052,297,401,692,1161,1077,1060,739,5427
36053,2098,2222,1966,2089,2151,1865,1967,14358
36054,15372,15917,15648,15069,14872,14675,15066,106619
36064,9194,8944,8141,7270,6614,6467,6753,53383
36066,19862,19243,18812,18527,17823,17421,19089,130777
36067,28015,28092,28483,27388,28222,27786,26954,194940
36069,1863,2138,1684,1537,1697,1718,1935,12572
36071,664,608,664,918,839,788,766,5247
36075,2189,2232,2223,2188,2457,2375,2226,15890
36078,13459,12916,13682,13463,13750,13322,13179,93771
36079,9757,10036,9471,9618,9124,8892,9339,66237
36080,2574,2762,2424,2369,2469,2676,2271,17545
36081,16154,15934,16356,16127,16223,16158,15267,112219
36082,1274,1286,1295,1233,1190,1190,1667,9135
36083,8178,8515,8933,8725,8606,9026,9563,61546
36088,4858,4700,4614,4678,4927,4961,4767,33505
36089,7533,7626,7916,8049,8413,8387,8760,56684
36091,3323,3710,3580,4314,3720,4072,3648,26367
36092,20297,19739,19611,20010,20851,20276,20274,141058
36093,10986,11033,10307,10370,9629,9165,9456,70946
36104,8056,8393,8287,8929,9359,10424,9468,62916
36105,10563,10636,11098,11351,11570,12368,12043,79629
36106,14986,15224,14467,14829,14406,14518,15211,103641
36107,7360,7541,8406,8261,8801,9115,9589,59073
36108,19772,20831,20780,21025,21196,22013,21306,146923
36109,24132,24430,23851,24107,25061,25454,24777,171812
36110,12807,12868,12923,12760,13126,12806,12997,90287
36111,12203,12171,12865,12814,13061,13203,12176,88493
36112,364,392,364,394,352,365,553,2784
36113,1753,1706,1685,1621,1575,1646,1902,11888
36115,855,785,712,724,792,777,623,5268
36116,44944,44196,45075,46139,44877,42729,43790,311750
36117,52890,52232,52187,51223,50979,49256,50268,359035
36201,18036,18544,18275,19500,20425,20679,20156,135615
36203,18104,18138,18628,18951,18743,19141,18799,130504
36205,445,461,398,466,605,572,635,3582
36206,11504,12138,11973,11501,11588,11596,11427,81727
36207,20867,20679,20726,20218,19808,19118,19801,141217
36250,4911,4770,4968,4928,4709,4629,4603,33518
36251,5195,5164,5015,4909,5013,4918,5103,35317
36255,753,794,822,852,1060,1025,969,6275
36256,1728,1900,1828,1848,1722,1696,1570,12292
36258,1379,1378,1236,1282,1400,1555,1599,9829
36260,3928,4341,4156,3920,4173,4120,4247,28885
36262,1389,1387,1424,1302,1353,1341,1448,9644
36263,537,757,811,761,888,735,658,5147
36264,8418,8375,8581,8737,9229,9003,8659,61002
36265,20741,20833,20810,21146,20596,20916,21060,146102
36266,5333,5434,5967,6255,5575,5254,5582,39400
36267,122,95,63,32,83,90,35,520
36268,6030,5977,5343,5068,5474,5610,5432,38934
36269,1209,1163,962,1159,1312,1477,1395,8677
36271,6099,5959,6124,5908,5656,5743,6023,41512
36272,12702,12229,12967,12722,12793,13209,13389,90011
36273,3449,3620,3673,3608,2988,2981,2914,23233
36274,11497,11655,11430,11045,10873,11551,11199,79250
36276,2669,2629,2380,2314,2320,2090,2592,16994
36277,5238,4846,4764,4827,4761,4722,5420,34578
36278,4469,4126,3921,4001,3764,4011,4366,28658
36279,2543,2662,2769,2735,2697,2470,2645,18521
36280,3698,3450,3683,3977,4551,4548,3932,27839
36301,36609,36341,36739,36679,36416,36247,35759,254790
36303,31422,31316,31000,30596,29938,29909,30217,214398
36305,15940,15519,15107,14767,14385,14060,14470,104248
36310,6491,6470,6679,6762,6694,6711,6783,46590
36311,2661,2723,3116,2669,2955,2920,2770,19814
36312,6317,6707,6430,6428,6282,5836,6187,44187
36313,295,256,328,377,287,279,285,2107
36314,504,509,507,381,445,515,595,3456
36316,1831,1727,1509,1283,1013,960,1722,10045
36317,371,318,374,306,343,499,590,2801
36318,1556,1362,1356,1223,1369,1163,1296,9325
36319,1742,1844,1935,2278,2209,2227,2276,14511
36320,3864,3837,3635,3757,3727,3589,3837,26246
36321,1701,1726,1580,1487,1506,1584,1632,11216
36322,8889,8519,8671,8840,8764,8373,9072,61128
36323,7870,8183,8221,8353,8569,8590,8255,58041
36330,36674,36380,35635,35391,35051,34275,35530,248936
36340,6066,5988,5938,6508,6254,6051,5490,42295
36343,1354,1467,1349,1296,1368,1327,1579,9740
36344,5893,5883,5676,5332,4896,4886,5732,38298
36345,8653,8660,8227,7896,7783,7428,7822,56469
36346,1386,1469,1364,1207,1214,1178,1456,9274
36350,6097,6090,6384,7034,7344,7448,6540,46937
36351,3563,3677,3932,4087,3865,3685,3146,25955
36352,5368,5661,5307,5240,4754,4606,4885,35821
36353,1945,1854,1871,1919,1905,2212,1968,13674
36360,19280,19742,19775,19674,19413,19359,20157,137400
36362,4681,4895,4996,4844,5254,5614,4637,34921
36370,876,859,877,929,1016,1013,972,6542
36371,583,456,540,667,643,489,720,4098
36373,472,525,633,598,700,566,581,4075
36374,1092,1010,907,1036,1051,864,970,6930
36375,6593,6856,7269,7530,8202,8538,7390,52378
36376,2105,1956,2203,2179,2334,2490,2445,15712
36401,7902,7862,7799,7550,7349,7619,8314,54395
36420,11056,11018,10794,10593,10291,10095,10673,74520
36421,9113,8690,8794,8588,8793,8896,9241,62115
36425,1078,1177,1119,1149,1104,1106,1008,7741
36426,15514,15509,15327,15261,15036,15400,16202,108249
36432,2789,3040,2844,2590,2785,2044,2420,18512
36435,355,423,400,521,474,769,579,3521
36436,460,497,477,339,294,198,531,2796
36439,805,722,734,449,475,366,583,4134
36441,3980,3880,3681,3708,4221,4184,3576,27230
36442,3357,3434,3643,4263,4157,4032,3555,26441
36444,790,777,712,688,741,602,702,5012
36445,3983,4337,4540,4745,4485,4926,5050,32066
36446,454,425,468,406,391,442,490,3076
36451,4371,4266,4305,4493,4340,4563,4977,31315
36453,2348,2276,2294,2145,2319,2350,2198,15930
36454,34,33,35,17,16,0,51,186
36455,353,408,405,502,511,507,465,3151
36456,1522,1602,1771,2106,2195,2507,1820,13523
36460,10903,11083,11223,11730,11407,11227,10738,78311
36467,9831,10148,10228,10124,10319,10334,10058,71042
36470,118,92,101,102,23,0,98,534
36471,1122,918,1037,925,1238,1315,1257,7812
36473,106,124,120,212,186,145,106,999
36474,3158,3154,3276,3182,3044,3183,2926,21923
36475,1994,1915,1991,2103,2436,2621,2208,15268
36476,59,78,77,68,33,49,51,415
36477,4372,4342,4478,4224,4522,4549,4946,31433
36480,1603,1571,1699,1645,1816,1714,1773,11821
36481,347,394,291,284,354,488,593,2751
36482,673,855,891,1184,846,781,1090,6320
36483,274,313,267,293,390,364,536,2437
36502,18608,18632,19049,19672,19093,19236,18355,132645
36505,1656,1617,1613,1451,1337,1273,1481,10428
36507,20384,19760,19191,18235,17501,18015,19090,132176
36509,2099,2192,2359,2138,2222,2113,1983,15106
36511,356,806,775,939,774,865,764,5279
36512,0,0,22,24,26,34,46,152
36513,1079,706,530,482,619,553,555,4524
36518,2201,2179,2471,2493,2612,2696,2842,17494
36521,5341,4964,5574,5723,5944,5859,5431,38836
36522,7135,6710,6370,6211,6486,6144,7183,46239
36523,2504,2190,1985,1837,1892,2183,2818,15409
36524,1206,1266,1271,1348,1211,1355,1232,8889
36525,1745,1874,1898,1750,1842,1872,1935,12916
36526,33151,31420,31326,29957,30015,27980,27890,211739
36527,13660,13597,13507,12994,12518,12611,12109,90996
36528,1156,1319,1291,1356,1366,1233,1237,8958
36529,117,223,288,496,451,544,478,2597
36530,7432,7235,7428,7442,6837,7306,6873,50553
36532,32285,31433,30327,29408,28676,28147,27829,208105
36535,27899,27236,25642,25821,25729,25042,26767,184136
36538,532,409,474,355,409,294,374,2847
36539,1049,985,910,869,1050,895,802,6560
36540,703,802,788,679,678,665,691,5006
36541,15464,14218,14142,14967,14797,14936,15647,104171
36542,13494,13315,12871,12678,12488,11610,12705,89161
36543,147,134,149,101,110,31,66,738
36544,10358,10961,11111,10638,11861,11804,12476,79209
36545,10235,10169,10350,10309,10814,10581,9941,72399
36548,1022,994,1090,1111,1076,827,1136,7256
36549,4926,5014,4730,4841,4734,4685,4271,33201
36550,325,258,198,75,72,119,217,1264
36551,8861,8482,8472,8288,7942,8024,8258,58327
36553,3083,3830,3837,3405,3669,3596,3575,24995
36555,704,696,703,858,778,544,654,4937
36556,424,249,95,134,113,155,308,1478
36558,3476,3617,3746,3946,3608,3571,3854,25818
36559,100,114,120,158,174,179,233,1078
36560,3263,3515,3479,3621,3276,3245,3690,24089
36561,6391,6035,6229,6157,6151,6162,5808,42933
36562,1583,1445,1543,1389,1218,1029,1596,9803
36564,17,18,20,16,19,21,107,218
36567,14409,14120,13462,13010,12845,12302,12672,92820
36568,175,124,134,143,68,230,162,1036
36569,915,1036,980,883,890,1221,928,6853
36571,14974,14588,14834,14706,14632,14722,14423,102879
36572,6276,6403,6434,6411,6419,6245,6340,44528
36574,777,1074,1427,1570,1601,1567,1341,9357
36575,20128,18968,19494,19114,19063,18111,18345,133223
36576,4035,3917,3740,3877,4128,4040,4143,27880
36578,1434,1392,1311,1414,1384,1609,1749,10293
36579,1004,1000,1063,1268,1397,1446,1590,8768
36580,5996,6441,6779,6237,5876,5567,5420,42316
36581,78,252,287,419,404,285,224,1949
36582,24940,25500,25603,25368,25805,25463,24624,177303
36583,727,570,568,703,647,865,639,4719
36584,1100,899,882,911,809,758,772,6131
36585,975,1017,1085,1093,1050,1331,972,7523
36587,9548,10707,11077,11695,11475,11294,12053,77849
36590,0,0,0,0,0,0,20,20
36602,791,759,762,627,631,758,1057,5385
36603,12638,12085,11623,11088,10017,9211,7922,74584
36604,9621,10046,10106,10049,9743,10227,10456,70248
36605,27317,27435,27860,29613,29886,31649,30111,203871
36606,18960,19135,20097,20726,20106,20343,18733,138100
36607,6466,6463,7020,7171,7787,7519,6852,49278
36608,36236,37301,37232,37296,37111,35914,36864,257954
36609,24986,25472,24111,23464,23661,22681,25846,170221
36610,10890,11302,11439,12297,12365,12992,13209,84494
36611,5955,6005,6026,6073,6085,6116,6106,42366
36612,4668,4794,4948,4742,5154,5065,4541,33912
36613,13713,13319,13323,13204,13238,12593,12749,92139
36615,0,0,46,234,248,279,391,1198
36616,0,0,0,0,0,0,27,27
36617,13859,14046,13649,13324,13641,14712,13967,97198
36618,17030,17303,17120,16743,16908,15600,16737,117441
36619,15960,15911,15735,15405,13831,13196,14269,104307
36688,269,337,407,545,723,999,659,3939
36693,18846,18867,18799,17338,17919,18292,17847,127908
36695,49824,48227,46636,46316,44880,45694,45118,326695
36701,22746,22428,22489,22605,22591,23497,24268,160624
36703,13392,13960,14218,14310,14678,14416,13643,98617
36720,889,731,593,586,883,815,784,5281
36722,456,409,486,578,598,650,472,3649
36723,118,61,100,124,131,309,230,1073
36726,5197,5514,5188,5369,5205,5396,4814,36683
36727,157,149,145,168,213,224,61,1117
36728,382,326,482,409,437,349,461,2846
36732,8328,8292,8192,8037,8149,8207,8395,57600
36736,1332,1359,1512,1756,1429,1336,1207,9931
36738,1128,1269,1085,894,724,685,952,6737
36740,1324,1645,1710,1666,1597,1481,1328,10751
36742,1525,1683,1729,1692,2126,2332,2554,13641
36744,6646,6534,6792,7183,7456,7975,7419,50005
36748,3019,3003,3060,3086,3070,3396,3260,21894
36749,572,781,691,847,959,1055,1089,5994
36750,3058,2793,2990,3349,3065,2990,2901,21146
36751,420,564,677,815,1025,1030,945,5476
36752,1499,1843,1727,1777,1836,1821,1644,12147
36753,23,27,32,42,28,16,85,253
36754,243,371,303,403,475,404,344,2543
36756,5700,5621,5839,6440,5844,6078,6165,41687
36758,1302,1812,1941,1661,1783,1491,1412,11402
36759,1440,1681,1387,1488,1640,1497,1501,10634
36761,1142,964,914,960,953,1015,1161,7109
36763,285,314,235,253,209,150,139,1585
36765,1218,1258,1252,1400,1505,1543,1294,9470
36766,16,20,19,30,9,7,25,126
36767,1701,1836,1916,1902,2213,2297,2012,13877
36768,1068,1138,1039,889,1003,844,1096,7077
36769,2839,2713,3011,2731,2633,2328,3014,19269
36773,484,351,737,1149,918,894,512,5045
36775,855,807,819,710,628,534,800,5153
36776,1583,1724,1664,1662,1604,1453,1489,11179
36782,2834,2857,2908,3042,2953,2915,2405,19914
36783,581,563,774,767,891,855,945,5376
36784,7289,7429,7468,7691,8076,8269,7754,53976
36785,1491,1428,1767,1738,1510,1393,1165,10492
36786,3226,3578,3689,3167,3646,3412,3365,24083
36790,72,61,40,80,80,129,139,601
36792,1276,1284,1204,1373,1429,1243,1169,8978
36793,357,552,568,650,648,660,568,4003
36801,24525,24273,24092,22895,22043,22128,22214,162170
36804,16944,16106,16707,17898,17096,17730,16861,119342
36830,38004,36303,35042,34089,33079,32663,33201,242381
36832,23636,24511,24179,23598,23207,22571,22071,163773
36849,3859,3539,3308,3204,3071,3079,3150,23210
36850,2541,2676,2712,2722,2700,2513,2630,18494
36852,2239,2437,2220,2082,2279,2174,2129,15560
36853,7879,7921,7988,8055,7885,7810,8269,55807
36854,15155,14711,14895,14719,15899,15343,14576,105298
36855,1824,1635,1582,1582,1612,1720,1551,11506
36856,6603,6285,5657,4732,4047,3428,3719,34471
36858,331,374,340,540,538,402,441,2966
36859,40,63,41,38,8,26,34,250
36860,1509,1525,1573,1404,1479,1481,1580,10551
36861,3222,3152,3262,3038,2722,2708,3264,21368
36862,6271,6336,6415,6510,6206,5973,6623,44334
36863,11870,12000,12147,12188,12047,12268,11672,84192
36865,30,30,26,20,12,0,23,141
36866,3367,3622,3636,3739,3802,3533,3955,25654
36867,23993,23243,22428,21976,21607,20898,22210,156355
36869,21235,21056,20413,19025,17884,17682,18751,136046
36870,20667,20057,19979,18792,18451,18554,18783,135283
36871,1263,1182,1243,1150,1373,1210,1277,8698
36874,8024,8542,8734,8775,9064,8673,7901,59713
36875,4014,4538,4385,5120,4699,4686,4622,32064
36877,12182,12137,10957,11523,11018,9947,11414,79178
36879,1841,2136,2413,2591,2381,2103,2114,15579
36901,455,524,452,399,485,514,329,3158
36904,4168,4096,4078,3973,4089,3974,4098,28476
36907,1822,2058,2133,2017,1966,1853,1930,13779
36908,2220,2282,2286,2372,2383,2204,2417,16164
36910,41,38,42,26,26,28,35,236
36912,1969,2001,1977,1854,1723,1835,2017,13376
36913,67,77,43,176,128,117,53,661
36915,554,525,528,481,679,611,627,4005
36916,815,820,834,656,647,406,709,4887
36919,1814,1933,1868,1994,2148,2613,2143,14513
36921,1053,1030,1184,1337,1337,1203,1035,8179
36922,393,361,385,647,601,861,656,3904
36925,3395,3362,3481,3605,3698,3923,3115,24579
37010,5198,5648,5568,5633,5751,5035,4679,37512
37012,2424,2637,2766,2477,2436,2355,2292,17387
37013,93372,90073,86261,81944,79903,76983,78406,586942
37014,2663,2500,2410,2130,1746,1812,1855,15116
37015,17996,18361,17846,17400,16985,16976,17184,122748
37016,1150,1367,1455,1215,935,932,793,7847
37018,2098,2306,1866,1625,1821,1880,2259,13855
37019,458,460,713,731,959,1130,694,5145
37020,5384,5506,5744,5200,5158,5029,5036,37057
37022,6386,5974,6013,6022,5439,5284,5469,40587
37023,1356,1431,1287,1486,1558,1633,1811,10562
37025,5682,5356,5504,6038,6348,6362,6226,41516
37026,2058,2217,2077,2134,2226,2243,2201,15156
37027,54032,53242,51818,51034,49832,48067,49035,357060
37028,902,831,694,775,1054,620,676,5552
37029,6005,5484,5238,5100,5357,5229,5628,38041
37030,6938,6624,6807,7057,7259,7299,6982,48966
37031,3854,4399,4014,3892,3948,3811,3712,27630
37032,4360,4094,4175,4496,4470,4306,4493,30394
37033,7680,7621,7750,8146,7950,7928,7805,54880
37034,7235,7005,7446,7210,7210,6979,6591,49676
37035,3179,3170,3351,3386,3257,3285,3766,23394
37036,5606,5559,5611,5911,6008,5998,5862,40555
37037,7321,6651,6288,6350,6293,6145,6312,45360
37040,48520,47081,46655,44301,42918,41487,44924,315886
37042,75488,73433,70890,68419,67119,65545,66916,487810
37043,45007,43755,42841,42919,41236,40113,39945,295816
37046,4424,4386,4206,4345,3973,3977,3665,28976
37047,2581,2691,2517,2444,2474,2110,2345,17162
37048,6403,6587,6697,6679,6211,5897,6030,44504
37049,3426,3616,3380,3088,2941,3207,3244,22902
37050,1624,1803,1787,1997,1747,1905,1699,12562
37051,3339,3587,3994,3966,3991,3578,3677,26132
37052,2762,2749,2484,2376,2183,2538,2656,17748
37055,27178,27755,27537,27780,27476,27229,27024,191979
37057,873,1003,1224,1213,1070,803,834,7020
37058,7737,7409,7746,7512,7081,7194,7081,51760
37059,1483,1450,1552,1432,1379,1448,1552,10296
37060,2197,2199,2216,2382,2361,2446,2230,16031
37061,4931,4962,5260,5185,5366,5224,5153,36081
37062,11312,10954,10751,10715,10214,10135,10745,74826
37064,54462,53212,52247,51393,50207,48318,48118,357957
37066,46969,45625,45012,43709,42873,42238,42758,309184
37067,26841,25787,24133,23391,22980,23041,23652,169825
37069,19522,19614,20178,19583,19475,19018,18899,136289
37072,31914,31392,31058,29970,29598,29279,30215,213426
37073,14086,13961,13448,13271,13150,12495,13350,93761
37074,7016,6941,6808,7188,6922,7304,6965,49144
37075,63452,62512,61757,60280,59694,58292,59256,425243
37076,37814,37749,37971,37929,37784,36970,35230,261447
37078,462,563,554,712,943,915,674,4823
37079,1836,2337,2068,2051,2386,2593,2578,15849
37080,7268,7079,7785,7962,8189,7609,7384,53276
37082,6523,6478,6535,6398,6539,6290,6107,44870
37083,14607,14708,14266,14006,13528,13683,13909,98707
37085,4292,4548,4489,4309,4240,4443,4035,30356
37086,33603,33054,32634,32310,31672,30917,31513,225703
37087,44501,43449,42826,41928,42364,41193,41132,297393
37090,14409,13963,13761,13231,12155,11703,12922,92144
37091,21755,21391,20534,20606,20095,20087,21005,145473
37095,1911,1600,1669,1606,1706,1888,1854,12234
37096,5536,5465,5446,5588,5350,5607,5503,38495
37097,2285,2315,2321,2232,2466,2196,2294,16109
37098,5726,5317,5044,4587,4638,5296,5382,35990
37101,6798,6345,6316,6388,6465,5867,6422,44601
37110,33028,33159,32751,33063,32982,32981,32495,230459
37115,40146,39846,37941,36959,36171,36839,37316,265218
37118,923,1173,1241,1678,1757,1410,1264,9446
37122,53219,51660,49446,48107,46075,44711,46463,339681
37127,17695,16834,16748,16555,15609,15286,15786,114513
37128,45969,44028,41906,41108,39889,38468,38966,290334
37129,54412,52703,51597,50076,49884,47522,49103,355297
37130,55300,53507,52023,50538,50013,50377,52070,363828
37132,2563,2653,2659,2730,2649,2802,2776,18832
37134,2805,2823,2805,2882,2878,2915,3061,20169
37135,10863,10374,9999,9524,9377,8509,9681,68327
37137,3372,3934,3561,3182,2692,2277,2725,21743
37138,23813,23408,22356,21909,21408,21416,22191,156501
37140,1239,1256,1315,1329,1348,1358,1365,9210
37141,1528,1445,1467,1235,1190,1175,1224,9264
37142,1938,1898,1916,2079,2194,2127,1902,14054
37143,3846,3847,3827,4032,3925,4167,3818,27462
37144,2979,3179,3343,3682,3427,3356,3344,23310
37145,1987,1920,2067,2103,2009,2209,2157,14452
37146,7111,7356,7118,7084,7074,7381,7182,50306
37148,23548,23041,22326,22373,22092,21624,22320,157324
37149,2586,2294,2235,2331,2039,1794,2210,15489
37150,4875,4503,4493,4597,5089,5044,4894,33495
37151,432,519,433,488,563,486,565,3486
37153,5602,5828,5856,5774,6206,6126,5520,40912
37160,33879,33625,32511,32686,32139,32446,32744,230030
37165,68,59,61,50,74,59,70,441
37166,13990,13699,13430,13470,13215,13088,13446,94338
37167,55622,54803,53889,51973,50453,49035,49322,365097
37171,511,519,602,556,684,634,917,4423
37172,28511,28009,28265,28918,29571,29311,28714,201299
37174,33604,32229,30860,29070,27238,24450,26418,203869
37175,883,1114,1230,1214,1183,1037,1015,7676
37178,2280,2230,2064,2087,2007,2180,2112,14960
37179,12713,11498,10784,10194,10148,11056,11767,78160
37180,3309,3334,2942,2967,2887,2830,3033,21302
37181,1715,1533,1325,1506,1525,1782,1534,10920
37183,3145,3177,3534,3338,3520,3058,3229,23001
37184,5850,5722,6024,6516,6672,6783,5844,43411
37185,8482,8716,8825,8575,8271,8858,8638,60365
37186,8825,8791,8799,9099,9223,9770,9184,63691
37187,7345,6889,7209,6715,6328,6597,6829,47912
37188,14678,14190,14112,13877,13731,13503,13643,97734
37189,3511,3476,3214,3019,3299,3763,3320,23602
37190,8799,8919,8705,9106,8910,8959,8787,62185
37191,3809,3880,3999,4226,4458,4697,4020,29089
37201,1661,1870,1896,2001,1784,1590,2137,12939
37203,12726,12068,11767,11525,11171,10465,11883,81605
37204,13760,13169,12599,12869,12826,12422,12031,89676
37205,24714,24341,24011,23812,23605,23263,24057,167803
37206,25372,26323,26223,24931,25264,25772,25699,179584
37207,36977,35497,34257,34306,32896,32074,34880,240887
37208,17103,16251,17117,16044,15593,16331,16067,114506
37209,38001,37308,36053,36000,36480,35179,35457,254478
37210,17007,16326,15485,15071,15337,14876,16067,110169
37211,77771,77960,77993,77379,75621,73475,74755,534954
37212,20642,20130,19758,19490,18961,17920,20148,137049
37213,108,125,154,175,185,208,218,1173
37214,30230,29555,29711,29675,29668,29911,28973,207723
37215,21521,21691,21374,21521,22224,21380,21190,150901
37216,18231,18479,18743,18158,18078,18912,17848,128449
37217,29298,28885,28928,28930,28758,29848,29599,204246
37218,15492,15044,14804,14985,14464,14441,14855,104085
37219,1017,1039,1142,1151,1078,975,1162,7564
37220,5720,5611,5774,5787,5876,5921,5786,40475
37221,39689,39313,39195,39125,37582,38054,36610,269568
37228,1107,1226,1254,1330,1570,1366,1160,9013
37240,730,717,602,626,684,988,754,5101
37243,0,0,0,0,0,0,0,0
37246,0,0,0,0,0,0,0,0
37301,1394,1423,1480,1518,1539,1593,1429,10376
37302,3850,3602,3622,3573,3139,3354,3730,24870
37303,24945,25389,25109,25680,25504,25193,25461,177281
37305,938,792,872,994,956,925,889,6366
37306,2654,2810,3136,3007,3042,3116,2760,20525
37307,5160,5117,5050,5488,5394,5419,4870,36498
37308,2858,2606,2534,2423,2159,2527,2772,17879
37309,2348,2379,2289,2026,2130,2314,2138,15624
37310,4706,4430,4048,3870,4057,4068,4135,29314
37311,28200,27875,26618,26285,27131,26335,27373,189817
37312,33231,32914,33292,33032,31626,31120,30962,226177
37313,1547,1530,1542,1435,1786,1620,1731,11191
37315,1463,1393,1308,1266,1242,1360,1556,9588
37317,2733,2589,2840,2916,3064,3061,2403,19606
37318,1711,1653,1617,1672,1625,1489,1978,11745
37321,18942,18968,19593,19100,19711,19415,19113,134842
37322,7815,7387,7582,7184,7902,7757,8239,53866
37323,30990,31510,31091,30960,30207,30229,30439,215426
37324,5433,5145,5116,5264,5190,4857,5322,36327
37325,1614,1766,1476,1473,1389,1417,1845,10980
37326,465,395,424,453,456,451,467,3111
37327,12173,12117,11796,11831,11384,10910,11174,81385
37328,1190,1068,870,1144,1398,1419,1364,8453
37329,5955,5828,6096,6124,6290,6222,5588,42103
37330,7632,7745,7431,7437,7166,7026,6784,51221
37331,7832,7868,7835,7580,7548,7454,7656,53773
37332,2825,2652,2473,2706,2516,2339,2609,18120
37333,630,683,748,674,634,427,534,4330
37334,22609,22630,22587,21350,21458,21112,21700,153446
37335,2856,2681,2704,2845,2647,2641,2778,19152
37336,4493,4545,4875,4864,4275,4246,4202,31500
37337,1543,1104,1182,1067,1145,1343,1470,8854
37338,3590,3652,3252,3194,2937,2611,3093,22329
37339,2218,2052,1715,1725,1798,1920,2018,13446
37340,689,591,501,434,464,291,607,3577
37341,12110,12817,13042,13571,13542,12766,12085,89933
37342,3442,3303,3333,3179,3285,3189,3593,23324
37343,42550,41603,40943,42128,41213,40565,40042,289044
37345,2433,2425,2317,2155,2059,2126,2311,15826
37347,7852,7666,7153,7336,7161,7370,7559,52097
37348,1096,1147,1291,1390,1350,1365,1131,8770
37350,1923,1871,1878,1849,1864,1911,1866,13162
37351,316,343,518,516,687,686,390,3456
37352,3361,3170,3076,3408,3182,3155,3268,22620
37353,4528,4663,4668,4523,4258,4741,4513,31894
37354,17024,16410,17016,16650,16353,16405,16483,116341
37355,25765,25493,25531,25681,25889,25556,25596,179511
37356,2706,2325,2482,2325,2540,2598,2486,17462
37357,6025,5952,6238,5392,5210,5077,5512,39406
37359,600,555,724,739,886,888,783,5175
37360,1527,1708,1531,1756,1493,1720,1732,11467
37361,1224,1136,1254,1492,1569,1650,1478,9803
37362,3249,3025,3069,2822,3135,3017,3395,21712
37363,37995,36442,35209,33075,31668,30741,32244,237374
37365,1132,1205,1210,1356,1366,1394,1314,8977
37366,775,754,908,879,889,855,828,5888
37367,11170,11150,10782,9665,9934,9963,10247,72911
37369,865,776,809,675,741,726,956,5548
37370,4673,4365,4626,4871,5058,4958,4652,33203
37373,2474,2800,2760,2787,2746,2874,3074,19515
37374,1846,1904,2227,2116,2192,2299,2047,14631
37375,4074,4287,4226,4317,4232,3909,3711,28756
37376,405,347,477,447,504,530,418,3128
37377,15993,15933,15379,15564,15310,15281,15310,108770
37379,27522,27086,26913,26423,26579,25865,26835,187223
37380,6610,6591,6277,6058,5737,6245,6289,43807
37381,9405,9352,8996,9521,8920,8992,8855,64041
37385,8274,8771,7948,8170,8343,8447,8131,58084
37387,2953,3209,3478,3604,3377,3245,3323,23189
37388,25290,25305,26124,25301,24718,24843,24494,176075
37391,1311,1392,1415,1093,1043,1136,1598,8988
37394,60,51,50,63,143,130,105,602
37396,185,169,149,315,258,216,257,1549
37397,9799,9760,10412,10591,10540,10685,10127,71914
37398,13633,13499,13171,13589,14159,14777,14347,97175
37402,3878,3682,3672,3505,3816,3871,3917,26341
37403,6957,6890,6271,5774,5563,4845,5811,42111
37404,11868,11856,11982,11848,12358,12685,13327,85924
37405,15772,15800,15418,15041,14686,14252,14597,105566
37406,15043,14977,14246,14396,14450,14152,14627,101891
37407,10256,9576,9813,9568,9059,8888,8932,66092
37408,1518,1431,1459,1414,1280,1282,1486,9870
37409,2729,2827,2993,2931,2928,3134,2851,20393
37410,3819,4051,4455,4420,4628,4514,3886,29773
37411,17810,18012,18128,18507,18232,18247,17587,126523
37412,21314,21438,21247,21137,21029,20948,20951,148064
37415,24513,24493,23946,23679,23464,24007,23873,167975
37416,14490,14815,15081,15242,14694,14134,14486,102942
37419,5910,5864,5820,6096,6164,6075,6100,42029
37421,47810,47400,47397,45902,46835,46325,46228,327897
37601,37097,36214,36284,37428,36864,36036,36182,256105
37604,34915,35032,34853,34456,34683,34456,34245,242640
37614,1945,1963,1932,1860,1783,1741,2107,13331
37615,21232,21085,20349,19503,19024,18161,19560,138914
37616,4638,4662,5017,4939,4982,5296,4874,34408
37617,13705,13552,13904,14275,14239,14209,14251,98135
37618,13706,13372,13545,13562,13376,12718,12747,93026
37620,38043,37942,37954,38407,38660,38391,39102,268499
37640,3572,3551,3416,3176,3594,3781,3743,24833
37641,9568,9076,8828,8194,7903,8232,8567,60368
37642,14647,14544,13974,13828,14272,14473,14947,100685
37643,34100,34042,34438,34390,34225,34077,33689,238961
37645,5098,5168,5184,5224,5156,5264,5145,36239
37650,12078,12194,12343,12334,12470,12651,12750,86820
37656,4617,4421,4244,4125,3965,4030,3677,29079
37657,938,974,961,1009,981,986,972,6821
37658,4063,4261,4207,4136,4058,4185,4386,29296
37659,27397,27802,28040,27349,27319,26971,27585,192463
37660,39650,39973,40401,39777,39880,40600,40038,280319
37663,14485,14739,14393,14808,15156,15155,14617,103353
37664,26411,26075,26353,26106,26194,26954,26880,184973
37665,6266,6159,6111,5698,5401,5242,5589,40466
37680,635,710,485,594,468,444,766,4102
37681,5810,5711,5739,5660,6220,6199,6121,41460
37682,661,624,615,616,631,599,667,4413
37683,12908,13071,13421,13740,13627,13504,13021,93292
37686,7994,8236,7622,7498,7229,6894,7072,52545
37687,4766,4920,5194,5007,5058,5173,5038,35156
37688,914,868,961,979,889,935,1018,6564
37690,3364,3612,3667,3914,3887,4376,4122,26942
37691,908,779,760,642,667,723,894,5373
37692,4750,4840,4906,4968,4842,4732,4770,33808
37694,1591,1878,1779,1902,2037,2080,1955,13222
37701,7460,7174,7239,7232,6778,6857,6817,49557
37705,4169,4286,4469,4247,4683,4521,4559,30934
37708,6201,6398,6531,6327,6616,6308,6563,44944
37709,3835,3649,3762,3842,3939,4034,3732,26793
37710,930,873,1089,948,1175,1137,1141,7293
37711,5230,4734,5071,5087,5028,4816,5044,35010
37713,1387,1212,1075,1216,1381,1498,1488,9257
37714,4765,4654,4490,4619,4287,4134,4547,31496
37715,607,616,643,635,667,685,1000,4853
37716,25355,24954,25389,25516,25544,26198,25749,178705
37719,133,126,113,115,107,82,168,844
37721,12819,11734,12305,12740,12795,12598,12733,87724
37722,5680,6521,6653,6946,6622,6811,6060,45293
37723,975,1007,960,935,944,1060,944,6825
37724,2509,2443,2487,2484,2556,2686,2874,18039
37725,16823,16501,16350,16333,15716,15999,16919,114641
37726,1648,1679,1473,1381,1462,1623,2037,11303
37727,2084,2290,2158,2101,2272,2196,2043,15144
37729,1535,1372,1531,1656,1802,1690,1456,11042
37730,25,46,48,43,34,24,59,279
37731,599,776,803,884,559,530,711,4862
37732,167,126,52,57,102,175,139,818
37733,57,74,64,20,21,69,64,369
37737,5660,5783,5543,5464,5677,5796,5785,39708
37738,5795,5484,5558,5356,5210,5224,5288,37915
37742,6046,6202,6342,6111,5968,5668,5837,42174
37743,25298,25992,26240,26696,25819,25733,25588,181366
37745,17664,17605,17563,17755,18250,18001,18401,125239
37748,17858,18189,18398,18215,17774,17835,17857,126126
37752,6513,6511,6279,6316,6470,6342,6516,44947
37753,940,804,845,960,790,739,814,5892
37754,5444,5191,4950,4823,4434,4512,4729,34083
37755,4049,4294,3345,3228,3115,2673,3688,24392
37756,2677,2671,3138,3249,3349,3445,2810,21339
37757,9417,9506,9324,9117,9385,8980,9337,65066
37760,12956,13125,13264,13572,13795,13493,12931,93136
37762,2933,2804,2930,2833,2867,2905,3126,20398
37763,15447,15394,15380,15733,16030,16219,15794,109997
37764,9509,8978,9273,9241,9328,9313,9258,64900
37765,365,438,403,411,445,518,546,3126
37766,18367,18757,18729,18880,18887,19387,18850,131857
37769,5504,5625,5853,6231,6123,6183,5990,41509
37770,2651,2596,2557,2889,3068,3112,2646,19519
37771,16125,15866,16087,15750,15526,15616,15380,110350
37772,11490,10763,10628,10599,10559,10505,11146,75690
37774,18646,19095,18723,19097,19084,18452,18321,131418
37777,11379,11223,11482,11051,12050,11494,11274,79953
37779,3025,3423,4099,4726,4493,4510,3978,28254
37801,25212,25543,25036,25500,24703,24349,25124,175467
37803,32402,31565,31644,31576,30917,31367,31668,221139
37804,25623,24901,24749,24513,24483,24429,24682,173380
37806,2596,2694,2717,2657,2916,2813,2868,19261
37807,10493,10351,9905,9388,9594,9208,9923,68862
37809,2349,2164,2151,2337,2719,2646,2278,16644
37810,1705,1823,1869,2024,1862,1854,1928,13065
37811,3506,3484,3758,3605,3409,3419,3215,24396
37813,16825,16889,17870,18252,18581,17805,17444,123666
37814,34367,33755,32885,33030,32674,33021,33071,232803
37818,5643,5380,5008,4955,4942,4691,4998,35617
37819,747,697,773,613,602,563,713,4708
37820,8175,8128,7536,7430,7599,7320,7495,53683
37821,21989,22122,22276,22086,22196,21921,22608,155198
37825,8477,8636,8513,8543,8473,8777,8399,59818
37826,4846,5026,4796,4607,4299,4398,4361,32333
37828,1515,1832,1771,1708,1622,1533,1430,11411
37829,1894,1915,2122,2254,1983,2135,1804,14107
37830,29709,29734,29768,29828,29698,29580,29700,208017
37840,11006,10573,10038,10131,9518,9687,10021,70974
37841,9236,9219,9630,9873,10006,9737,9605,67306
37843,3875,3426,3466,3740,3676,3873,3725,25781
37845,534,383,429,502,558,546,494,3446
37846,5002,5808,5867,6103,6181,5391,5030,39382
37847,2506,2469,2147,2549,2412,2820,2714,17617
37848,218,202,179,259,245,267,246,1616
37849,27229,27045,27210,25799,25989,24152,25459,182883
37851,44,44,60,6,37,37,36,264
37852,2464,2417,2669,2539,2601,2917,2558,18165
37853,3776,3820,4117,3857,3807,3739,3815,26931
37854,12622,12767,12668,12106,12582,12087,13108,87940
37857,20708,20665,20901,21312,21523,20863,21309,147281
37860,4159,4044,4210,4487,4175,4162,4113,29350
37861,8735,8733,8598,8344,8056,8375,8340,59181
37862,22843,22959,22546,21953,21797,21027,20934,154059
37863,6557,6258,6276,6635,6538,6772,6569,45605
37865,21686,20641,20646,20719,20373,19361,20912,144338
37866,1688,1730,1589,1627,1577,1692,1699,11602
37869,4788,4840,5048,4979,5031,5183,5031,34900
37870,4870,4865,4808,4513,4973,5061,4580,33670
37871,9139,9227,8940,8777,8742,9470,9134,63429
37872,1584,1559,1717,1730,1661,1695,2041,11987
37873,4419,4685,4364,4599,4508,4848,4073,31496
37874,14873,14009,14348,13509,13650,13579,14979,98947
37876,31750,31525,30792,29550,29337,29052,29246,211252
37877,9092,9004,8784,7965,8022,8113,8464,59444
37878,436,556,599,645,587,502,514,3839
37879,10683,10617,10915,11162,10654,10249,10634,74914
37880,3141,3441,3594,4025,4053,4503,3477,26234
37881,2296,2368,2231,2239,2316,1727,2291,15468
37882,2847,2843,2866,2854,3043,2840,2724,20017
37885,5307,5187,4831,4787,4819,5092,5067,35090
37886,4339,5391,4722,4658,4558,4686,4418,32772
37887,7701,7906,7846,7731,7517,7252,7511,53464
37888,3189,3025,2755,2828,2657,2857,2741,20052
37890,6810,6605,6834,6687,6825,6764,6668,47193
37891,3163,3717,3549,3165,3051,3243,3626,23514
37892,2062,2068,2147,1967,1987,2010,2007,14248
37902,2180,2097,1931,1810,1752,1544,1586,12900
37909,15377,15319,16159,15966,15924,15774,15168,109687
37912,21718,20761,19345,18856,19178,19746,20673,140277
37914,20458,20382,20948,21082,20307,19318,19663,142158
37915,6609,6616,6165,6325,5982,5955,5647,43299
37916,12868,12710,13019,12677,12647,12530,12507,88958
37917,24613,24882,24088,24267,24466,24341,24072,170729
37918,44600,44654,44717,44863,43240,42683,42835,307592
37919,28125,28906,28659,29037,28927,28465,28194,200313
37920,39875,39823,38350,37540,37359,38037,39087,270071
37921,28284,28960,28499,28464,27838,27853,28233,198131
37922,34545,33623,34137,34186,33871,34172,33180,237714
37923,29074,27804,28131,27624,27731,27132,27457,194953
37924,11163,11283,10659,10891,10597,10581,11259,76433
37931,27522,27364,26687,25848,25646,25022,26109,184198
37932,16388,15947,15000,14453,14272,13852,14527,104439
37934,25366,25203,24960,24835,24597,24279,24107,173347
37938,17482,17486,17992,17695,18005,17819,17085,123564
38001,4621,4380,4462,4508,4214,4209,4719,31113
38002,40125,39450,40079,39470,37458,36135,38927,271644
38004,10538,10479,10187,10406,10125,9187,9866,70788
38006,5185,5097,5543,5651,5786,5677,5207,38146
38007,89,69,59,58,94,9,91,469
38008,9083,9005,9338,9431,9121,9802,9721,65501
38011,10327,10184,10117,9721,9239,9644,9908,69140
38012,14006,14176,14193,14135,14308,14424,14575,99817
38015,2457,2651,2677,2740,2963,3469,2828,19785
38016,46763,46399,44772,42103,43137,41481,43079,307734
38017,52283,51132,50360,48641,47262,47109,48642,345429
38018,37107,36602,36495,35504,34728,34304,35059,249799
38019,16002,15863,15452,15860,16078,15755,15601,110611
38021,21,174,154,191,191,221,59,1011
38023,6232,6813,6839,6572,6135,5822,6146,44559
38024,27798,27510,27514,27815,27729,27339,27406,193111
38028,6734,6573,6462,6865,6899,7429,6883,47845
38029,0,0,0,0,0,0,80,80
38030,525,572,837,853,799,1085,977,5648
38034,2943,3157,3007,2854,3229,3235,2998,21423
38036,659,599,612,596,502,475,478,3921
38037,1593,1849,2091,2159,2101,2052,1773,13618
38039,1783,1836,1736,1591,1719,1673,1804,12142
38040,5071,5120,5403,5337,5496,5446,5193,37066
38041,4841,4886,4786,5014,4979,4813,5085,34404
38042,929,966,932,955,762,930,796,6270
38044,858,703,578,594,719,719,865,5036
38046,42,51,53,37,47,54,108,392
38047,71,38,31,40,313,375,91,959
38049,4257,4386,4258,4572,4758,4759,4984,31974
38050,528,444,419,447,512,652,459,3461
38052,3869,4102,4058,4139,4366,4069,3907,28510
38053,26875,27752,28450,28228,28871,28656,27932,196764
38054,363,317,316,263,238,172,284,1953
38057,4084,4118,3890,3568,3545,3219,3649,26073
38058,9598,9335,9096,8817,8904,8894,10236,64880
38059,7668,7996,7603,7587,7247,7091,7663,52855
38060,9901,10148,10248,9979,9459,8846,9496,68077
38061,553,614,701,765,687,777,977,5074
38063,17416,17184,17191,16844,16683,16995,17403,119716
38066,2944,2976,2758,2758,2532,2499,2630,19097
38067,1343,1261,1422,1355,1499,1571,1476,9927
38068,9750,9684,9688,10284,10951,11166,10941,72464
38069,2315,2495,2495,2340,2393,2732,2376,17146
38070,319,323,271,103,46,18,175,1255
38075,6878,6781,6846,7022,7060,6638,6936,48161
38076,805,828,883,1066,1241,1375,847,7045
38077,71,78,89,93,16,45,43,435
38079,5218,5336,5241,5242,5473,5584,5577,37671
38080,2934,2775,2765,2772,2558,2341,2568,18713
38103,13690,13253,12818,12630,12168,11945,12180,88684
38104,23979,23957,23867,23261,23031,22668,23409,164172
38105,6380,6683,6650,6720,6445,6824,6184,45886
38106,25392,24526,24640,25072,25065,26890,27222,178807
38107,16865,16952,17118,16504,16739,16345,17698,118221
38108,18918,19378,18685,18788,19630,18994,18729,133122
38109,44889,44779,46265,48169,48322,47610,46594,326628
38111,43843,44947,44612,43725,43199,43379,41742,305447
38112,16896,17073,16858,17033,17531,17443,17472,120306
38114,25851,26032,27896,28215,28363,30309,26905,193571
38115,41246,42650,41823,41712,39084,38697,39129,284341
38116,40033,40642,41491,42016,40468,40383,40404,285437
38117,26203,27419,27675,26504,26622,26311,26125,186859
38118,40702,41940,42779,42639,43021,41226,41465,293772
38119,23221,22925,22147,22809,23361,23321,22330,160114
38120,14823,14273,14587,14617,14003,14004,14237,100544
38122,24546,24686,23586,24353,23838,24772,25270,171051
38125,37947,37389,37420,37766,37414,34934,36150,259020
38126,6049,6095,6286,6781,6881,7396,7334,46822
38127,44131,43729,44632,45074,46994,48836,45248,318644
38128,44901,44086,43440,43552,43348,42940,44863,307130
38131,0,0,0,0,0,0,0,0
38132,0,0,0,0,0,0,7,7
38133,21324,21547,20895,20372,21646,21493,20787,148064
38134,43679,42777,43244,43261,43406,44200,41948,302515
38135,29040,29608,28664,28852,29058,28858,30657,204737
38138,24567,23727,23772,23457,23329,23390,24045,166287
38139,15978,16319,16491,16762,16752,16687,16086,115075
38141,22709,22612,22436,22454,22750,22012,22462,157435
38152,959,961,807,818,619,1027,834,6025
38201,10604,10108,10474,10142,10015,10337,10093,71773
38220,1767,1834,1779,1813,1736,1842,1849,12620
38221,3135,3001,3185,3297,3311,3281,3308,22518
38222,3006,3089,2774,2675,2520,2582,2629,19275
38224,983,1090,1052,1044,953,1033,956,7111
38225,6565,6461,6549,6525,6248,5918,6283,44549
38226,176,158,157,117,211,215,345,1379
38229,2659,2787,2565,2948,2942,3066,2931,19898
38230,3481,3703,3723,3554,3623,3691,3736,25511
38231,1576,1941,1845,2127,2253,2174,1664,13580
38232,1911,1820,1801,1850,2062,1977,1998,13419
38233,2497,2420,2568,2688,2878,3073,2852,18976
38235,289,280,246,220,195,203,441,1874
38236,768,614,529,630,548,454,662,4205
38237,16196,16431,16392,16278,16345,16145,16627,114414
38240,2534,2388,2338,2273,2220,2358,2259,16370
38241,842,761,834,935,963,944,898,6177
38242,20260,19802,20119,19903,19952,19873,20151,140060
38251,2636,2524,2688,2791,2941,2872,2751,19203
38253,985,959,1101,1332,1442,1404,1156,8379
38254,62,65,63,53,36,64,85,428
38255,2269,2336,2464,2409,2452,2381,2299,16610
38256,2672,2782,2867,2852,2728,2850,3089,19840
38257,4388,4430,4243,4358,4354,4274,4397,30444
38258,1388,1481,1397,1424,1580,1499,1500,10269
38259,653,738,859,875,945,1004,860,5934
38260,3352,3422,3555,3528,3824,4062,3804,25547
38261,16449,16764,17023,16963,16661,16695,16919,117474
38301,34007,34316,35106,36403,36045,36319,36613,248809
38305,52363,51762,51427,50335,49537,49319,49808,354551
38310,6120,6216,5939,6151,6477,6578,6145,43626
38311,813,1011,945,1007,1048,804,786,6414
38313,2582,2543,2795,3234,3082,3468,3204,20908
38315,3543,3580,3457,3737,3688,3563,3876,25444
38316,3222,3539,3373,3486,3152,3058,2917,22747
38317,2657,2805,2901,2801,2635,2751,2537,19087
38318,357,389,375,345,267,234,476,2443
38320,10449,10631,10569,10489,10617,10657,10686,74098
38321,2241,2081,2105,2391,2271,2166,2431,15686
38326,2399,2429,2439,2466,2230,2271,2560,16794
38327,378,439,375,409,451,448,477,2977
38328,667,672,727,829,721,841,730,5187
38329,3354,3274,3296,3432,3441,3693,3220,23710
38330,4448,4333,4390,4383,4577,4571,4404,31106
38332,1337,1411,1581,1495,1586,1344,1120,9874
38333,383,403,520,551,402,442,523,3224
38334,1971,1879,1893,1701,1734,1808,1911,12897
38337,1299,1290,1215,1354,1327,1354,1366,9205
38339,564,546,585,574,570,552,637,4028
38340,13663,13267,13602,13740,13926,13748,12935,94881
38341,2425,2518,2383,2293,2416,2519,2252,16806
38342,1370,1407,1269,1288,1379,1462,1438,9613
38343,15097,15499,15640,15792,15732,15961,15619,109340
38344,8681,8571,8723,8576,8879,8702,8684,60816
38345,2334,2339,2357,2093,1880,2214,2089,15306
38347,331,502,113,122,146,222,270,1706
38348,1214,1282,1360,1306,1081,1062,1037,8342
38351,17582,18163,18063,18350,18569,17868,17603,126198
38352,606,449,401,457,322,287,494,3016
38355,6238,6225,6304,5803,5544,5173,5882,41169
38356,2538,2619,2516,2325,2619,2425,2193,17235
38357,2636,2589,2765,2983,2964,3079,2757,19773
38358,11372,11267,11040,11372,11676,11565,12121,80413
38359,271,248,285,331,355,337,278,2105
38361,1025,1030,1055,922,835,719,994,6580
38362,1149,1175,1398,1068,1021,1162,1145,8118
38363,5917,5941,5876,5485,5752,5628,6097,40696
38365,59,75,78,0,0,0,16,228
38366,2042,2328,2081,2002,2367,2079,2267,15166
38367,3090,2976,2806,2694,2857,3138,2843,20404
38368,1977,1570,1571,1432,1414,1533,1985,11482
38369,1727,1864,2015,1934,1885,2100,1887,13412
38370,742,739,731,554,637,609,670,4682
38371,1255,1270,1065,1212,1252,1451,1235,8740
38372,17542,17283,17366,17391,17754,17346,17595,122277
38374,2198,1904,1972,1839,1640,1623,2052,13228
38375,8874,9358,9743,9598,9191,9053,9251,65068
38376,230,233,203,183,161,236,233,1479
38379,1516,1403,1316,1225,1039,1133,1171,8803
38380,589,520,548,885,647,581,574,4344
38381,1209,1434,1275,1485,1397,1393,1640,9833
38382,9862,9675,9341,9273,9410,9197,9515,66273
38387,230,310,378,409,523,612,375,2837
38388,1961,1936,1778,1582,1941,1853,1840,12891
38390,961,974,954,965,905,856,907,6522
38391,1139,1208,1318,1273,1300,1161,1174,8573
38392,684,789,569,557,634,590,776,4599
38401,55482,53977,53701,54353,54028,54298,54469,380308
38425,3459,3389,3696,3612,3483,3659,3724,25022
38449,2407,2459,2596,2784,3159,3301,2811,19517
38450,2954,2894,2713,2669,2828,2777,2778,19613
38451,4106,4909,5078,4899,5148,5064,4814,34018
38452,1170,1262,1134,1030,1320,1321,1091,8328
38453,369,362,297,378,430,483,373,2692
38454,1287,1360,1391,1223,1489,1243,1208,9201
38455,106,101,112,110,124,97,227,877
38456,5784,5469,5096,4553,3905,3655,4559,33021
38457,842,748,840,752,667,608,808,5265
38459,491,514,558,577,720,586,453,3899
38460,1319,1233,1359,1344,1478,1439,1410,9582
38461,1096,1373,1310,1408,1543,1579,1379,9688
38462,10060,10053,10048,10248,10435,10473,10297,71614
38463,2571,2770,2779,2872,2520,2341,2817,18670
38464,21762,22062,22124,22171,23046,22839,22293,156297
38468,4903,4662,5119,5079,5068,5238,5201,35270
38469,4010,3989,3894,3765,3887,4196,4092,27833
38471,461,440,476,591,595,634,530,3727
38472,2638,2767,2700,2679,2672,2873,2656,18985
38473,1244,1188,991,982,950,868,1061,7284
38474,8722,8875,8399,8263,8047,7632,7802,57740
38475,649,706,774,915,681,629,635,4989
38476,1048,1175,867,945,1254,1281,1228,7798
38477,2765,2759,2795,2825,2718,2757,2766,19385
38478,17372,17541,17701,18120,17996,18008,17733,124471
38481,927,1030,1048,983,960,942,896,6786
38482,1549,1476,1660,1445,1355,1457,1535,10477
38483,5633,5704,5704,5757,5344,5131,5663,38936
38485,6870,6616,6726,6752,6576,6630,6502,46672
38486,953,857,719,841,892,886,967,6115
38487,1343,1076,1201,762,521,681,1057,6641
38488,2512,2411,2375,2364,2317,2553,2524,17056
38501,38044,38425,37919,37675,37080,36571,36687,262401
38504,911,1094,1219,1167,1194,1129,901,7615
38505,2053,2012,1850,1753,1648,1489,1806,12611
38506,27642,27269,27112,26380,25920,25430,26521,186274
38541,1478,1464,1388,1502,1715,1785,1613,10945
38542,0,0,33,26,28,50,22,159
38543,651,587,497,521,544,468,560,3828
38544,6495,6170,6463,6943,7306,6995,6543,46915
38545,1573,1296,1267,1207,1334,1354,1474,9505
38547,1817,1662,1546,1676,1619,1790,1975,12085
38548,784,694,677,597,686,661,731,4830
38549,3864,3856,3976,3888,3813,3844,3679,26920
38551,4041,3948,3943,3843,3923,3920,4106,27724
38552,194,245,360,483,599,681,275,2837
38553,2299,2401,2401,2549,2507,2434,2312,16903
38554,1080,1092,868,899,902,768,827,6436
38555,19348,19440,19320,19274,19436,19403,18809,135030
38556,12507,12246,12062,12098,12049,12194,12540,85696
38558,8466,8132,7671,7501,7249,7031,6970,53020
38559,1221,1281,1490,1532,1430,1501,1340,9795
38560,1221,1176,1179,1325,1371,1153,1425,8850
38562,6728,6631,6415,6621,6570,6844,6554,46363
38563,2977,3110,2823,2415,2337,2415,2330,18407
38564,365,354,424,340,334,351,453,2621
38565,1341,1342,1215,1158,1052,1029,1098,8235
38567,571,670,724,890,887,777,784,5303
38568,2518,2347,2552,2504,2107,2056,2034,16118
38569,293,333,354,328,476,331,363,2478
38570,9204,9407,9705,9626,10086,10014,9898,67940
38571,13699,13377,13845,13448,13496,13136,13848,94849
38572,11087,10930,10679,10923,10121,10266,10649,74655
38573,2248,2561,2331,2269,2295,2271,2198,16173
38574,7848,7973,8122,8245,8166,8686,8413,57453
38575,1027,1177,1218,1248,1324,1405,1172,8571
38577,916,734,803,802,905,873,1153,6186
38578,171,160,157,134,114,130,177,1043
38579,994,1010,1010,941,1011,852,1063,6881
38580,1465,1296,1377,1637,1744,1814,1743,11076
38581,4193,4147,4145,4300,4243,4315,4112,29455
38582,1561,1592,1625,1439,1403,1204,1426,10250
38583,24396,24300,24005,24159,24010,23824,23825,168519
38585,3402,3576,3622,3786,4113,4077,3717,26293
38587,1398,1396,1151,1085,1156,1060,1301,8547
38588,934,993,968,963,700,646,1011,6215
38589,325,357,270,249,238,261,200,1900
38601,2607,2974,3242,3200,2808,2343,2371,19545
38603,2879,2771,2661,3035,2934,3069,2894,20243
38606,15307,15267,16081,15628,15562,15927,16127,109899
38610,3944,3950,3681,3664,3326,3278,3542,25385
38611,16180,15954,16310,15868,16299,16420,17202,114233
38614,19283,19615,19667,19865,19997,20155,20418,139000
38617,708,770,782,841,892,826,734,5553
38618,11288,11529,11902,11716,11309,11175,12031,80950
38619,5589,5890,5597,5732,5223,5420,5004,38455
38620,4053,4322,3511,3999,4012,3664,3375,26936
38621,1500,1851,1530,1875,1847,1982,1910,12495
38622,736,680,547,584,527,541,705,4320
38623,316,315,276,279,267,194,259,1906
38625,1206,1006,876,910,1223,1315,1058,7594
38626,1401,1348,1164,1105,1251,1029,1353,8651
38627,1050,982,1037,1035,1129,1040,1120,7393
38629,1982,1954,2002,2370,2610,2326,1774,15018
38630,292,394,331,218,229,188,132,1784
38631,1061,870,932,913,958,1020,1306,7060
38632,26010,26253,26207,25340,24714,24482,24377,177383
38633,2111,2614,2776,2717,2612,2492,2590,17912
38635,15873,16237,16291,16895,17194,17289,15941,115720
38637,26982,26815,26575,26350,26120,25901,26066,184809
38639,1303,1311,1258,1230,1255,1419,1257,9033
38641,2663,2399,2610,2890,2460,2536,2338,17896
38642,2459,2353,2474,2182,1890,1801,2321,15480
38643,2281,2310,2329,2331,2565,2529,2619,16964
38644,180,301,315,286,286,289,208,1865
38645,1384,1396,1754,1777,1931,1803,1329,11374
38646,3032,3115,3282,3307,3180,3246,3073,22235
38647,976,1139,1267,1420,1355,1211,1143,8511
38650,4063,3866,3747,3879,4375,3942,3881,27753
38651,7257,7326,7014,7251,7081,6763,7103,49795
38652,16610,16330,15984,15959,15407,15971,16600,112861
38654,50173,48904,48112,47182,46582,45375,45956,332284
38655,40577,39366,38419,37188,36109,35804,36699,264162
38658,1728,1920,2116,1696,1581,1627,2074,12742
38659,2630,2122,2313,2511,2751,2838,2841,18006
38661,1991,2074,1971,1919,1556,1606,2039,13156
38663,12361,12411,12383,11896,11438,11526,11950,83965
38664,2957,2860,3245,3506,3583,3839,3279,23269
38665,2833,2678,2775,2629,2515,2525,2683,18638
38666,6842,6289,6936,6794,7690,7753,6915,49219
38668,14824,14749,14422,14728,15053,14689,14462,102927
38670,808,932,1054,1130,1272,1455,1226,7877
38671,36466,35840,35880,35476,36312,35483,35712,251169
38672,12942,12804,12224,12196,10700,10535,11249,82650
38673,1021,820,642,670,678,634,746,5211
38674,713,816,960,1002,1087,840,898,6316
38676,6258,6458,6393,6285,6022,5975,6375,43766
38677,4640,4619,4643,4541,4680,4873,4198,32194
38680,6233,6175,5794,5481,5580,5269,6194,40726
38683,4814,5347,5323,5250,5344,5158,5637,36873
38685,1443,1455,1017,891,1316,1285,1347,8754
38701,22793,22790,22959,23774,23728,24367,24187,164598
38702,0,0,0,0,0,0,1,1
38703,13700,14034,14262,13799,14058,14139,14568,98560
38704,3,4,3,6,25,77,41,159
38720,584,671,700,678,668,852,597,4750
38721,944,959,988,1129,1198,1187,1230,7635
38722,491,384,448,482,551,586,531,3473
38723,14,23,22,5,6,5,33,108
38725,864,871,852,817,820,875,998,6097
38726,432,464,483,374,402,604,532,3291
38730,2263,2183,1947,1802,1682,2021,1718,13616
38731,198,280,184,171,230,188,129,1380
38732,18373,18126,18060,17853,17896,17785,17981,126074
38736,405,481,379,450,618,734,440,3507
38737,2967,2948,3748,3876,4096,3320,2932,23887
38738,3504,3463,2813,2874,2881,3737,3998,23270
38740,365,411,384,390,347,348,466,2711
38744,894,941,928,813,837,687,682,5782
38745,114,155,111,129,172,171,144,996
38746,447,434,439,604,742,807,616,4089
38748,3695,4048,4209,4193,4231,4699,3901,28976
38749,26,26,20,16,20,17,26,151
38751,11074,11342,11610,11508,11611,11800,11638,80583
38753,1347,1237,1391,1255,1473,1605,1456,9764
38754,1492,1557,1625,1812,1751,1766,1532,11535
38756,6360,6268,6259,6679,6854,6696,6462,45578
38759,1004,1048,1095,1146,1074,1014,1194,7575
38760,950,1043,1126,1005,872,701,929,6626
38761,2383,2495,2496,2526,2674,2780,2870,18224
38762,2316,2450,2523,2494,2561,2507,2294,17145
38764,209,304,274,321,370,439,430,2347
38765,55,88,83,84,89,80,201,680
38767,45,41,45,96,83,100,77,487
38768,74,86,26,158,171,186,182,883
38769,1870,2022,2126,2413,2439,2453,2216,15539
38771,3239,3120,3164,3165,3042,3097,3260,22087
38772,120,118,137,208,145,164,182,1074
38773,2917,3121,3454,3744,3590,3539,3375,23740
38774,2679,2700,2590,2409,2388,2272,2522,17560
38778,1641,1570,1574,1669,1670,1759,1686,11569
38781,278,260,247,219,163,149,252,1568
38801,29004,29114,29568,29730,29129,29186,29871,205602
38804,18135,17091,17824,17754,17595,17312,17285,122996
38821,12555,12361,12470,12346,12418,12788,12528,87466
38824,7865,8094,8451,8278,8821,8744,7832,58085
38826,5374,5705,5109,4730,4745,4868,4703,35234
38827,3368,3287,3230,2730,2762,2617,2733,20727
38828,4274,4315,4721,4838,4718,4505,3970,31341
38829,18783,18336,18005,18131,17890,17907,18707,127759
38833,2732,2869,3029,2983,3165,2966,2370,20114
38834,29282,29202,29591,29944,29772,29209,29133,206133
38838,1294,1283,1409,1401,1363,1557,1629,9936
38841,2711,3342,2835,2690,2000,2507,2775,18860
38843,12132,11979,11489,11607,11518,11748,11467,81940
38844,170,188,175,153,173,109,131,1099
38846,2431,2397,2156,2223,2363,2766,2446,16782
38847,2917,2981,3245,3158,3382,3299,3501,22483
38848,1022,935,1090,947,894,573,848,6309
38849,6986,6181,5587,5635,5685,5142,5702,40918
38850,2971,2862,2888,2910,3067,3216,3141,21055
38851,8090,8258,8540,8407,8522,8918,8408,59143
38852,9012,8817,8745,9166,8802,8959,9449,62950
38855,4489,4875,5017,4876,5062,4992,4602,33913
38856,1782,1861,1702,1841,1846,1794,1788,12614
38857,3628,3595,3522,3490,3220,3288,3252,23995
38858,7048,6827,7391,7392,6986,6883,7176,49703
38859,795,835,560,614,618,846,749,5017
38860,5718,5516,5313,5585,5647,5678,5663,39120
38862,2005,2155,2004,2265,2871,2841,2731,16872
38863,20922,20191,20350,20306,20871,20299,19788,142727
38864,2125,1972,1875,1823,1559,1522,1701,12577
38865,4707,4585,4553,4211,4223,4654,4698,31631
38866,11703,12746,12845,12534,11878,11788,11897,85391
38868,5442,5549,5291,5133,4937,4845,5481,36678
38869,491,526,420,390,276,208,478,2789
38870,2742,2668,2491,2559,2941,3025,3122,19548
38871,1970,1923,1776,1998,2080,1729,1640,13116
38873,2731,2842,2761,2582,2609,2584,2719,18828
38876,1470,1341,1443,1619,1476,1417,1322,10088
38878,2897,3090,2941,2919,3033,2861,2864,20605
38879,772,882,634,526,671,715,785,4985
38901,18323,18568,18635,18306,18627,18855,18403,129717
38913,323,256,365,430,422,481,396,2673
38914,570,548,406,447,505,466,552,3494
38915,3712,3724,3825,3994,3876,4002,4046,27179
38916,5472,5282,5375,4809,4787,4690,5049,35464
38917,3149,2994,3286,2695,2851,2928,3258,21161
38920,515,380,541,679,598,654,804,4171
38921,4060,2874,4564,4831,4842,4954,5061,31186
38922,3493,3172,3405,3493,3693,3938,3451,24645
38923,1666,1670,1465,1772,1713,1294,1293,10873
38924,828,826,779,604,784,698,771,5290
38925,2458,2469,2289,2492,2412,2604,2363,17087
38927,1170,988,1081,1068,1091,988,1186,7572
38928,332,143,300,347,286,465,497,2370
38929,1380,1220,1286,1365,1213,1309,1317,9090
38930,23881,24919,25087,26085,26028,26375,25297,177672
38940,1966,1896,1861,1589,1574,1596,2141,12623
38941,4677,4947,5024,4638,4823,4975,5282,34366
38943,270,246,431,407,365,190,526,2435
38944,646,435,411,537,446,500,504,3479
38945,45,22,16,14,17,20,35,169
38946,341,336,361,341,399,315,362,2455
38947,435,560,493,653,570,810,445,3966
38948,2613,2462,2233,1782,1883,1793,2288,15054
38949,231,263,53,78,140,194,297,1256
38950,482,279,161,265,247,325,334,2093
38951,1163,1362,1354,1572,1491,1661,1316,9919
38952,462,618,684,662,767,784,611,4588
38953,555,580,610,1030,1237,905,798,5715
38954,1466,1321,1060,1115,1171,1257,1514,8904
38957,718,508,624,615,579,600,734,4378
38958,30,34,27,29,30,0,38,188
38961,771,703,791,720,905,753,803,5446
38962,157,44,84,77,77,72,149,660
38963,4962,8148,5608,5414,5063,5014,4015,38224
38964,212,167,284,270,269,257,104,1563
38965,8663,8701,8854,9024,8595,8312,9135,61284
38966,851,508,771,792,996,928,1174,6020
38967,6926,6998,6911,7550,7519,7532,7755,51191
39038,6446,6492,6549,6518,6702,6550,6258,45515
39039,1654,1505,1892,1838,1993,2061,2193,13136
39040,3782,3994,4176,3785,3531,3195,3295,25758
39041,3511,3614,4028,4003,3680,3518,3404,25758
39042,36486,36159,35777,33776,34594,34591,34198,245581
39044,3991,3812,4050,4101,3588,3591,3872,27005
39045,1289,1226,1258,1369,1445,1410,1353,9350
39046,27721,27359,27121,26746,26475,26219,26398,188039
39047,39043,38290,37880,38370,37728,35843,34539,261693
39051,16491,16328,16799,16682,16659,17142,16569,116670
39054,423,415,411,519,519,430,341,3058
39056,26227,26218,26231,25996,26061,25676,25621,182030
39057,1832,1840,1766,2005,2034,2152,2291,13920
39059,12033,11910,12089,11623,11303,12059,12073,83090
39061,0,80,247,271,206,213,88,1105
39062,503,422,458,439,460,430,467,3179
39063,3752,3924,3507,3477,3472,3496,3620,25248
39066,4331,4575,4513,4761,4504,4757,4338,31779
39067,1586,1544,1595,1486,1495,1595,1434,10735
39069,5993,5989,6154,6417,6433,6076,5409,42471
39071,6179,5896,5680,5218,5023,4894,5346,38236
39073,19014,19331,19976,20122,19811,19197,19685,137136
39074,15174,14657,15049,14712,15395,15587,14896,105470
39078,890,976,1052,909,810,706,755,6098
39079,1961,1915,2139,2199,2112,2443,2037,14806
39082,1471,1513,1527,1282,911,976,1312,8992
39083,9784,10039,9961,10552,11474,10857,10626,73293
39086,1423,1723,1939,2435,2204,2140,1635,13499
39088,89,183,189,192,195,189,135,1172
39090,13673,13785,13673,13919,13631,13554,13398,95633
39092,2867,3197,3231,3262,3147,2894,2934,21532
39094,3285,3721,3578,3982,4419,4559,3956,27500
39095,7847,7699,7486,7562,7071,7084,7324,52073
39096,1708,1657,1812,1373,1401,1741,2338,12030
39097,450,392,422,495,548,896,873,4076
39108,2024,2117,1959,1844,1697,1576,1974,13191
39110,40739,39909,38795,38083,36954,35859,36143,266482
39111,9804,9804,9601,9270,9547,9727,10460,68213
39113,671,634,659,656,691,787,595,4693
39114,9986,9860,9584,10151,10307,10788,9998,70674
39115,29,25,28,51,137,169,155,594
39116,1843,1935,2275,2587,2882,3205,2538,17265
39117,10722,10571,10626,10035,9646,9520,10697,71817
39119,6068,6686,6348,5990,5917,4855,5506,41370
39120,31904,32148,32443,32501,32536,32453,32334,226319
39140,2184,2222,2075,2078,2249,2036,2250,15094
39144,876,1072,1020,1071,1152,924,867,6982
39145,4830,4498,4647,5220,5052,4840,5170,34257
39146,2073,2160,2353,2317,2708,2660,2841,17112
39149,1165,1419,1512,1459,1882,1827,1649,10913
39150,5862,5661,5528,5485,5623,6036,5914,40109
39152,1381,1322,1113,1218,1216,1083,1284,8617
39153,3692,4083,3992,3822,3619,3719,3724,26651
39154,9949,9978,10499,10381,10365,10375,10526,72073
39156,334,283,463,318,318,401,513,2630
39157,24825,24793,24781,24663,24585,24373,24645,172665
39159,3464,3464,3291,3128,3126,3111,3334,22918
39160,2443,2485,2658,2821,3234,3078,2889,19608
39162,29,59,88,78,103,123,205,685
39166,501,582,580,505,494,339,613,3614
39167,0,0,0,0,0,0,47,47
39168,7499,7321,6789,6921,6809,6158,6643,48140
39169,2583,2792,3058,3097,3175,3313,2957,20975
39170,10673,10593,9765,9417,9205,9006,9407,68066
39174,675,688,652,622,641,609,715,4602
39175,4224,3974,4399,4342,4807,4750,4843,31339
39176,2253,2033,2562,2045,2262,2459,2106,15720
39177,145,63,67,59,60,71,136,601
39179,1401,1518,1068,711,733,784,1228,7443
39180,33113,33365,33245,33827,33555,33401,32603,233109
39183,14387,14372,14583,14244,14546,14861,15661,102654
39189,4294,4585,4345,4737,4584,4243,5263,32051
39191,7959,7585,7508,7242,6699,7027,8074,52094
39192,1245,1324,1471,1334,1218,1504,1733,9829
39193,894,853,674,1092,989,303,968,5773
39194,20736,20619,20631,21466,21538,21820,20925,147735
39201,585,512,479,467,436,374,536,3389
39202,8085,8262,8613,9028,8808,8222,8411,59429
39203,6221,6316,6749,6666,7147,7290,7091,47480
39204,19870,20038,20082,19557,18964,18375,19468,136354
39206,25098,25258,25012,24890,24705,25055,25341,175359
39208,32360,32366,31411,29894,28990,30506,31371,216898
39209,28622,28530,27188,28998,30391,30835,29617,204181
39211,25204,25141,25346,24742,24713,24321,24515,173982
39212,33620,33517,34200,34092,33294,33644,33263,235630
39213,21653,22590,22758,22472,22700,23465,22328,157966
39216,3279,3037,2823,2952,3141,3391,3454,22077
39217,1182,1138,823,756,661,597,1103,6260
39218,6987,7330,7131,7240,7398,6988,6943,50017
39232,7266,6943,7199,7129,7099,7130,7068,49834
39269,0,0,0,0,0,0,0,0
39272,12597,12915,13118,13402,13364,12692,12551,90639
39301,25465,25909,25963,26616,27139,26982,27449,185523
39305,20809,20068,20539,20578,20319,20285,20431,143029
39307,18045,18964,19159,18484,18377,18454,18603,130086
39309,451,487,534,590,651,835,601,4149
39320,1880,2036,2194,2226,1952,1896,1828,14012
39322,1849,1371,1467,1670,1867,1627,1882,11733
39323,1215,1402,1239,1103,1071,1243,1290,8563
39325,6693,6035,5717,6332,5978,6229,5983,42967
39326,797,971,1147,1173,1151,986,720,6945
39327,4383,4411,4432,4251,4332,4312,4190,30311
39328,4758,4429,5058,4932,4977,5477,4806,34437
39330,2330,2504,2517,2621,2495,2729,2746,17942
39332,1642,1641,1824,1705,2046,1901,1923,12682
39335,3355,3208,3249,3395,3401,3126,3160,22894
39336,1130,1041,1090,1157,1114,1300,1235,8067
39337,2050,1842,1808,1944,1870,1822,1808,13144
39338,4123,3706,3707,3360,3089,3072,3319,24376
39339,14946,15407,15614,15725,15654,16137,15619,109102
39341,7470,7176,6896,6749,6586,6927,7156,48960
39342,1406,1374,1362,1579,1284,1137,1287,9429
39345,6500,6479,6303,6296,6190,6365,6127,44260
39346,2195,2164,2113,2480,2752,2398,2241,16343
39347,1476,1622,1562,1618,1655,2037,1497,11467
39348,854,743,717,516,287,107,838,4062
39350,25564,25525,25998,25605,25375,24902,24865,177834
39352,337,377,543,644,692,654,812,4059
39354,2160,1880,1220,1175,1280,1269,2094,11078
39355,7162,6685,6603,6579,6341,6361,7131,46862
39356,597,433,589,635,648,845,659,4406
39358,1914,2050,1669,1630,1756,1533,1679,12231
39359,317,314,252,235,181,283,273,1855
39360,3466,4167,4334,4497,4663,4888,3830,29845
39361,1524,1488,1679,1951,1906,2043,1468,12059
39362,2915,2669,2615,2495,3127,2849,2866,19536
39363,1610,1754,1798,1607,1742,1658,1773,11942
39364,3172,3847,3592,3177,3473,3245,2985,23491
39365,6702,6787,6785,7098,7359,7305,7547,49583
39366,1572,1486,1448,1275,1317,983,1380,9461
39367,14762,14505,14642,14705,14372,14900,15096,102982
39401,43321,43905,44176,44309,43639,43216,43366,305932
39402,41877,42326,41274,39090,38401,37003,37492,277463
39406,2001,2069,2114,2072,2124,2405,1759,14544
39421,2370,2664,2880,3468,3413,3307,2936,21038
39422,5308,5416,5286,5491,5307,5202,5146,37156
39423,2711,2725,2667,2722,2652,2661,2690,18828
39425,1748,1724,1559,1704,1681,1403,1754,11573
39426,17285,17434,16057,15889,15403,14968,16301,113337
39427,1571,1666,1696,1532,1178,1009,1314,9966
39428,9490,9488,9349,9683,9659,9995,9761,67425
39429,16929,16689,17420,17909,17718,17810,17657,122132
39437,13626,13830,13376,13484,12657,12354,12917,92244
39439,4226,4349,4355,4340,4447,4513,4573,30803
39440,20546,20521,20470,20414,20520,21285,21305,145061
39443,21709,21351,21495,22142,22842,22506,21939,153984
39451,6857,7275,7576,7697,7118,7120,7181,50824
39452,27330,27668,27754,27266,27041,26433,26964,190456
39455,9767,9997,10383,9679,9231,9129,9721,67907
39456,1020,1108,883,1296,1325,1563,1292,8487
39459,4110,4215,4393,3713,3751,2980,3677,26839
39461,646,648,479,409,649,511,582,3924
39462,1121,1477,1585,1563,1599,1861,1122,10328
39464,2031,2243,2414,2552,2536,2831,2482,17089
39465,21218,21242,21154,21371,21719,21435,21386,149525
39466,27297,26825,28030,28072,28673,28387,27738,195022
39470,11934,12308,12581,13394,13607,13656,13011,90491
39474,5553,5337,5788,5801,6050,6808,6050,41387
39475,12433,11680,11552,12295,12120,12068,12225,84373
39476,8011,7432,7305,6752,6637,6577,7582,50296
39477,698,642,767,664,627,687,686,4771
39478,2283,2424,2220,2153,2036,1706,2201,15023
39479,5461,5321,5331,5255,5055,6467,5796,38686
39480,2887,3010,2944,3340,2934,2712,2770,20597
39481,1568,1814,1864,1789,2042,2329,1867,13273
39482,10151,8547,8893,8821,9320,8515,9746,63993
39483,6427,6525,6111,5760,6183,6096,6447,43549
39501,22159,21800,21735,21865,21740,21674,21987,152960
39503,52387,50568,49448,48348,46548,44735,45309,337343
39507,16771,16653,16303,15754,15719,15541,16234,112975
39520,16831,16024,15655,14877,14850,14836,14681,107754
39525,8341,8246,8275,8777,8546,8324,8383,58892
39530,8002,7917,7940,8366,8143,7886,8086,56340
39531,17752,17468,18117,17668,17266,17403,17736,123410
39532,36207,35164,34311,34953,34252,34475,32716,242078
39534,2650,2846,2591,2335,2179,1888,2379,16868
39540,9422,9124,8866,8567,8749,8573,8522,61823
39553,17257,17015,17148,17469,17543,17273,17174,120879
39556,7655,8120,7735,7661,7337,7663,7705,53876
39560,17388,17496,17233,16987,16553,16495,16844,118996
39561,2785,2910,2378,2197,2155,1877,1852,16154
39562,17333,17110,17627,17019,17486,17657,17912,122144
39563,13664,13734,13734,13786,13842,13921,13790,96471
39564,39662,39480,37760,38187,38000,36885,36952,266926
39565,18314,19116,20067,19040,18689,18691,19453,133370
39567,11347,11165,10745,10787,10529,10652,10740,75965
39571,13674,13875,13767,13143,13069,12545,13179,93252
39572,1445,1460,1557,1430,1032,1053,1414,9391
39573,8090,7840,7980,7832,8325,8767,8828,57662
39574,12476,12863,12659,12299,12840,12817,13613,89567
39576,5893,5921,5966,5910,5781,5615,5809,40895
39577,9944,9985,10395,10866,10600,10659,10374,72823
39581,10847,11054,11481,11576,11956,12144,11595,80653
39601,23519,23800,23798,23907,24780,24173,23536,167513
39629,6464,6274,6643,6716,6054,6771,6519,45441
39630,794,905,1032,1337,1260,1289,1115,7732
39631,3487,3381,3352,3478,3766,3920,3732,25116
39633,1322,1222,1242,1360,1441,1318,1094,8999
39635,249,258,177,111,244,141,170,1350
39638,3351,3134,3043,2923,3114,2855,3333,21753
39641,3729,3820,4197,4428,4526,4455,4569,29724
39643,1194,1427,1184,1169,829,914,1102,7819
39645,5169,5506,5704,5195,4753,5158,5016,36501
39647,1399,1217,998,1070,582,643,1023,6932
39648,21584,22243,22772,22291,22395,22748,21710,155743
39652,7730,7502,7627,8310,8821,8477,8315,56782
39653,2797,2819,2855,2854,3169,2928,2799,20221
39654,5170,5460,5316,5382,5732,5599,5635,38294
39656,784,899,967,1012,1055,1250,803,6770
39657,1569,1678,1483,1721,1885,1968,2351,12655
39661,2617,2814,2810,2691,2707,3033,2997,19669
39662,1240,1284,1244,1040,1160,957,1318,8243
39663,3381,3171,3107,3028,2749,2633,3080,21149
39664,2093,2183,2115,2184,2127,2227,2256,15185
39665,1293,1229,1174,1150,1180,1321,1196,8543
39666,10574,10358,9628,9612,9232,8949,9588,67941
39667,12334,12318,12518,12543,12727,13454,12837,88731
39668,498,437,168,227,422,603,681,3036
39669,5192,5320,5688,5959,5715,5796,6045,39715
39701,13781,13424,13162,13835,14097,14111,13997,96407
39702,23161,22973,22953,22239,22418,22568,22883,159195
39705,13848,13602,14037,14421,14023,13577,13667,97175
39730,10863,11297,11407,11667,12223,12178,11805,81440
39735,3679,3747,4003,4073,4180,4229,3916,27827
39736,221,232,280,279,303,295,312,1922
39737,374,258,399,439,585,536,285,2876
39739,2034,2528,2730,2716,3094,2734,2957,18793
39740,5017,5508,5635,5436,5490,5549,5038,37673
39741,1668,1296,1295,1340,1438,1467,1560,10064
39743,1385,1597,1736,1706,1492,1566,2067,11549
39744,5401,5588,5575,5595,5628,5522,6008,39317
39745,924,804,716,824,759,641,810,5478
39746,3530,3578,3471,3264,3094,3229,3183,23349
39747,1678,1941,2096,1838,1886,1819,1999,13257
39750,2480,2269,2604,2899,2641,2969,2781,18643
39751,1693,1732,1477,1507,1286,1156,1309,10160
39752,2913,3021,2887,2603,2729,2574,2473,19200
39755,653,703,800,785,889,878,1051,5759
39756,1816,2131,2412,2361,2331,2244,1943,15238
39759,43449,43060,42634,42474,41887,42329,42108,297941
39760,0,0,0,0,0,0,23,23
39762,3066,2931,2728,2504,2238,1764,2207,17438
39766,2981,3136,2768,2543,2526,2542,2630,19126
39767,558,544,595,621,540,547,861,4266
39769,1971,2000,2091,1990,2075,1798,1923,13848
39771,96,111,130,153,226,166,127,1009
39772,1576,1562,1640,1512,1676,1965,1793,11724
39773,16293,16499,16252,16658,16699,16902,16670,115973
39776,1581,1599,1581,1447,1465,1346,1674,10693
39813,2213,1936,1824,1933,2103,2040,2110,14159
39815,1956,2147,2096,1702,1666,1952,1686,13205
39817,10969,10477,10724,11474,11597,11686,10894,77821
39819,10328,10343,10626,10510,10654,10567,11282,74310
39823,8053,7972,8400,8727,8687,8702,8550,59091
39824,446,415,385,367,478,492,544,3127
39825,1204,1772,1527,1386,1283,1316,1461,9949
39826,453,438,777,656,702,678,418,4122
39827,4321,4081,4346,4020,4157,4104,3842,28871
39828,15179,15519,15261,15448,14993,14481,15150,106031
39834,2399,2251,2248,2075,2218,1978,2138,15307
39836,519,526,636,671,669,442,461,3924
39837,6110,6138,6251,6116,6112,6161,6166,43054
39840,5417,5329,5299,5335,5366,5440,5726,37912
39841,766,668,581,573,676,739,878,4881
39842,8289,8256,7957,8044,8110,8247,8357,57260
39845,7815,7939,7674,8016,7653,7846,7871,54814
39846,1784,1846,1728,1745,1617,1757,2440,12917
39851,2053,2154,2271,2233,2419,2259,2388,15777
39854,2095,2360,2449,2397,2591,2708,2592,17192
39859,1148,1142,1232,1194,1469,1213,1281,8679
39861,1178,1313,1140,1090,1065,1182,1003,7971
39862,1352,1183,1285,1177,1133,981,1326,8437
39866,2346,2830,2879,2923,2961,2870,2122,18931
39867,590,431,371,454,204,164,321,2535
39870,2153,2259,2423,2477,2469,2558,2238,16577
39877,304,379,407,452,479,450,500,2971
39885,99,123,146,154,155,162,76,915
39886,1439,1666,1607,1600,1717,2047,1616,11692
39897,3645,3517,3490,3403,3632,3742,3430,24859
40003,2038,2271,2510,2367,1962,2020,1902,15070
40004,29494,29563,29228,28815,27806,27925,28245,201076
40006,5008,4863,4679,4820,5068,4998,5084,34520
40007,238,228,251,85,178,166,166,1312
40008,3614,3579,3786,3677,3930,3949,3476,26011
40009,1059,1258,1546,1543,1408,1024,1051,8889
40010,743,651,495,542,560,572,587,4150
40011,2229,2378,2226,2217,2351,2471,2549,16421
40012,458,496,459,629,457,395,589,3483
40013,5332,5285,5389,5546,5825,5336,5369,38082
40014,20649,20595,20317,20153,19998,20149,19986,141847
40019,3738,3789,3891,3725,3384,3680,3789,25996
40020,165,121,112,124,92,164,109,887
40022,1058,921,826,813,836,914,834,6202
40023,4671,4727,4598,4384,3732,3801,4118,30031
40025,45,29,58,74,85,73,59,423
40026,5748,5788,5747,5449,5107,5374,5458,38671
40031,24597,24095,23358,23006,22390,22050,22863,162359
40033,12972,12704,12581,12372,12225,12227,12355,87436
40036,225,241,237,276,304,377,223,1883
40037,2670,2771,2745,2747,2886,2887,2864,19570
40040,456,522,473,456,481,473,531,3392
40041,336,275,277,323,381,391,286,2269
40045,3203,3370,3489,3612,3380,3338,3451,23843
40046,1597,1774,1881,2118,1924,1875,1741,12910
40047,20290,20197,19820,18708,19531,19164,19345,137055
40048,137,137,111,101,89,74,113,762
40049,108,107,109,109,109,111,115,768
40050,1777,1726,1828,1593,1644,1674,1389,11631
40051,4252,4251,4445,4472,4663,4611,4799,31493
40052,655,629,520,534,706,638,515,4197
40055,2167,2084,2040,1862,1585,1433,1752,12923
40056,3483,3493,3527,3471,3680,3472,3263,24389
40057,3279,3225,3336,3647,3947,3687,3354,24475
40058,73,90,104,87,89,76,64,583
40059,18614,17986,17785,17330,17195,16514,16708,122132
40060,1024,1056,1174,1115,1099,1060,1184,7712
40062,264,344,385,426,482,482,301,2684
40063,420,624,663,761,780,797,789,4834
40065,30359,29713,28933,28694,27823,27125,28025,200672
40067,5368,5313,5353,5459,5606,5735,5114,37948
40068,1891,1826,1961,2152,2140,2116,2131,14217
40069,8617,8553,8475,8294,8315,8027,8276,58557
40070,428,429,383,524,578,635,582,3559
40071,15470,14818,14636,14424,14635,14038,14292,102313
40075,1332,1242,1298,1207,1229,1239,1323,8870
40076,2301,2307,2182,2033,2505,2464,2516,16308
40077,375,382,377,475,538,503,564,3214
40078,2283,2232,2322,2273,2185,2365,2200,15860
40104,889,1166,1267,1203,1108,1031,1336,8000
40107,2303,2229,2033,2013,1965,1938,2067,14548
40108,12138,11782,11566,11583,11394,11558,11583,81604
40109,2023,1923,2424,2468,2641,2468,1990,15937
40110,12,12,12,16,13,20,60,145
40111,1480,1525,1662,1706,1712,1694,1682,11461
40115,577,579,686,724,601,576,727,4470
40117,2356,2421,2081,2553,2110,2043,2299,15863
40118,9433,9285,9767,9452,9710,9211,9724,66582
40119,1808,1666,1580,1664,1635,1826,1797,11976
40121,9226,9449,10271,10555,10946,11308,10124,71879
40140,581,509,514,423,658,798,787,4270
40142,2257,2677,2691,2500,2405,2279,2304,17113
40143,6119,6167,6515,6725,6466,6550,5939,44481
40144,2092,1933,1779,1730,1382,1366,1866,12148
40145,669,859,786,996,1194,1220,908,6632
40146,4215,4420,4353,4350,4399,4040,3745,29522
40150,4202,3797,3839,3744,3603,3533,4103,26821
40152,679,514,380,382,470,556,604,3585
40155,1240,1063,1173,1100,1246,1288,947,8057
40157,685,645,638,755,888,965,876,5452
40160,23486,23643,23689,23361,22999,22939,23574,163691
40161,140,190,184,118,73,71,178,954
40162,5862,6644,6245,5985,5912,5914,6056,42618
40165,34538,34579,33626,34077,32875,32348,32726,234769
40170,247,256,275,306,273,378,344,2079
40171,274,197,236,230,192,195,243,1567
40175,14329,14022,13961,13198,13318,12385,13070,94283
40176,1057,1019,1126,967,1179,987,931,7266
40177,1610,1431,1388,1469,1553,1368,1463,10282
40178,592,706,654,460,464,438,468,3782
40202,6411,6362,6468,6442,6429,6319,6772,45203
40203,19004,18964,18347,18884,19270,19241,19694,133404
40204,14661,14353,14229,14426,14480,14238,14236,100623
40205,24342,24134,24068,23865,23483,23146,23678,166716
40206,19352,19144,19277,18778,18474,18576,18865,132466
40207,30864,30544,30237,29805,28989,29161,29745,209345
40208,16935,16186,15480,14482,13727,13478,13227,103515
40209,522,450,485,586,683,611,360,3697
40210,14194,15044,15250,15544,16230,15042,14822,106126
40211,22826,23434,23622,22297,22770,23638,22612,161199
40212,18031,18348,17308,18359,18628,18478,17685,126837
40213,16117,16327,15834,15921,16008,15817,16796,112820
40214,44480,45370,45756,46134,44880,45052,45291,316963
40215,21643,21052,22342,22747,23450,23251,22287,156772
40216,42371,41358,40844,40903,40697,41535,40746,288454
40217,12687,12972,13077,12813,12102,12413,12507,88571
40218,31703,31971,30193,29834,29441,28983,31658,213783
40219,39475,40370,39651,39577,38383,37852,38032,273340
40220,33523,33009,33941,33525,32610,33279,33109,232996
40222,21520,21021,21221,21628,21922,21820,21359,150491
40223,23168,22079,21491,21610,21500,21366,22011,153225
40228,16150,16010,16008,15771,15897,15504,15743,111083
40229,37632,36788,36536,36741,36630,36843,36852,258022
40231,0,0,0,0,0,0,0,0
40241,30263,29891,29907,29783,29260,28742,28988,206834
40242,11304,11403,11334,11193,10761,11002,10930,77927
40243,10364,10361,10569,10509,10004,10219,10210,72236
40245,33338,32896,31941,30743,30352,29373,30109,218752
40258,27410,27000,27222,27394,27304,26685,26465,189480
40272,37138,38519,38758,37708,37826,37126,37394,264469
40280,692,595,536,450,406,394,303,3376
40291,37403,36786,35110,34087,33897,33278,35427,245988
40299,38969,38402,38952,38530,38833,38530,38371,270587
40310,539,554,626,682,681,569,526,4177
40311,7378,7389,7296,7296,7406,7222,7153,51140
40312,5551,5943,6435,6647,6801,6504,5898,43779
40313,3489,3723,3665,3853,3867,3880,3143,25620
40316,380,203,334,376,394,400,309,2396
40322,3016,3049,3131,3284,3258,3436,3328,22502
40324,45547,44644,43689,42552,41752,40540,41342,300066
40328,1154,1048,965,1017,951,883,1065,7083
40330,19289,19113,18747,18977,19135,19601,19334,134196
40334,128,103,91,114,111,37,76,660
40336,12891,13071,13071,13139,13081,12997,13061,91311
40337,4904,5331,5396,5516,5736,5565,5501,37949
40339,0,0,0,0,0,42,46,88
40342,21591,21465,21426,21305,21222,21076,21125,149210
40346,923,915,947,688,769,586,686,5514
40347,2748,2791,2873,2806,2937,2903,2767,19825
40348,642,679,735,730,680,550,600,4616
40350,128,112,124,106,128,230,228,1056
40351,20848,19918,19839,19590,19549,19475,20329,139548
40353,22360,21542,21228,20682,20189,20093,20779,146873
40356,42478,42266,41361,41331,40082,39616,40503,287637
40358,673,530,699,802,1228,1213,904,6049
40359,6487,6525,6665,6899,7410,7468,7080,48534
40360,6691,6850,6749,6905,6908,6710,6564,47377
40361,18242,18113,18110,18259,18103,18338,18220,127385
40363,0,0,0,0,0,0,22,22
40370,2516,2455,2309,2349,2900,2748,2763,18040
40371,3221,3246,2934,2935,2378,2576,2838,20128
40372,2126,2150,2387,2270,2143,1927,2128,15131
40374,1792,1816,1914,1707,1820,2033,1702,12784
40376,15,0,0,14,35,36,52,152
40379,3490,3344,3320,3545,3092,3256,3288,23335
40380,6642,6313,6117,5921,5802,6190,6612,43597
40383,23301,22545,22168,22196,21906,21532,22408,156056
40385,2569,2581,2510,2950,2906,2837,3131,19484
40387,2076,2211,1981,2009,1933,1900,2046,14156
40390,7447,7486,7636,7154,8001,7854,7366,52944
40391,35365,35360,35351,35298,35204,35037,35262,246877
40402,2351,2525,2257,2106,2102,2385,2905,16631
40403,25145,24794,24369,24471,24549,24145,23774,171247
40404,800,740,734,664,690,698,643,4969
40409,3930,4150,3922,3626,3475,3621,3843,26567
40419,4307,4683,4584,4250,4109,4016,4621,30570
40422,24971,24748,24762,24399,24410,24129,24280,171699
40434,109,84,88,88,32,0,34,435
40437,5226,5459,5498,5756,5400,5307,4932,37578
40440,2155,2192,2318,2300,2422,2519,2092,15998
40442,1839,1548,1327,1156,993,1143,1136,9142
40444,14374,14079,13948,13701,13803,13955,14096,97956
40445,847,817,814,883,897,927,997,6182
40447,7846,7975,7959,7744,8250,8604,8251,56629
40448,56,38,0,0,0,0,53,147
40456,9548,9636,9614,9913,9804,9741,9300,67556
40460,949,918,923,856,1166,1184,1129,7125
40461,3240,3315,3132,3291,3454,3400,3121,22953
40464,1238,1120,921,926,865,765,1114,6949
40468,2041,2186,2095,2057,1889,1925,1807,14000
40472,1576,1462,1514,1473,1596,1799,1679,11099
40475,59221,57892,58341,56351,55310,55005,55803,397923
40481,275,278,351,342,281,208,218,1953
40484,11025,10915,11013,10924,11434,11105,11612,78028
40486,2876,2584,2788,3191,2901,2449,2223,19012
40489,3643,3801,3933,4437,4299,4794,4109,29016
40502,26410,26335,26660,26931,26508,26375,25709,184928
40503,28924,28611,28100,27755,28245,27942,28003,197580
40504,26607,26282,26123,25884,24988,24833,25655,180372
40505,25850,26476,26783,26212,25849,25279,26040,182489
40506,2742,2714,2242,2128,2195,2355,2802,17178
40507,1754,1710,1691,1677,1455,1495,1757,11539
40508,26984,26515,25868,24968,24718,23688,23569,176310
40509,37242,35588,34463,34413,33265,32643,32364,239978
40510,2098,2314,2291,2193,2103,2033,1928,14960
40511,32750,32265,31135,31143,30374,29035,31798,218500
40513,10780,11188,11200,11109,11333,11566,10994,78170
40514,15606,15337,14773,14934,15088,14522,14647,104907
40515,35315,34919,34933,34375,34420,35274,33595,242831
40516,2964,2979,2883,2596,2504,2577,2877,19380
40517,36489,36025,36147,35333,34659,33818,35227,247698
40601,50471,50313,50239,49984,49948,49807,49566,350328
40604,194,293,370,437,488,544,462,2788
40701,29674,29797,28250,28275,28222,28440,29497,202155
40729,5653,5814,6156,6261,6101,5937,5485,41407
40734,3409,3376,3534,3349,3066,3362,3764,23860
40737,960,1038,1246,1377,1104,1113,1379,8217
40740,3247,3049,3531,3319,3368,3536,3321,23371
40741,22110,22195,22812,22623,22700,21866,21875,156181
40743,114,232,254,410,341,340,229,1920
40744,19096,18763,17804,17272,17338,17467,18334,126074
40759,3159,3530,3264,3084,3258,2833,2531,21659
40763,557,541,601,561,747,672,469,4148
40769,17619,17160,17447,18135,17667,18657,18507,125192
40771,1650,1503,1309,1152,1322,855,1068,8859
40801,562,519,573,484,363,440,531,3472
40806,2388,2162,2492,2826,3253,2963,2499,18583
40807,363,382,374,425,440,500,337,2821
40808,51,49,40,73,180,236,99,728
40810,1343,1468,1463,1151,1373,1270,1548,9616
40813,532,531,636,649,475,528,669,4020
40815,1355,1464,1439,1389,1520,1420,1534,10121
40816,5,21,15,33,36,36,78,224
40818,83,92,64,50,48,36,110,483
40819,744,739,631,821,969,1101,729,5734
40820,663,530,395,357,351,506,581,3383
40823,3960,4208,4045,4247,4588,4462,4231,29741
40824,416,530,624,774,697,718,559,4318
40826,791,802,824,1190,1054,1039,759,6459
40827,953,788,854,555,814,721,674,5359
40828,3614,3598,3598,3561,3390,3360,3965,25086
40829,349,434,303,295,232,117,172,1902
40830,296,341,345,325,430,344,301,2382
40831,5357,5494,5398,5337,5104,5051,5150,36891
40840,183,192,177,254,129,167,312,1414
40843,238,227,315,290,348,412,259,2089
40844,60,101,55,38,46,51,123,474
40845,661,708,593,508,351,384,635,3840
40847,315,337,259,256,160,193,261,1781
40849,398,383,375,391,410,445,352,2754
40854,1103,1083,1029,1200,1193,1345,1213,8166
40855,742,770,841,920,975,1089,860,6197
40856,755,820,738,970,782,879,756,5700
40858,230,204,284,596,509,516,397,2736
40862,461,565,680,818,769,762,647,4702
40863,611,585,567,554,484,476,502,3779
40865,393,420,452,352,335,250,410,2612
40868,965,1347,1322,1264,1108,1254,1100,8360
40870,410,396,346,292,394,433,279,2550
40873,2304,2167,2499,2205,1885,2000,2390,15450
40874,487,526,478,541,533,421,504,3490
40902,1226,1120,1186,1057,1024,1285,1239,8137
40903,548,542,540,759,791,789,681,4650
40906,11963,12112,11730,11614,11636,10470,11132,80657
40913,393,306,277,144,158,105,171,1554
40914,279,242,401,467,565,376,467,2797
40915,667,887,1087,1535,1441,1511,896,8024
40921,336,336,350,385,265,282,295,2249
40923,575,571,979,1037,966,1019,735,5882
40927,235,275,219,199,178,240,482,1828
40935,2796,2593,2916,2634,2920,3279,2699,19837
40939,165,142,158,218,256,339,273,1551
40940,661,707,678,572,572,578,478,4246
40941,389,290,133,121,113,51,251,1348
40943,731,737,750,795,822,868,748,5451
40946,178,170,165,154,92,261,220,1240
40949,855,598,559,615,717,689,788,4821
40953,923,1141,992,945,944,1099,998,7042
40958,346,500,524,347,407,365,451,2940
40962,18284,18474,18611,18774,18879,19368,19143,131533
40964,14,13,212,303,349,451,151,1493
40965,13176,13744,13732,13352,13790,13346,13570,94710
40972,1166,1229,1202,1166,1110,1299,1327,8499
40977,9947,9500,9718,10452,10901,11013,10362,71893
40979,172,161,254,255,271,108,148,1369
40982,430,416,453,418,362,461,388,2928
40983,521,702,761,720,751,676,352,4483
40988,480,416,541,641,469,405,555,3507
40995,204,77,29,8,13,0,121,452
40997,384,346,422,348,417,458,371,2746
41001,16836,16581,16566,16510,16380,16235,16412,115520
41002,2375,2415,2397,2482,2604,2786,2510,17569
41003,2578,2617,2620,2324,2177,2211,2786,17313
41004,4361,4325,4402,4356,4448,4391,4122,30405
41005,23140,23848,24310,24406,24599,23971,22569,166843
41006,4356,4454,4235,4239,4859,4870,4434,31447
41007,3952,3995,4057,3684,3623,3911,4193,27415
41008,6938,7219,7282,7523,7602,7698,7457,51719
41010,4032,3858,4054,3662,3464,3162,3217,25449
41011,25188,25098,25068,25513,24974,25485,25872,177198
41014,7330,7539,7484,7728,7916,7477,6942,52416
41015,21179,20941,20465,20175,20928,20711,20864,145263
41016,6142,6088,6090,5832,5778,6039,6075,42044
41017,39815,39959,39886,39281,39399,39286,38940,276566
41018,27278,27784,27622,27386,27168,26787,27345,191370
41030,5775,5840,6010,6181,6013,5875,6299,41993
41031,15915,15796,15642,15999,15896,15702,15886,110836
41033,1907,2100,2046,1881,1577,1701,1976,13188
41034,978,1081,1181,967,973,1039,1032,7251
41035,10510,10710,10688,10571,10923,11039,10785,75226
41039,2587,2664,2738,2739,2730,2837,2502,18797
41040,7392,7066,7516,7680,7778,7460,7265,52157
41041,7521,7366,7508,7477,7868,7749,7153,52642
41042,51835,51276,50807,49747,49097,48507,49968,351237
41043,1621,1743,1855,1660,1368,1255,1745,11247
41044,899,808,988,983,1093,1248,1116,7135
41045,1998,1647,1667,1409,1285,1303,1273,10582
41046,1220,1282,1616,1991,1701,1775,1414,10999
41048,15417,15378,15156,14717,14704,14197,13959,103528
41049,2440,2446,1912,1968,1882,1939,2261,14848
41051,29317,28805,28419,28453,27546,26783,26796,196119
41052,72,65,45,65,28,23,107,405
41055,1926,1946,2046,2002,2015,1884,1813,13632
41056,13933,13958,13737,14082,14112,14085,14228,98135
41059,2539,2544,2484,3131,3192,3216,2712,19818
41062,43,59,62,64,22,17,35,302
41063,3300,3091,2920,3035,3036,3199,3378,21959
41064,1869,1929,1812,1834,1811,1749,2073,13077
41071,20724,20818,21009,21073,20951,21116,20869,146560
41073,5844,5773,5817,5810,5838,5996,5955,41033
41074,5420,5529,5498,5482,5485,5371,5338,38123
41075,16439,16482,16404,16399,16439,16348,16459,114970
41076,17694,18195,17611,16920,16352,15755,16468,118995
41080,2161,1631,1669,1753,1479,1890,1849,12432
41083,1376,1186,1094,998,891,751,1326,7622
41085,874,775,852,718,665,542,724,5150
41086,2938,3190,2733,2724,2881,2736,2771,19973
41091,18708,17899,17423,16622,16355,15659,16873,119539
41092,3744,3526,3474,3653,3950,4066,3514,25927
41093,2588,2640,3043,2925,2701,2520,2869,19286
41094,14840,14795,14308,13987,12784,12838,13631,97183
41095,3223,3294,3151,2967,3026,2984,3540,22185
41097,7776,7559,7355,7338,7333,7542,7349,52252
41098,1735,1922,2068,2096,1834,2078,2037,13770
41099,911,684,870,908,1025,1076,1169,6643
41101,19424,19280,19074,19425,19334,19086,18758,134381
41102,20087,20837,21413,21060,21106,21166,21712,147381
41121,1249,1456,1552,1499,1672,1492,1852,10772
41124,1396,1384,1382,1374,1326,1336,1039,9237
41129,10463,10331,9914,10018,10216,10030,9922,70894
41132,393,349,330,407,530,442,425,2876
41135,132,153,160,190,260,168,172,1235
41139,8160,8265,8176,8135,8211,8168,8271,57386
41141,2196,2365,2170,2126,2117,2534,2461,15969
41142,117,129,64,51,54,0,91,506
41143,14614,14902,14987,14272,14403,14413,14535,102126
41144,10117,9954,10739,10535,10663,10544,10279,72831
41146,388,406,324,256,308,276,412,2370
41149,601,621,640,538,560,500,733,4193
41159,331,347,320,366,437,567,583,2951
41164,13258,13081,13123,13532,13268,13455,13125,92842
41166,1243,998,815,996,808,802,919,6581
41168,2592,2373,2736,3147,3129,3221,3043,20241
41169,5872,6036,5503,5769,5854,5560,5354,39948
41171,4627,4646,4702,4737,4879,4825,5042,33458
41174,1003,950,1106,1166,1256,1437,1122,8040
41175,5430,5560,5615,6043,5665,6309,5591,40213
41179,7476,7430,7531,7555,7425,7109,7852,52378
41180,1025,900,938,1145,1111,1146,1087,7352
41183,1424,1334,1421,1407,1499,1640,1618,10343
41189,2393,2552,2526,2222,2068,2185,2264,16210
41201,125,226,390,291,267,283,238,1820
41203,590,603,629,745,616,595,696,4474
41204,473,631,721,770,854,764,560,4773
41214,511,586,569,434,599,579,750,4028
41216,1357,1196,1363,1117,982,985,1297,8297
41219,2105,2010,2039,2051,1965,1911,2053,14134
41222,2107,2182,2294,2469,3217,3218,2627,18114
41224,6532,6044,6318,6628,6712,7203,6414,45851
41226,307,281,251,112,84,30,168,1233
41230,12013,12063,11856,11658,11345,11259,11730,81924
41231,1049,1054,806,699,863,692,1002,6165
41232,826,756,830,597,599,665,782,5055
41234,533,468,263,346,463,570,601,3244
41238,667,806,908,1071,997,1032,860,6341
41240,7311,7817,7699,7899,7199,7082,6916,51923
41250,1254,1380,1312,1022,1104,901,1195,8168
41254,467,461,514,650,601,439,571,3703
41255,1269,1053,1105,1105,1163,948,1036,7679
41256,2400,2405,2250,1973,2035,1952,2433,15448
41257,484,275,285,202,255,413,390,2304
41260,1035,769,717,683,748,722,885,5559
41262,1236,1577,1703,1887,1604,1800,1474,11281
41263,461,385,304,420,328,312,525,2735
41264,295,304,237,142,233,252,389,1852
41265,1649,1833,1951,2050,2051,2127,1857,13518
41267,864,859,1000,1125,1223,1089,1245,7405
41268,434,373,345,282,303,544,395,2676
41271,248,247,317,292,197,193,237,1731
41274,718,662,578,474,448,488,585,3953
41301,6030,5921,6022,6057,5855,6107,6159,42151
41311,6713,6953,7436,7429,7786,7662,7538,51517
41314,4859,4928,5081,5266,5311,5248,5239,35932
41317,129,188,180,304,214,78,190,1283
41332,1180,1147,1161,1141,1395,1246,1184,8454
41339,11071,10906,10680,10543,10328,10745,10957,75230
41348,1088,1276,1473,1489,1654,1657,1219,9856
41352,795,865,884,721,635,611,677,5188
41360,409,511,346,409,540,454,500,3169
41365,447,497,411,478,397,595,501,3326
41366,11,11,9,10,0,0,20,61
41367,201,156,221,202,257,359,179,1575
41385,421,385,413,291,290,290,470,2560
41390,11,60,61,56,56,62,52,358
41397,20,16,17,0,13,11,64,141
41408,451,411,384,381,489,444,445,3005
41421,331,193,94,96,50,35,233,1032
41425,1155,1120,1112,983,1074,983,1138,7565
41464,658,619,736,713,671,836,722,4955
41465,11710,11768,11656,11734,11998,11986,11979,82831
41472,10318,10554,10842,11240,11480,11582,10985,77001
41501,23630,23505,24082,24221,24575,24212,23298,167523
41503,529,562,588,600,657,617,570,4123
41512,857,843,923,959,1007,933,976,6498
41513,398,508,451,555,467,455,590,3424
41514,2822,3123,3010,2978,3268,3432,3491,22124
41517,115,112,38,55,76,131,109,636
41519,1258,1084,1201,1203,1249,1237,1108,8340
41522,5104,4967,5075,5239,4966,5408,5352,36111
41524,164,222,289,419,373,374,384,2225
41526,71,93,104,108,179,134,125,814
41527,897,862,845,833,839,799,675,5750
41528,1004,908,633,603,662,728,999,5537
41531,876,1005,979,878,847,726,985,6296
41534,264,261,190,180,164,135,273,1467
41535,433,380,377,446,322,443,526,2927
41537,5243,5245,5503,5538,5653,5893,5373,38448
41538,74,47,30,34,45,0,97,327
41539,1470,1604,1717,1775,1833,2010,1722,12131
41540,275,280,296,235,358,460,302,2206
41543,542,600,543,547,384,382,543,3541
41544,873,962,772,1001,957,993,931,6489
41547,235,197,145,267,277,202,369,1692
41548,817,697,808,711,590,685,862,5170
41553,2040,2640,2931,2895,2835,2764,2288,18393
41554,957,1060,1081,1180,1294,1521,1102,8195
41555,746,834,800,862,1025,997,915,6179
41557,1781,1822,1809,2003,2040,2067,1716,13238
41558,819,666,695,697,854,878,809,5418
41559,410,431,354,311,458,247,339,2550
41560,310,351,356,317,226,258,384,2202
41562,2869,3071,3085,2616,2760,2666,2807,19874
41563,457,342,415,515,583,512,445,3269
41564,1165,1156,1310,1312,1263,1226,1159,8591
41566,883,805,791,659,461,446,714,4759
41567,212,196,255,191,155,141,369,1519
41568,780,791,727,705,832,777,1073,5685
41571,546,452,518,538,595,619,639,3907
41572,3778,3740,3761,3504,3051,3112,3754,24700
41601,784,931,953,546,619,676,755,5264
41602,527,534,411,363,550,523,819,3727
41603,1411,1229,1320,1365,1551,1591,1498,9965
41604,397,395,453,433,460,466,620,3224
41605,709,738,722,647,358,425,637,4236
41606,725,643,481,596,515,648,656,4264
41607,612,551,649,522,287,219,318,3158
41612,107,100,45,41,32,34,78,437
41615,764,482,683,580,510,530,675,4224
41616,517,708,752,744,811,788,794,5114
41619,364,391,489,560,533,689,599,3625
41621,281,279,230,504,443,341,329,2407
41622,235,258,367,392,265,379,228,2124
41630,1460,1426,1350,1293,1143,1328,1230,9230
41631,1576,1356,1443,1258,1009,872,1106,8620
41632,519,592,684,732,560,464,614,4165
41635,2725,3219,3172,2894,3010,2985,3056,21061
41636,883,889,936,912,894,797,984,6295
41640,1069,1230,1113,961,966,906,1343,7588
41642,548,603,579,523,631,618,725,4227
41643,105,219,296,301,180,192,194,1487
41645,1677,1420,1460,1228,1109,1058,1268,9220
41647,1614,1592,1514,1528,1781,2011,1815,11855
41649,2121,2516,2524,3004,3429,3624,2631,19849
41650,588,413,486,423,467,338,534,3249
41653,11183,11561,11968,12465,12534,12194,11451,83356
41655,1009,959,713,702,623,600,896,5502
41659,307,287,206,303,454,393,520,2470
41660,629,523,668,882,828,843,802,5175
41663,471,553,397,613,566,548,384,3532
41666,1155,1134,1083,951,977,945,908,7153
41667,763,721,624,655,675,853,720,5011
41669,868,999,1096,1172,1172,1165,865,7337
41701,17528,17265,17079,17468,17153,16488,17252,120233
41712,282,402,214,293,333,630,380,2534
41713,93,97,0,0,34,28,51,303
41714,260,269,300,243,231,308,418,2029
41719,911,946,912,832,721,568,1043,5933
41721,519,538,570,622,676,539,788,4252
41722,1447,1587,1841,1636,1426,1943,1688,11568
41723,1318,1270,1255,1601,1792,1750,1537,10523
41725,242,240,135,87,95,101,174,1074
41727,762,935,898,672,733,698,640,5338
41729,153,153,278,281,307,281,230,1683
41731,1005,1120,1255,1141,1057,1036,1023,7637
41735,177,230,160,130,177,150,295,1319
41739,59,57,108,115,115,125,179,758
41740,835,709,888,951,787,918,877,5965
41745,312,199,82,43,84,43,200,963
41746,560,686,779,800,850,833,835,5343
41749,3446,3278,3283,3298,3189,3331,3556,23381
41751,397,355,407,444,248,283,289,2423
41754,277,279,406,446,569,665,460,3102
41759,211,359,300,365,380,363,397,2375
41760,4,21,12,13,24,24,35,133
41762,110,185,169,219,148,83,107,1021
41763,626,681,672,645,533,421,574,4152
41764,848,704,717,771,665,625,741,5071
41766,177,137,184,161,262,486,131,1538
41772,145,240,251,307,331,407,277,1958
41773,1441,1364,1311,1564,1639,1607,1273,10199
41774,2302,2223,2313,2230,2577,2888,2659,17192
41775,63,67,92,62,80,44,114,522
41776,1368,1566,1493,1470,1699,1581,1509,10686
41777,1157,1066,1157,1092,972,1125,947,7516
41804,793,855,867,1059,1263,1162,720,6719
41810,544,518,485,509,537,339,502,3434
41812,258,303,305,337,267,261,230,1961
41815,915,886,479,471,300,409,802,4262
41817,399,226,219,332,365,359,251,2151
41819,173,280,221,231,298,296,392,1891
41821,927,813,868,809,619,629,537,5202
41822,2153,2017,2300,2322,2257,2404,2553,16006
41824,1024,994,1055,1047,1223,1151,1072,7566
41825,600,487,499,456,604,571,548,3765
41826,807,993,989,911,1053,1012,978,6743
41828,836,748,986,1041,1179,910,808,6508
41831,855,1001,1002,896,1118,1174,849,6895
41832,179,230,611,608,595,612,424,3259
41833,311,255,253,185,202,131,321,1658
41834,550,775,693,844,786,779,659,5086
41835,918,856,809,967,869,958,790,6167
41836,1119,1139,983,793,855,947,798,6634
41837,1196,689,473,478,548,703,1284,5371
41838,401,385,306,374,530,593,548,3137
41839,1494,1425,1312,1319,974,1198,1193,8915
41840,959,1317,1572,1556,1359,1195,1111,9069
41843,619,669,720,704,861,746,949,5268
41844,1594,1772,1809,1765,1770,1669,1355,11734
41845,167,136,105,83,130,234,293,1148
41847,506,462,305,449,394,462,617,3195
41848,0,17,23,18,29,45,80,212
41849,19,156,156,189,175,154,193,1042
41855,613,639,842,628,683,745,696,4846
41858,8134,8053,8057,7737,7627,7676,8064,55348
41859,373,336,369,355,397,422,349,2601
41861,46,45,125,198,285,221,108,1028
41862,885,1061,1017,849,828,796,952,6388
42001,27649,27593,28182,28249,28218,28601,27960,196452
42003,29223,28933,28598,29181,29221,29003,29683,203842
42020,2465,2493,2326,2299,2057,1909,2330,15879
42021,1670,1750,1754,1708,1334,1410,1505,11131
42022,144,95,45,50,52,19,104,509
42023,2377,2418,2449,2412,2611,2596,2422,17285
42024,1480,1496,1579,1577,1574,1518,1490,10714
42025,19663,19544,19173,19744,19990,19471,19305,136890
42027,2421,2506,2344,2063,2064,1949,2291,15638
42028,954,851,711,610,627,580,635,4968
42029,6217,6199,6563,6311,6094,6366,6321,44071
42031,3078,3167,3387,3251,3538,3510,3418,23349
42032,244,143,199,238,275,278,192,1569
42035,887,800,854,947,964,946,1068,6466
42036,1687,1422,1245,1014,1229,1168,1167,8932
42037,62,15,18,0,0,0,29,124
42038,5555,5610,5555,5303,4899,5080,5298,37300
42039,1730,1808,1809,1795,1690,1584,1751,12167
42040,958,1142,1344,1293,1124,907,1082,7850
42041,4645,4670,4597,4628,4757,4899,4627,32823
42044,2694,2552,2548,2868,2922,3259,3404,20247
42045,2098,2181,1771,1817,1975,2426,2089,14357
42047,258,209,280,138,104,77,192,1258
42048,2226,2386,2575,2436,2465,2312,2147,16547
42049,1759,1963,1966,1927,1845,1768,1480,12708
42050,2960,3013,3035,3102,2938,2899,3256,21203
42051,3115,2745,2743,2714,2640,2835,2840,19632
42053,4556,4904,4969,4803,4808,5542,4931,34513
42054,655,1120,1035,1108,1188,1019,984,7109
42055,2388,2387,2432,2643,2973,2982,2609,18414
42056,2328,2405,2472,2524,2356,2154,1982,16221
42058,2391,2245,2332,2191,2338,1923,2336,15756
42060,112,105,217,207,214,162,130,1147
42061,76,80,67,92,54,53,55,477
42064,8326,8363,8340,8301,8415,8540,8421,58706
42066,23913,23993,23235,23807,23792,23584,23182,165506
42069,597,793,787,848,1117,921,1100,6163
42071,30271,29740,29955,29425,29397,29810,29655,208253
42076,1163,991,1020,1039,899,790,1213,7115
42078,1631,1800,1831,1953,2036,2070,1852,13173
42079,1346,1305,1610,1494,1533,1733,1426,10447
42081,1960,2053,2427,2640,2327,2363,2203,15973
42082,1684,1951,1997,1655,1489,1575,1845,12196
42083,285,308,317,349,360,360,446,2425
42084,159,191,139,149,80,59,83,860
42085,777,760,820,760,835,841,918,5711
42086,4699,4588,4413,4054,3950,3559,4036,29299
42087,2146,2295,2264,2262,2455,2467,2419,16308
42088,2755,2711,2669,2563,2636,2600,2656,18590
42101,60297,58390,57296,56169,53975,53125,55648,394900
42102,56,37,33,37,33,0,88,284
42103,19952,20223,20251,20264,20109,19228,18936,138963
42104,31156,30484,30713,30185,30763,29998,29610,212909
42120,2913,2881,2812,2698,2786,2617,2588,19295
42122,4568,4425,4461,4360,4114,4117,4368,30413
42123,992,1019,1072,910,1095,1030,840,6958
42124,0,92,83,89,109,91,55,519
42127,6483,6473,6333,5939,6019,5838,6199,43284
42129,6768,6860,7048,6812,6655,6979,7026,48148
42130,292,92,123,125,125,91,175,1023
42133,1511,1445,1427,1291,1486,1542,1370,10072
42134,17091,16908,16723,16660,16422,16252,16785,116841
42140,1138,1064,1316,1280,1361,1337,1264,8760
42141,30874,30707,30517,31166,30653,30506,30349,214772
42151,321,324,309,172,197,126,275,1724
42153,434,423,285,169,160,196,326,1993
42154,621,736,715,677,814,638,691,4892
42156,196,143,174,199,152,152,254,1270
42157,447,288,198,245,332,314,437,2261
42159,998,1165,1145,1251,1354,1273,1195,8381
42160,1708,1536,1675,1845,1804,2189,1992,12749
42163,150,186,89,94,120,0,56,695
42164,16440,16434,16549,16772,16530,16678,16277,115680
42166,2922,3061,2988,2528,2600,2502,2314,18915
42167,7804,7992,7838,8241,8065,8108,8145,56193
42170,1482,1656,1525,1329,1203,1246,1403,9844
42171,7204,7515,6933,6683,6811,7561,6841,49548
42202,2062,2110,2197,2582,2520,2814,2389,16674
42204,485,454,642,533,635,750,657,4156
42206,5958,5609,5860,5668,5665,5616,5407,39783
42207,1307,1447,1504,1606,1399,1255,1207,9725
42210,3777,3973,3651,3897,3946,4062,4236,27542
42211,13062,13001,13098,13083,13314,13254,13422,92234
42214,557,492,443,490,796,594,682,4054
42215,1237,1489,1368,1351,1294,1515,1300,9554
42217,3423,3629,3774,3886,4117,4124,4117,27070
42220,7110,7186,7172,7061,7093,6877,6844,49343
42223,20733,20846,20840,20509,19864,18637,19837,141266
42232,736,596,509,504,618,664,812,4439
42234,2739,2752,2506,2673,2835,2602,2469,18576
42236,938,735,571,648,589,992,929,5402
42240,43268,43567,44276,43718,42928,42737,42479,302973
42254,242,280,289,198,252,240,209,1710
42256,4562,4547,4580,4546,4681,5218,5028,33162
42259,1209,1153,1113,1122,1098,1060,1281,8036
42261,10852,10800,11202,11047,10717,10262,10602,75482
42262,8707,8806,8322,8343,8243,8341,8396,59158
42265,825,1003,1296,1484,1431,1146,820,8005
42266,2217,2039,2129,2336,2425,2315,2590,16051
42273,543,518,452,357,413,386,443,3112
42274,2453,2628,2195,2287,2448,2278,2373,16662
42275,681,720,551,684,826,948,883,5293
42276,14443,14643,14069,13649,13581,13719,14471,98575
42280,302,301,343,487,497,501,484,2915
42285,483,308,390,388,533,452,375,2929
42286,1210,1170,1097,1039,928,909,1291,7644
42301,42728,43243,42270,42625,42749,42579,42440,298634
42303,40585,40029,39894,38735,38337,37947,38909,274436
42320,8616,8475,8539,8512,8341,8275,8205,58963
42321,268,178,488,245,218,381,327,2105
42322,12,71,0,0,0,47,47,177
42323,1007,932,915,865,904,909,793,6325
42324,960,1127,1384,1380,1316,1171,1276,8614
42325,2438,2628,2529,2495,2599,2296,2028,17013
42326,613,664,522,735,506,396,460,3896
42327,4027,3992,4249,4175,4182,4043,4037,28705
42328,1503,1452,1548,1521,1424,1380,1389,10217
42330,9254,9202,9412,9801,9300,9266,9386,65621
42332,91,83,167,175,194,232,271,1213
42333,1243,1286,1318,1110,1077,1028,1111,8173
42337,2048,2019,1755,1632,1840,2078,2026,13398
42338,71,102,100,115,87,41,88,604
42339,832,798,726,767,868,799,800,5590
42343,1643,1662,1826,1937,1817,1869,1782,12536
42344,1333,1324,1347,1157,1014,962,856,7993
42345,10684,10853,10782,10978,11505,11586,11747,78135
42347,6308,6130,5811,6056,5869,6107,6152,42433
42348,5371,5512,5502,5525,5110,4928,4810,36758
42349,1184,1098,1117,1198,1255,1358,1503,8713
42350,1362,1361,1476,1509,1395,1410,1433,9946
42351,3718,3580,3734,3676,3896,3982,3851,26437
42352,2218,2136,1954,1921,1878,1762,2060,13929
42354,275,304,319,244,315,344,252,2053
42355,2049,1911,1777,1828,1763,1788,1852,12968
42356,98,91,129,131,121,109,83,762
42361,512,626,525,442,652,607,492,3856
42366,5613,5413,5742,5847,5841,6184,5863,40503
42367,653,604,618,582,619,638,667,4381
42368,1229,1420,1168,1243,1513,1662,1325,9560
42369,242,275,331,344,326,417,331,2266
42370,0,0,0,0,33,37,28,98
42371,487,405,456,538,502,718,476,3582
42372,1603,1682,1647,1645,1803,1904,1854,12138
42374,366,268,220,150,158,384,277,1823
42376,6220,6276,6025,6069,6049,5609,5799,42047
42378,2958,2865,2997,3104,3216,2775,3339,21254
42404,2570,2736,2948,2874,3102,3004,2569,19803
42406,3402,3373,3531,3971,3747,3766,3555,25345
42408,6418,6186,6372,6416,6294,6383,6737,44806
42409,2807,2578,2494,2498,2534,2403,2586,17900
42410,1462,1555,1601,1488,1610,1668,1460,10844
42411,1448,1469,1443,1687,1706,1530,1656,10939
42413,3487,3584,3662,3559,3324,3104,3118,23838
42420,38618,38088,37800,37541,37632,37679,38192,265550
42431,26569,26721,26384,26453,26647,26818,26916,186508
42436,1000,987,1045,1011,1117,1148,1030,7338
42437,8866,8999,8760,8464,8394,7980,8324,59787
42440,952,934,874,725,748,655,748,5636
42441,1625,1624,1606,1681,1597,1569,1594,11296
42442,2873,3017,3288,3474,3397,3524,3504,23077
42445,11279,11310,11355,11064,11146,11239,11331,78724
42450,3994,3857,3785,3706,3694,3821,4063,26920
42451,736,885,1059,1082,1352,1106,783,7003
42452,2375,2599,2529,2308,2287,2228,2141,16467
42453,504,550,594,635,632,553,532,4000
42455,3131,3219,3354,3332,3291,3270,3376,22973
42456,1334,1413,1223,1438,1755,2043,1690,10896
42458,1128,1118,1250,1184,906,911,1151,7648
42459,4269,4344,4613,4855,4536,4699,4423,31739
42461,1057,1100,1244,1369,1390,1412,1481,9053
42462,1166,1048,1054,1004,1200,1453,1319,8244
42463,83,113,117,131,129,174,156,903
42464,1980,1834,1916,2150,1934,1764,1799,13377
42501,18003,18020,17740,17964,18408,18295,17592,126022
42503,23257,23408,23747,23981,23524,23364,22894,164175
42516,419,499,647,583,702,630,463,3943
42518,2541,2747,3116,3052,2844,2668,2914,19882
42519,3228,2841,2798,2747,2701,3125,3191,20631
42528,1536,1475,1607,1608,1878,2141,1524,11769
42533,823,903,914,904,978,894,802,6218
42539,10031,9894,9937,9833,9633,9461,10026,68815
42541,629,586,671,784,726,788,531,4715
42544,5633,5727,5535,5971,5826,5694,5843,40229
42553,4956,5050,4885,4591,4474,4562,5284,33802
42565,433,528,613,639,798,761,735,4507
42566,506,651,512,504,444,458,660,3735
42567,6491,6216,6092,5911,5876,5500,6007,42093
42602,10149,10187,10251,10215,10354,10218,10216,71590
42603,13,84,67,123,143,249,130,809
42629,5402,5273,5429,5471,5646,5373,4953,37547
42631,67,76,84,85,0,120,134,566
42633,19873,19842,20001,19865,19822,19891,20065,139359
42634,1473,1675,1580,1465,1599,1680,1565,11037
42635,4810,4871,4718,5078,4777,4786,5103,34143
42638,190,149,119,225,149,39,207,1078
42642,12230,12263,11923,11772,11757,12078,12573,84596
42647,3675,3732,3795,4468,4363,4293,4086,28412
42649,2915,3066,3165,2365,2279,2001,2326,18117
42653,4371,4210,4316,4210,4902,5230,4619,31858
42701,50533,50367,49670,48299,47658,46493,48194,341214
42712,1558,1314,1407,1572,1738,1678,1855,11122
42713,1821,1637,1382,1318,1411,1311,1641,10521
42715,328,317,302,359,268,233,347,2154
42716,1510,1601,1763,1890,1792,1732,1582,11870
42717,6747,6787,6779,6711,6726,6785,6558,47093
42718,25107,24399,24408,23950,23805,24028,24312,170009
42721,3522,3803,4108,4119,4187,4267,3982,27988
42722,472,601,686,634,660,688,714,4455
42724,4737,3992,4125,4591,4612,4809,4714,31580
42726,5125,5372,5243,4796,4742,4520,4667,34465
42728,16528,16327,16458,15973,15777,15494,15925,112482
42729,1661,1393,1723,1548,1524,1611,1617,11077
42731,64,53,82,153,172,141,341,1006
42732,1815,1890,2233,1964,1817,2140,2120,13979
42733,1167,1332,1300,1604,1674,1559,1454,10090
42740,1672,1622,1703,1833,1975,1890,1973,12668
42741,616,628,543,591,511,575,480,3944
42743,9393,9249,9204,9069,8734,8753,8869,63271
42746,1928,2098,2229,2284,2542,2259,1892,15232
42748,8777,8525,8316,8147,8326,8398,8706,59195
42749,5238,5139,5096,5148,4977,5302,5245,36145
42753,763,685,718,694,750,808,743,5161
42754,15830,15370,15332,15476,15390,15163,15349,107910
42757,2939,2537,2746,2850,3168,3393,2974,20607
42758,63,107,200,120,119,145,139,893
42762,356,472,465,531,415,425,422,3086
42764,512,504,297,462,598,595,559,3527
42765,5965,6061,6079,6032,5736,5607,5840,41320
42776,3328,3424,3373,2939,2387,2223,2736,20410
42782,945,1066,1128,1073,974,1008,953,7147
42784,2410,2428,2272,2913,2654,2833,2685,18195
42788,237,405,451,366,314,317,310,2400
43001,2930,2677,2475,2295,2227,2189,2400,17193
43002,2858,2859,2753,2184,1904,1507,2262,16327
43003,2875,2429,2366,2591,2681,2788,2917,18647
43004,25473,24464,24625,24350,24288,22943,22727,168870
43005,111,103,155,178,141,123,174,985
43006,611,558,705,566,678,707,822,4647
43008,2506,2445,2430,2456,2286,2327,2479,16929
43009,2161,2142,2036,2188,2351,2351,2135,15364
43010,390,371,386,363,343,288,272,2413
43011,8209,7806,7733,7447,7008,6749,7491,52443
43013,1004,1025,966,863,976,1007,1201,7042
43014,3531,3531,3610,3790,3848,3766,3632,25708
43015,52834,52145,50809,49491,48166,47907,48107,349459
43016,34750,34438,34409,34316,33056,31895,31306,234170
43017,40449,40242,39329,38568,38081,36621,37626,270916
43019,8963,9438,9722,9156,8908,9257,8700,64144
43021,12369,11553,10910,10615,10268,9607,10301,75623
43022,4429,4231,4089,4196,4174,4428,4161,29708
43023,13201,13181,12624,12710,12644,12617,13231,90208
43025,5366,5730,5870,5817,5839,5497,5306,39425
43026,60290,59179,58392,58097,56946,55874,54017,402795
43028,8023,7938,7857,7686,7771,7494,7537,54306
43029,710,526,631,509,605,553,664,4198
43030,0,105,241,180,147,177,114,964
43031,12675,12499,12390,12447,12114,11923,12318,86366
43032,137,143,127,118,137,37,77,776
43033,368,403,410,405,359,338,380,2663
43035,26421,26471,26130,25705,24722,23746,24721,177916
43036,252,280,268,313,311,306,258,1988
43037,312,408,370,377,422,497,535,2921
43040,33103,32649,32507,32066,31465,31484,31790,225064
43044,5111,5232,5228,5035,5236,4887,5528,36257
43045,1653,1685,1725,1790,1881,1703,1953,12390
43046,3870,3891,3697,3345,3442,3369,3396,25010
43050,28031,28313,28425,28612,28706,28401,29050,199538
43054,24191,23358,21948,20873,20738,20330,20566,152004
43055,61931,60866,60157,60396,59996,59879,59605,422830
43056,18173,17860,17828,16911,16898,17285,17439,122394
43060,2618,2545,2486,2456,2191,2325,2480,17101
43061,4265,4107,3951,3781,3992,3734,3967,27797
43062,28526,27717,27617,27354,26917,26834,27644,192609
43064,14009,13857,13425,12987,13130,13002,12580,92990
43065,40957,41266,40626,40008,39033,38148,38821,278859
43066,1369,1363,1399,1346,1390,1224,1328,9419
43067,1361,1154,1101,1139,1118,1103,1591,8567
43068,54128,54214,54214,52605,52177,52326,51836,371500
43070,160,135,119,109,58,148,133,862
43071,1954,2044,2335,2363,2316,2001,2351,15364
43072,5778,5688,5693,5922,5895,5837,5948,40761
43074,12386,11981,11908,12107,12336,12106,11655,84479
43076,8481,8694,8701,9316,8945,8871,9051,62059
43077,361,325,341,264,308,365,258,2222
43078,20375,20383,20729,20937,20931,21121,20885,145361
43080,5577,5612,5831,5947,6105,5814,5498,40384
43081,58780,57560,57036,56325,56157,55447,55991,397296
43082,31821,31425,31205,30353,29995,29361,29946,214106
43084,728,791,872,854,838,851,841,5775
43085,25254,24815,23818,23107,22822,23384,23258,166458
43101,289,364,399,385,345,298,380,2460
43102,4856,4813,4621,4606,4470,4407,4512,32285
43103,11440,11782,11530,11440,11217,10455,10697,78561
43105,8125,8470,8643,8518,8434,8388,8147,58725
43106,1633,1636,1742,1651,1588,1475,1685,11410
43107,3767,3396,3410,3400,3135,3190,3153,23451
43109,119,95,138,143,152,126,118,891
43110,37322,36208,35252,33926,33742,32565,33847,242862
43111,350,265,187,161,155,33,225,1376
43112,4529,4128,4099,4310,4341,4777,4617,30801
43113,24162,23540,23501,23401,23498,23516,23717,165335
43115,1451,1525,1575,1513,1614,1597,1321,10596
43116,1746,1517,1497,1263,1267,1176,1448,9914
43117,172,181,72,0,0,0,73,498
43119,28100,28115,28300,27892,28055,27960,27698,196120
43123,62094,61803,59860,58964,57901,57520,58424,416566
43125,13625,13163,12617,12088,12192,11590,12161,87436
43126,457,394,377,388,427,361,326,2730
43127,113,113,59,83,69,67,283,787
43128,2388,2219,2277,2306,2347,2293,2309,16139
43130,59900,59566,59923,59486,59904,59455,59570,417804
43135,4120,4531,4378,4242,4900,4733,4445,31349
43136,557,494,467,635,516,458,460,3587
43137,1892,1501,1497,1873,1891,2345,2388,13387
43138,18350,18534,18791,18797,18741,19036,18437,130686
43140,24390,24424,24095,24114,24185,24233,24066,169507
43142,140,178,174,177,119,105,111,1004
43143,5262,5498,5619,5473,5526,5738,5694,38810
43144,350,369,399,462,419,392,477,2868
43145,1858,1636,1650,1461,1634,1775,1918,11932
43146,12326,12303,12686,13080,13079,12895,12369,88738
43147,39576,39510,39171,39513,38861,37780,38440,272851
43148,2517,2382,2517,2245,2247,2323,2220,16451
43149,2735,2812,2972,3234,2720,2706,2552,19731
43150,2005,2341,2380,2700,2555,2780,2482,17243
43151,283,196,227,304,281,255,322,1868
43152,780,748,873,883,927,1071,921,6203
43153,769,922,918,969,1043,1086,971,6678
43154,3075,3357,3366,3230,3407,3164,3150,22749
43155,2544,2496,2106,2174,2219,2355,2543,16437
43156,193,221,258,235,252,218,242,1619
43157,473,539,512,606,618,577,610,3935
43158,227,260,280,312,338,275,268,1960
43160,22171,22431,22320,22281,22268,22571,22305,156347
43162,6945,6885,6897,6904,6855,6832,6926,48244
43164,2019,2157,2351,2477,2702,2712,2203,16621
43201,30195,30586,29384,29389,30186,32855,35495,218090
43202,21730,22313,21005,20340,19712,19619,20251,144970
43203,7602,7832,7830,7297,8170,8101,8108,54940
43204,40957,39897,39651,40262,41210,41180,42104,285261
43205,12605,13030,12396,12434,11535,12037,12272,86309
43206,21894,22087,22162,22723,22110,22846,21864,155686
43207,47592,47124,47943,46253,45831,44348,45144,324235
43209,28412,28790,27934,28232,27479,27449,27228,195524
43210,11789,10889,10818,10860,10341,10425,9432,74554
43211,21929,21322,22151,21997,21558,20957,21600,151514
43212,19436,19119,18478,18266,18535,18782,18551,131167
43213,32469,32570,31989,31510,30018,29402,30444,218402
43214,26300,26434,26403,26441,25801,24701,24650,180730
43215,13807,13197,12843,12410,12123,12074,12790,89244
43217,2501,2594,2579,2593,2524,2566,2602,17959
43219,29237,28305,28342,28137,27064,26800,27123,195008
43220,26995,26339,25896,25362,24513,23400,24989,177494
43221,32313,32368,32733,33315,32785,32797,31265,227576
43222,4020,3918,4208,4597,4285,4451,4617,30096
43223,25159,25565,24615,25786,26567,27458,27366,182516
43224,41462,39958,39170,36772,36303,35917,38699,268281
43227,23431,22959,23285,22350,21969,22770,21340,158104
43228,54999,55335,53346,52522,52632,51939,50737,371510
43229,50964,48597,47851,47084,46387,44477,46347,331707
43230,56634,55313,54247,52819,52442,51339,51161,373955
43231,20469,19624,19510,18998,18784,18201,19685,135271
43232,43448,43204,41714,42762,42655,41895,42201,297879
43235,42314,41814,41492,40709,39588,38667,38493,283077
43240,4054,3816,3744,3730,3178,3261,3469,25252
43302,53632,54485,54404,54800,54664,54950,54790,381725
43310,3117,3154,3331,3516,3298,3133,3104,22653
43311,19108,19124,19089,19361,19369,19265,19240,134556
43314,3279,3066,3228,3093,3150,2873,3173,21862
43315,6999,6622,7085,7166,7277,7521,7046,49716
43316,5963,6081,6021,5951,5854,5906,6041,41817
43317,149,157,154,188,183,163,168,1162
43318,4406,4949,5173,4294,4317,4474,3864,31477
43319,854,732,904,850,929,918,1040,6227
43320,1940,1879,1686,1572,1329,1443,1588,11437
43321,224,338,276,257,265,302,267,1929
43322,349,368,326,383,367,332,374,2499
43323,685,685,609,782,686,735,680,4862
43324,2861,2764,2376,2297,2482,2754,2817,18351
43326,13353,13255,13233,13399,13701,13950,13611,94502
43330,120,76,106,98,84,88,118,690
43331,4475,4450,4511,4479,4525,4575,4485,31500
43332,1680,1577,1705,1638,2049,2126,2323,13098
43333,593,675,576,897,929,914,894,5478
43334,6921,7000,6875,6457,6771,5908,6651,46583
43336,0,0,0,0,42,37,39,118
43337,1095,1048,1206,1363,1385,1322,1108,8527
43338,9864,10113,10173,10368,10694,10552,10489,72253
43340,2035,2005,1994,2164,1965,1870,1721,13754
43341,1339,1469,1346,1113,925,869,907,7968
43342,3128,3011,3240,3171,2969,3152,3228,21899
43343,1234,1331,1400,1551,1489,1666,1505,10176
43344,5632,5650,5420,5484,5719,5746,5677,39328
43345,792,659,726,863,880,964,920,5804
43347,1568,1534,1393,1484,1446,1367,1530,10322
43348,1644,1646,1603,1949,2082,1915,1984,12823
43351,10491,10698,10836,10691,10374,10140,10436,73666
43356,1274,1137,976,994,1358,1330,1103,8172
43357,4211,4436,4710,4577,4764,4854,4763,32315
43358,2737,2705,2936,3125,2997,2552,2521,19573
43359,825,720,804,719,797,874,819,5558
43360,1620,1684,1727,1469,1159,1325,1593,10577
43402,32761,32788,32798,32020,31372,30060,31327,223126
43403,5546,5449,5496,5842,5916,6253,5004,39506
43406,1756,1744,1809,1745,1868,1805,1777,12504
43407,690,753,686,881,784,833,639,5266
43408,337,307,291,290,302,271,269,2067
43410,10578,10455,10500,10410,10179,10266,10403,72791
43412,4656,4586,4495,4304,4302,4272,4362,30977
43413,1545,1645,1334,1408,1334,1318,1407,9991
43416,2910,2837,2850,3005,2819,2968,2891,20280
43420,30083,30452,30554,30461,30927,31141,30579,214197
43430,4743,4895,5066,4828,5054,4936,4783,34305
43431,4563,4515,4538,4517,4928,4834,4752,32647
43432,1263,1201,1463,1350,1043,1284,1366,8970
43433,34,20,20,96,96,77,95,438
43434,52,128,145,250,218,179,101,1073
43435,1579,1319,1381,1264,1378,1350,1532,9803
43437,535,472,477,473,478,439,427,3301
43438,158,138,171,177,203,260,312,1419
43439,45,50,22,90,106,90,113,516
43440,4849,4921,4960,4897,4942,4834,4875,34278
43442,1327,1378,1182,1153,863,920,999,7822
43443,1882,1860,1803,1801,1679,1778,1834,12637
43445,1120,1225,1110,1171,1127,948,1161,7862
43446,102,142,152,135,156,115,25,827
43447,3363,3428,3382,3466,3634,3538,3450,24261
43449,8590,8519,8324,8584,8800,8449,8278,59544
43450,3531,3583,3605,3827,3950,3896,3619,26011
43451,1045,952,873,1001,1049,1005,1119,7044
43452,13378,13490,13679,13659,13498,13832,13811,95347
43456,440,483,553,536,511,442,608,3573
43457,1326,1389,1374,1343,1242,1454,1456,9584
43458,520,485,395,312,441,469,414,3036
43460,6477,6431,6405,6334,6327,6358,6289,44621
43462,1271,1004,1029,1075,969,1097,1163,7608
43463,17,18,16,16,0,0,18,85
43464,1096,1096,1443,1464,1436,1461,1460,9456
43465,5296,5482,5332,5267,5162,5136,5059,36734
43466,2122,2264,2339,2381,2334,2305,2192,15937
43467,88,101,116,104,64,70,106,649
43468,398,407,354,403,419,397,451,2829
43469,3003,3062,2976,3043,2784,2858,3149,20875
43501,761,746,643,712,659,626,788,4935
43502,6804,6723,6762,6765,6834,6992,6933,47813
43504,1301,1281,1193,1345,1251,1162,1094,8627
43505,66,66,63,61,68,60,96,480
43506,14305,14777,14540,14604,14562,14843,14830,102461
43511,874,863,875,757,774,832,940,5915
43512,27770,27814,27986,28349,28837,29101,28674,198531
43515,9014,8608,8248,8213,8280,8122,7979,58464
43516,2980,2797,2965,2938,2870,2845,2951,20346
43517,4068,3859,3811,3755,3594,3593,3744,26424
43518,2610,2502,2571,2831,2836,3035,2726,19111
43519,301,256,216,89,48,69,184,1163
43521,2883,2760,2850,2786,2783,2894,2811,19767
43522,2973,2812,2780,3000,3082,3304,3344,21295
43523,0,0,0,0,0,0,62,62
43524,1155,1240,1123,1207,1260,1324,1236,8545
43525,1422,1272,1204,1179,1145,1152,1152,8526
43526,5676,5450,5528,5598,5736,5690,6072,39750
43527,1958,2117,2335,2219,2343,2310,2287,15569
43528,16132,16244,16474,16076,15418,15614,16430,112388
43529,325,296,280,250,211,204,256,1822
43531,153,76,82,134,136,104,216,901
43532,4177,3885,4202,4295,4124,4291,4015,28989
43533,1596,1528,1399,1475,1299,1192,1553,10042
43534,1704,1602,1665,1822,1718,1835,1784,12130
43535,932,938,820,712,883,751,757,5793
43536,518,543,648,607,370,237,394,3317
43537,27138,26651,26853,26812,26599,26965,27276,188294
43540,1408,1891,1690,1669,1603,1675,1501,11437
43541,196,208,140,152,120,117,144,1077
43542,3459,3891,3799,4020,4194,4052,3591,27006
43543,8042,8117,8426,8105,8029,7836,7771,56326
43545,14211,14499,14239,14320,14231,14315,14034,99849
43547,287,355,335,378,416,320,284,2375
43548,691,662,637,608,570,508,700,4376
43549,1396,1454,1459,1443,1734,1779,1460,10725
43551,37959,37596,37306,36884,36721,36551,37002,260019
43553,155,178,163,192,210,159,252,1309
43554,2792,2695,2632,2640,2599,2605,2408,18371
43555,197,204,233,106,140,137,200,1217
43556,1813,1994,2103,2075,1969,1890,1860,13704
43557,3310,3288,3289,3262,3295,3260,3393,23097
43558,12308,12446,13053,13077,13374,13713,13579,91550
43560,32483,32220,32342,32422,32589,32044,32226,226326
43565,434,469,419,368,364,349,348,2751
43566,8007,8150,7957,8038,7742,7223,7613,54730
43567,13003,12898,13056,13007,13275,13253,13283,91775
43569,2953,3067,3072,2904,2925,3056,2818,20795
43570,2813,3020,3118,3252,3352,3335,3106,21996
43571,7436,7377,7460,7037,6979,6944,6783,50016
43604,9009,9289,9040,9017,8638,9063,10154,64210
43605,27151,27699,27713,27546,28801,29152,28346,196408
43606,25346,24342,24083,24628,24642,24572,26429,174042
43607,22082,23123,23547,24717,24363,24708,23958,166498
43608,14951,15906,15421,15988,16037,16708,16515,111526
43609,22429,22364,22811,23343,23426,23750,23687,161810
43610,4298,4295,4599,4695,4510,4541,5105,32043
43611,18665,18544,19261,19176,19653,19753,19207,134259
43612,29905,30543,30812,31144,31067,30711,29674,213856
43613,32322,31677,32306,31616,32263,32790,31635,224609
43614,30930,30586,30070,29803,30042,29887,29290,210608
43615,39747,39952,39868,39363,39719,39506,39441,277596
43616,20635,20892,20914,21034,20947,21005,20873,146300
43617,6685,6827,6917,6882,7221,7920,7500,49952
43619,7506,7587,7764,7789,7661,7884,7499,53690
43620,5877,6007,5948,5907,6072,5929,5858,41598
43623,20252,20154,20287,20387,20263,19791,20149,141283
43701,55566,55101,55252,55568,55815,55973,55643,388918
43711,94,53,24,29,0,0,91,291
43713,7378,7272,7344,7193,7560,7457,7487,51691
43716,1994,1990,1661,1604,1662,1942,1973,12826
43717,149,117,168,227,234,237,164,1296
43718,3362,3364,3546,3727,3649,4034,3209,24891
43719,2478,2591,2644,2694,2598,2607,2601,18213
43720,1474,1258,1220,989,895,874,1300,8010
43721,0,42,41,34,43,112,149,421
43722,335,287,304,360,376,288,420,2370
43723,4966,4914,4794,4821,4787,5005,4984,34271
43724,9241,9680,9328,9312,9418,9368,9201,65548
43725,20131,20114,19908,20308,20362,20253,20357,141433
43727,1095,1175,1250,1330,1596,1350,1473,9269
43728,1279,1172,1335,1204,1008,1070,1250,8318
43730,2357,2468,2474,2575,2413,2780,2503,17570
43731,5515,5582,5640,5792,6031,5835,5461,39856
43732,1529,1742,1827,1876,1997,1997,1703,12671
43733,0,135,283,275,307,193,95,1288
43734,1681,1595,1374,1273,1180,1281,1171,9555
43735,494,497,436,286,345,373,499,2930
43736,68,79,79,61,72,63,55,477
43738,106,156,113,142,112,99,164,892
43739,2446,2260,2254,1898,2159,2166,2025,15208
43740,348,515,514,497,388,476,256,2994
43746,1299,1402,1501,1594,1561,1421,1425,10203
43747,916,1048,1206,1216,788,1064,1083,7321
43748,2711,2679,2845,2818,2957,2650,2755,19415
43749,2606,2691,2905,2398,2173,2219,2339,17331
43750,171,145,144,109,172,133,164,1038
43754,1783,1859,1766,1624,1556,1414,1542,11544
43755,1539,1284,1455,1399,1490,1728,1620,10515
43756,5284,5467,5426,5282,5223,5154,5320,37156
43758,3000,3001,3245,3517,3538,3594,3315,23210
43759,56,61,48,41,40,24,66,336
43760,2310,2266,1900,1427,1451,1311,1831,12496
43761,45,48,50,83,100,133,111,570
43762,5995,6307,6063,5851,5904,5963,5413,41496
43764,8545,8644,8581,8327,8309,8583,8566,59555
43766,1691,1811,1664,1618,1592,1598,1648,11622
43767,1233,1296,1302,1439,1470,1295,1443,9478
43768,351,353,308,290,261,248,275,2086
43771,1637,1762,1611,1807,1940,2210,2007,12974
43772,1874,1805,1681,1765,1754,1639,1879,12397
43773,3409,2997,3169,3155,3161,3043,3248,22182
43777,4630,4380,4620,4621,4371,4652,4714,31988
43778,1238,1411,1507,1702,1668,1716,1526,10768
43779,938,908,928,815,878,939,971,6377
43780,1740,1756,1979,1750,1707,1828,2106,12866
43782,713,865,762,738,639,657,849,5223
43783,4692,4626,4748,4977,5198,4679,4704,33624
43786,30,30,27,26,35,28,32,208
43787,2765,2867,2594,2487,2689,2740,2997,19139
43788,737,938,920,967,970,917,865,6314
43793,5052,4922,4892,4969,5055,4954,5110,34954
43802,1147,1049,1128,1072,1041,805,1075,7317
43804,4172,3470,3793,3750,4050,3628,3851,26714
43805,16,51,64,66,59,75,71,402
43811,816,798,811,708,799,864,829,5625
43812,18796,18848,19222,19637,19380,19531,19061,134475
43821,4027,4144,3917,4164,4438,4785,4327,29802
43822,4270,4759,5084,5048,5214,4868,4626,33869
43824,3697,3618,3379,3387,3365,3575,3787,24808
43830,6300,6568,6379,6374,6191,5795,6158,43765
43832,7623,7665,7703,7585,7756,7740,7479,53551
43836,124,124,138,142,136,131,128,923
43837,1802,1913,1794,1943,1737,1732,1973,12894
43840,1186,1288,1123,1098,1220,1331,1248,8494
43842,212,194,238,197,161,179,355,1536
43843,1645,1420,1438,1576,1043,995,1123,9240
43844,3499,3531,3617,3628,3827,4087,3869,26058
43845,4752,4878,4779,4828,4642,4516,4711,33106
43901,2091,2201,2346,2427,2484,2595,2219,16363
43902,20,52,175,204,207,226,202,1086
43903,2160,2275,2113,2116,2127,2009,2208,15008
43905,138,144,185,187,170,175,237,1236
43906,8631,8445,8493,8497,8553,8762,8678,60059
43907,5769,6020,5930,6107,5936,6192,6008,41962
43908,1634,1518,1647,1696,1707,1639,1574,11415
43910,3126,3035,3266,3411,3641,3389,3631,23499
43912,6582,6601,6974,6972,7074,6914,6801,47918
43913,1830,1690,1623,1542,1608,1557,1490,11340
43914,169,127,14,11,14,19,94,448
43915,1355,1348,1396,1477,1585,1697,1495,10353
43917,2994,3059,3137,3116,3071,3150,3136,21663
43920,22834,22974,23270,23340,23416,23634,23438,162906
43925,461,398,328,168,12,0,82,1449
43926,225,246,275,246,237,252,285,1766
43927,155,141,92,59,46,13,74,580
43928,0,117,158,117,104,127,116,739
43930,860,911,796,819,779,611,882,5658
43931,274,240,249,132,318,336,272,1821
43932,678,667,882,898,926,897,931,5879
43933,2020,2035,2141,2162,1943,2100,2070,14471
43934,482,366,305,237,170,142,295,1997
43935,8705,8868,8662,8733,8625,8777,8943,61313
43938,5231,5295,5480,5551,5557,5511,5794,38419
43939,627,637,594,558,512,495,513,3936
43940,201,339,408,451,492,433,377,2701
43942,2633,2475,2455,2486,2486,2422,2500,17457
43943,3011,3070,3025,3368,3339,3304,3472,22589
43944,2444,2556,2621,2578,2723,2677,2529,18128
43945,3159,3266,3208,3169,3120,3150,3191,22263
43946,1742,2145,2255,2369,2411,2531,2114,15567
43947,5199,5313,5177,5202,5257,5132,5322,36602
43948,628,663,615,539,517,583,670,4215
43950,16450,16509,16732,16670,17015,16587,16762,116725
43951,126,126,202,221,179,151,84,1089
43952,18693,18644,18745,18558,18556,19083,19050,131329
43953,11437,11735,11407,11823,11981,12024,11553,81960
43961,333,318,248,266,294,286,294,2039
43962,97,85,88,136,127,117,112,762
43963,1286,1314,1338,1314,1348,1449,1362,9411
43964,9206,9239,9414,9354,9536,9523,9575,65847
43967,0,0,0,0,0,0,21,21
43968,6548,6559,6747,7163,7326,7456,7182,48981
43970,69,66,43,0,0,0,31,209
43971,1195,1147,1186,1175,1220,1233,1150,8306
43972,175,216,232,172,92,65,144,1096
43973,2282,2393,2075,2323,2263,2336,1996,15668
43974,65,60,69,76,73,67,107,517
43976,1805,1904,1737,1707,1453,1408,1632,11646
43977,2406,2504,2186,2342,2406,2273,2407,16524
43983,513,443,418,469,275,278,440,2836
43985,138,129,121,177,183,159,128,1035
43986,2384,2156,2360,2245,2296,2264,1975,15680
43988,2199,2173,2205,2189,2532,2557,2476,16331
44001,20913,20900,20579,20358,20411,20207,20769,144137
44003,4707,4233,4761,4962,4949,4719,4676,33007
44004,32089,32671,32956,33250,33727,33985,33421,232099
44010,1446,1714,1760,1891,1996,2178,1667,12652
44011,22289,22046,21783,21440,20925,20223,21193,149899
44012,23221,23052,22881,22708,22515,22196,22581,159154
44017,19087,19098,19116,19266,19292,19160,19161,134180
44021,6031,6242,5994,6052,5959,6026,6444,42748
44022,16736,16811,16507,16655,16663,16803,16516,116691
44023,17503,17332,17289,17374,17298,17273,17351,121420
44024,23693,23668,23498,23430,23503,23601,23557,164950
44026,11076,11009,11207,11218,11055,11123,11116,77804
44028,8908,8840,8269,8380,8126,8312,8467,59302
44030,15991,16036,16518,16875,16785,16685,16652,115542
44032,2427,1764,1418,1628,1872,1450,1557,12116
44035,63663,63689,63607,63911,64105,64212,64263,447450
44039,31890,31322,30805,30216,29676,28986,29563,212458
44040,3000,2989,3075,3191,3013,2958,3020,21246
44041,14689,14607,14724,14766,14814,14860,14979,103439
44044,14797,14943,15722,15509,15790,15905,15951,108617
44045,348,387,373,375,408,479,422,2792
44046,2107,1787,2025,2339,2077,1928,2222,14485
44047,8954,8840,8787,9208,9319,9648,9213,63969
44048,2704,2737,3075,2843,2590,2669,2565,19183
44049,245,243,258,286,310,314,238,1894
44050,6647,6466,6181,6323,6205,6162,6118,44102
44052,29065,28652,28628,29946,30891,31461,29850,208493
44053,18037,18149,18352,17551,17788,18353,18256,126486
44054,12588,12645,12811,12707,12656,12704,12591,88702
44055,20423,20886,20841,20373,19498,18992,19846,140859
44056,11670,11538,11434,11326,11196,10951,11157,79272
44057,19484,19544,19732,19780,19902,19936,19961,138339
44060,60544,60970,60627,60780,60850,60816,60211,424798
44062,14954,15485,15630,15293,15353,15329,14972,107016
44064,1641,1705,1717,1676,1863,1801,1657,12060
44065,4633,4444,4671,4487,4487,4581,4433,31736
44067,20485,20592,20518,20457,20346,20192,20441,143031
44070,32193,32410,32668,32818,32830,32875,32902,228696
44072,4404,4632,4434,4227,4346,4309,4383,30735
44074,11594,11725,11978,11829,11882,11837,11679,82524
44076,4520,4886,4956,4599,4714,4764,5141,33580
44077,56051,55871,56347,56334,56017,55840,56491,392951
44080,53,66,115,129,272,264,226,1125
44081,7121,7006,6927,6779,6797,6745,7088,48463
44082,1799,1892,1271,1354,1365,1586,1619,10886
44084,3376,3890,3746,3623,3923,3886,3611,26055
44085,3504,3107,3208,3227,2832,2797,3277,21952
44086,2564,2510,2452,2277,2320,2352,2391,16866
44087,20344,20056,20047,20030,19864,20031,20221,140593
44089,15654,15622,15646,15938,15979,16133,15899,110871
44090,11369,11256,11254,11467,11405,11740,11504,79995
44092,16563,16621,16535,16754,16750,16712,16835,116770
44093,1317,1677,1537,1104,984,824,1467,8910
44094,35627,35336,35408,35334,35309,35310,35234,247558
44095,33349,33374,33509,33613,33691,33668,33579,234783
44099,2120,2367,2101,1836,2004,2301,2314,15043
44101,645,673,688,715,732,675,565,4693
44102,45863,45069,42793,44026,44496,44978,45014,312239
44103,16813,16456,17291,17990,18745,19540,18123,124958
44104,21351,22165,22479,23307,23181,23626,22640,158749
44105,37850,39130,38741,37857,38515,40401,40089,272583
44106,25557,25805,26837,26373,26768,27247,26896,185483
44107,51131,51391,51670,51899,52101,52401,52244,362837
44108,22441,23403,25122,25355,26387,26842,25679,175229
44109,41742,41032,41044,41372,41882,42871,40646,290589
44110,19548,19582,20185,21133,21012,20731,20136,142327
44111,40665,40095,40069,40321,40881,41071,39778,282880
44112,22283,22465,22193,22593,23193,24403,23073,160203
44113,19907,19825,19624,18933,18650,18004,19213,134156
44114,6447,6474,5714,5130,4378,4218,5225,37586
44115,7652,7857,7087,7502,7510,7612,8307,53527
44116,20265,20242,20199,20170,20206,20197,20268,141547
44117,9900,9797,10099,10367,10001,10317,10224,70705
44118,39792,39856,39721,39767,39548,39787,40438,278909
44119,11988,11611,12293,12435,12077,12494,12482,85380
44120,34115,34696,35768,36313,37763,40181,38196,257032
44121,32552,32915,33214,33252,33556,33603,33220,232312
44122,34044,34171,34893,34654,33662,33190,34057,238671
44123,16289,16697,16137,16675,17281,16298,17637,117014
44124,37584,37634,37742,37971,38113,38261,38282,265587
44125,28321,28455,28698,28633,28740,28346,28730,199923
44126,16419,16497,16571,16641,16694,16778,16771,116371
44127,5076,5003,5088,4581,4544,4613,5586,34491
44128,28619,29140,29269,29667,30139,30057,29274,206165
44129,28673,28611,28322,29260,29323,28785,29090,202064
44130,49717,49840,50401,50416,50585,50734,50639,352332
44131,20408,20377,20378,20361,20338,20310,20469,142641
44132,15019,15119,15299,14883,14798,15035,14071,104224
44133,30255,30251,30335,30335,30229,30203,30394,212002
44134,37840,38322,38493,37945,37983,38800,38800,268183
44135,27992,27932,27716,28131,28024,27494,26861,194150
44136,25927,25898,25803,25775,25689,25487,25608,180187
44137,22711,22887,22903,23080,23255,23443,23240,161519
44138,21984,22026,21958,21907,21909,21787,22332,153903
44139,24310,24221,24359,24154,24036,24154,24356,169590
44140,15414,15469,15508,15550,15589,15617,15651,108798
44141,13773,13858,13768,13875,13843,13871,13945,96933
44142,18875,18956,19027,19126,19199,19306,19201,133690
44143,24420,24376,24270,24044,24284,24448,24499,170341
44144,21555,21318,21795,21654,21906,21122,21089,150439
44145,32408,32469,32513,32552,32519,32447,32729,227637
44146,29331,29511,29551,29676,29734,29792,29761,207356
44147,19325,19359,19346,19331,19196,18838,19480,134875
44149,18713,18766,18860,18894,18879,18931,19177,132220
44201,6945,6893,6817,6456,6390,6591,6917,47009
44202,20021,20030,19631,19598,19506,19239,19561,137586
44203,40946,40753,40993,41346,41125,41001,41248,287412
44212,44202,44256,43997,43937,43699,43447,43548,307086
44214,2249,1941,1947,2083,2019,1912,2076,14227
44215,2302,2244,2284,2288,2367,2260,2162,15907
44216,9463,9889,10182,9665,9674,9135,9418,67426
44217,4162,4294,4185,4031,4041,4021,4142,28876
44221,29544,29840,29567,29875,29858,30176,29587,208447
44223,17853,17921,18099,18266,18428,18422,18185,127174
44224,38710,38727,38421,38443,38312,38033,38742,269388
44230,8628,8314,8277,8161,8193,8111,8252,57936
44231,8711,8598,8464,8625,8616,8845,8308,60167
44233,7825,7836,7779,7714,7662,7602,7646,54064
44234,4525,4414,4528,4234,3986,3832,4192,29711
44235,1964,2165,2094,2070,2132,1990,1825,14240
44236,25335,25557,25373,25277,25373,25171,25296,177382
44240,39460,39251,39284,41288,39412,38729,37927,275351
44241,16651,16454,16573,16214,16029,15911,16428,114260
44243,4425,4307,4205,4239,4139,4401,5658,31374
44250,1117,1186,1309,1163,1265,1299,1253,8592
44251,899,887,923,905,894,895,850,6253
44253,3201,3264,3387,3241,3215,3229,3218,22755
44254,4845,4884,4714,4809,4782,4978,4833,33845
44255,8366,8715,8678,8416,8373,7834,7987,58369
44256,62337,62446,62343,62303,62319,62042,62039,435829
44260,13512,13613,13375,13152,12955,12979,13450,93036
44262,5047,4995,4993,4981,4990,5071,5016,35093
44264,3019,2736,2950,2571,2522,2647,2315,18760
44265,0,0,0,0,0,0,51,51
44266,33346,33506,33696,33702,33715,33741,33581,235287
44270,8633,8878,8759,8784,9134,9273,8890,62351
44272,5062,5135,5000,5115,5048,5192,5208,35760
44273,7195,7033,6914,6704,6471,6401,6718,47436
44274,351,177,213,143,109,129,225,1347
44275,3326,3157,3255,3264,3109,3203,3521,22835
44276,1937,1849,1869,1879,1735,1717,1906,12892
44278,17864,17781,17774,17844,17795,17649,17868,124575
44280,4470,4508,4437,4476,4453,4401,4557,31302
44281,31148,30580,30393,30231,29997,29882,29954,212185
44285,128,73,88,68,105,17,85,564
44286,6140,6120,6120,5942,5950,5862,6109,42243
44287,7461,7984,7964,7806,7648,7512,7559,53934
44288,3628,3567,3525,3829,4043,4467,4118,27177
44301,15983,15341,15719,15700,15748,15940,15340,109771
44302,5487,5998,6116,6119,6113,5814,5524,41171
44303,7770,7598,7613,7635,7354,7463,7700,53133
44304,5654,5634,5591,5611,5656,5219,5916,39281
44305,23041,22871,21726,21899,21947,21735,22294,155513
44306,21581,22198,22554,22348,22622,22998,22492,156793
44307,6987,6745,6328,5830,6606,7087,7643,47226
44308,963,920,666,735,684,658,1392,6018
44310,24922,23634,23402,23362,23289,23013,22786,164408
44311,9061,9475,9458,9107,8985,9121,8782,63989
44312,31539,31610,31769,31874,32364,32283,31919,223358
44313,23580,23352,23953,24611,24454,25078,24935,169963
44314,18675,19053,19042,18950,18805,18832,18825,132182
44319,22486,22592,22458,22616,22564,23019,22686,158421
44320,19049,19653,20666,21228,20675,21657,19937,142865
44321,15180,15676,15211,14933,15077,14829,15200,106106
44333,18740,18679,18516,18541,18825,18633,18763,130697
44401,2770,2815,2760,2818,2939,2870,2892,19864
44402,3080,3042,3054,2924,3166,3259,3352,21877
44403,3970,3923,4044,4003,3938,3997,3820,27695
44404,1751,1665,1763,1708,1448,1325,1624,11284
44405,8045,8045,8097,8138,8218,8326,8229,57098
44406,21416,21793,21852,21622,21769,21552,22054,152058
44408,10465,10624,10588,10422,10261,10324,10331,73015
44410,16501,16698,16825,17331,17585,17167,17409,119516
44411,2282,2211,2095,2082,2221,2253,2181,15325
44412,2846,2756,2659,2620,2733,2682,2644,18940
44413,7580,7738,7563,7588,7401,7279,7261,52410
44417,1829,1646,1590,1596,1546,1401,1659,11267
44418,1502,1595,1715,1464,1517,1593,1357,10743
44420,15252,14996,15364,15368,15423,15608,15429,107440
44423,2418,2378,2881,2893,2837,2913,2425,18745
44425,14836,14739,14564,14675,14680,14896,14898,103288
44427,1798,1802,1438,1510,1572,1452,1612,11184
44428,3071,3142,2896,2873,2838,3014,3290,21124
44429,2449,2621,2493,2551,2519,2680,2576,17889
44430,4737,4924,5448,5520,5734,5695,5270,37328
44431,4306,4657,4647,4597,4695,4908,4727,32537
44432,13402,13456,13499,13213,13169,13124,13693,93556
44436,3566,3610,3725,3692,3835,3827,3836,26091
44437,4221,4332,4140,4127,4330,4219,4252,29621
44438,4105,4225,4478,4443,4792,4830,4751,31624
44439,141,61,49,61,62,126,115,615
44440,5083,4926,5107,4915,4692,4825,4967,34515
44441,1541,1673,1517,1630,1720,1596,1600,11277
44442,3847,3909,3790,4132,3993,3885,4006,27562
44443,1924,2030,2043,1945,2085,1938,1704,13669
44444,9857,9908,10062,10489,10673,10862,10454,72305
44445,3402,3023,3211,3175,3360,3190,3449,22810
44446,20313,20422,20561,20310,20692,20812,20955,144065
44449,927,1040,1109,1292,1302,1190,1323,8183
44450,2021,2099,2305,2733,2631,2623,2042,16454
44451,3047,2904,3068,3146,2925,2802,3032,20924
44452,3610,3118,3022,2861,2813,2937,3167,21528
44454,941,871,859,900,817,1078,1153,6619
44455,1584,1537,1623,1836,1902,2123,1890,12495
44460,25915,26115,26417,26710,26796,26565,26732,185250
44470,3801,3830,3990,3859,3779,3975,3790,27024
44471,10776,10916,10940,11024,11099,11155,11097,77007
44473,3652,3745,3722,3769,3817,3790,3823,26318
44481,10699,10903,10728,10819,10094,10640,10408,74291
44483,25470,25750,25646,26047,26921,26858,26006,182698
44484,22151,22238,23113,23136,22557,22881,22991,159067
44485,16191,16257,15748,15777,15967,16167,16498,112605
44490,878,864,870,814,858,920,798,6002
44491,3539,3427,3023,3248,3203,3035,3515,22990
44493,31,47,39,43,34,32,25,251
44502,9732,10184,10260,10219,10228,9663,10204,70490
44503,1035,959,970,914,929,972,1021,6800
44504,4997,4771,5099,5303,6018,5703,5262,37153
44505,18633,19903,19828,20138,20130,20647,19357,138636
44506,2485,2242,2145,1965,2266,3062,2707,16872
44507,5046,5313,5374,5536,5360,5990,5863,38482
44509,11686,11883,12348,12532,12079,12520,11975,85023
44510,2966,2665,2454,2543,2447,2273,2499,17847
44511,19241,18646,19040,19935,20282,20848,19672,137664
44512,33514,34133,34286,34019,33741,33880,34424,237997
44514,22035,22148,22034,22095,22484,22427,22472,155695
44515,27161,27267,27181,27381,27712,27529,27766,191997
44601,35146,35068,34796,34527,34622,34717,35294,244170
44606,7526,7656,7433,7571,7423,7429,7819,52857
44607,176,199,221,114,204,186,234,1334
44608,2638,2595,2833,2638,2834,2982,2666,19186
44609,4127,4309,4352,4127,4022,4121,3987,29045
44610,187,231,251,298,486,480,263,2196
44611,2041,1603,1657,1886,2177,2094,2025,13483
44612,5471,5600,5541,5379,5295,5252,5293,37831
44613,2145,2093,2298,2247,2186,2025,2011,15005
44614,12751,12825,12597,12454,12497,12788,12595,88507
44615,10759,11042,11270,11144,11324,11715,11125,78379
44618,6738,6860,6770,6771,6986,6767,6858,47750
44620,1530,1382,1479,1717,1762,1738,1567,11175
44621,4506,4555,4498,4652,4613,4915,4624,32363
44622,18180,18192,18398,18427,18352,18525,18588,128662
44624,5768,6041,5554,6179,5564,5092,5397,39595
44625,1888,1739,1689,1278,1301,1296,1418,10609
44626,3095,3287,3103,2957,3035,3157,2977,21611
44627,7787,7738,7614,7799,7430,7190,6845,52403
44628,1037,1072,1065,1026,931,978,1067,7176
44629,2459,2542,2749,2707,2755,2978,2403,18593
44632,9067,9619,9884,10012,10166,10253,9765,68766
44633,2627,3015,2778,2816,2690,2549,2615,19090
44634,2209,2177,2115,2127,2192,2239,2164,15223
44637,3325,3229,2905,2674,2400,2182,2694,19409
44638,1422,1570,1528,1581,1489,1327,1497,10414
44640,144,139,300,269,312,365,151,1680
44641,20409,20319,20204,20377,20320,20095,20349,142073
44643,3320,3082,3269,3305,2907,2701,3239,21823
44644,4647,4609,4733,4683,4682,4638,4791,32783
44645,2202,2292,2471,2502,2395,2653,2465,16980
44646,46098,45594,45615,46219,46305,46640,47525,323996
44647,18852,18573,18483,18850,18815,18274,18015,129862
44651,538,635,655,707,830,787,861,5013
44652,36,31,27,0,56,90,80,320
44653,672,658,799,752,635,498,599,4613
44654,20551,19772,20135,19256,19339,19198,19679,137930
44656,2947,3087,3090,3009,2958,2892,2968,20951
44657,9973,10515,10469,10943,10762,10757,10334,73753
44659,133,146,161,168,172,185,163,1128
44661,224,223,217,260,261,203,171,1559
44662,9310,9466,9217,9461,9311,9645,9656,66066
44663,25216,25172,25075,25049,25241,25400,25362,176515
44666,3206,2912,3093,3264,2901,2600,2928,20904
44667,13750,13931,14141,14249,14082,14257,13481,97891
44669,1272,1161,1269,1240,1315,1208,1382,8847
44670,381,380,357,315,217,308,235,2193
44671,298,277,207,274,276,287,380,1999
44672,4730,4793,4707,4769,4776,5061,4874,33710
44675,2117,2316,2107,2179,2180,2187,2082,15168
44676,4653,4864,4820,4807,4728,5259,4877,34008
44677,2531,2496,2480,2523,2438,2412,2543,17423
44678,105,99,23,28,63,72,152,542
44680,4275,4419,4211,4285,4285,4280,4138,29893
44681,7435,7797,7689,7697,7830,7847,7799,54094
44682,928,938,892,935,820,766,803,6082
44683,8329,8362,8490,8292,8305,8323,8550,58651
44685,27926,26800,26971,28116,28157,28573,27556,194099
44687,260,253,155,161,161,244,249,1483
44688,3004,3091,2988,3067,3206,3237,3053,21646
44689,685,529,607,525,788,819,638,4591
44690,199,131,229,181,166,129,166,1201
44691,44630,43937,43476,42807,43057,42695,43753,304355
44693,41,57,52,52,74,112,86,474
44695,1579,1562,1733,1640,1684,1631,1608,11437
44697,237,213,189,181,177,153,187,1337
44699,700,676,696,607,899,1013,937,5528
44702,964,932,931,1014,1081,1021,1053,6996
44703,7899,8551,8741,8862,8942,9521,8895,61411
44704,3352,3469,3695,3826,4052,4488,3811,26693
44705,19646,19839,19288,18581,18709,18664,18772,133499
44706,17767,17837,18081,18558,18672,18716,18246,127877
44707,9071,8898,8804,8794,8883,9158,9208,62816
44708,25562,25176,24982,25341,25628,25134,25109,176932
44709,19386,19124,19096,19019,18682,19056,18905,133268
44710,9884,10004,10388,9640,9844,9386,9179,68325
44714,8570,8618,8886,9249,9498,8752,9056,62629
44718,11683,12498,12115,11642,11640,11664,11951,83193
44720,38825,39301,39832,39118,39054,38993,39010,274133
44721,14146,13844,13556,13381,13016,13031,13560,94534
44730,6170,6175,6231,6339,6152,6140,6050,43257
44802,841,828,886,953,941,925,1032,6406
44804,1048,1115,1106,1097,1086,1314,1202,7968
44805,32815,32562,32347,32524,32530,32328,32345,227451
44807,2306,2378,2168,2461,2455,2385,2381,16534
44809,319,320,254,171,182,226,293,1765
44811,12542,12648,12732,12944,13071,13345,12867,90149
44813,8648,7969,7633,7478,7622,7958,8051,55359
44814,2745,2734,2855,2800,2703,2606,2929,19372
44815,594,558,608,568,591,596,637,4152
44816,37,36,57,55,39,29,42,295
44817,1564,1534,1731,1587,1778,1687,1562,11443
44818,2510,2580,2289,2490,2394,2520,2644,17427
44820,17442,17597,17829,17763,18081,18465,18102,125279
44822,2770,2860,3009,3053,3153,3598,3240,21683
44824,3687,3715,3625,3673,3759,4135,4060,26654
44825,47,44,27,58,23,35,58,292
44826,1583,1509,1719,1578,1819,1575,1687,11470
44827,6496,6751,6917,7053,7279,7340,7097,48933
44828,78,29,27,23,22,29,166,374
44830,18978,18905,18525,18665,18585,18544,18962,131164
44833,17411,17217,16997,16997,16670,16754,17121,119167
44836,2735,2574,2476,2752,2588,2622,2654,18401
44837,4698,4614,4402,4522,4281,4272,4514,31303
44838,233,229,211,165,197,225,266,1526
44839,12339,12572,12646,12586,12789,12705,12519,88156
44840,2808,3069,3366,3721,3481,3733,2900,23078
44841,636,673,614,724,726,679,710,4762
44842,5214,5417,5308,5513,5459,5950,5436,38297
44843,2195,2326,2371,2487,2502,2449,2387,16717
44844,586,566,680,450,629,594,764,4269
44846,3349,3114,3015,3148,3166,3303,3301,22396
44847,3814,4071,3771,3655,3769,3676,3739,26495
44849,2367,2385,2204,2386,2462,2622,2260,16686
44850,27,14,6,35,51,47,148,328
44851,4700,4945,4985,5169,5345,5577,5308,36029
44853,1318,1278,1256,1308,1365,1400,1397,9322
44854,1573,1663,1646,1712,1808,1759,1749,11910
44855,1137,1300,1365,1351,1299,1230,1271,8953
44856,184,174,119,79,73,97,128,854
44857,23291,23522,23486,23499,23583,23627,23805,164813
44859,1515,1367,1454,1161,1266,1525,1737,10025
44861,89,80,49,47,62,40,64,431
44864,4067,3510,3517,3195,3498,3172,3204,24163
44865,3626,3761,3750,3519,3546,3510,3434,25146
44866,2140,2139,2337,2426,2279,2467,2259,16047
44867,2121,2119,2574,2294,2513,2543,2351,16515
44870,40647,40825,41125,41126,41212,40872,41030,286837
44874,327,325,397,373,413,340,394,2569
44875,13384,13348,13668,13700,13911,13883,13818,95712
44878,3375,3222,2873,3074,3075,2961,3147,21727
44880,2975,3096,3123,3118,3097,3064,2864,21337
44881,11,9,11,28,62,87,70,278
44882,3029,2700,2717,2916,2850,2827,2909,19948
44883,28387,28782,29271,29438,29681,29654,29413,204626
44887,1036,1179,1239,1192,1071,999,1020,7736
44889,7026,6622,6630,6699,7115,6984,6703,47779
44890,11282,11267,11384,11348,11255,11457,11162,79155
44901,2606,2557,2546,2552,2566,2534,2501,17862
44902,4433,4273,5132,5392,5550,5654,5432,35866
44903,24768,24455,24934,24720,25156,26313,25602,175948
44904,13366,13971,13881,14135,14437,14326,13906,98022
44905,13830,14106,13984,14188,13899,13943,14513,98463
44906,17088,17309,17179,17031,16962,16596,16718,118883
44907,14494,14626,14359,14572,14626,14898,14313,101888
45001,613,579,564,570,538,552,606,4022
45002,13707,13777,13557,13227,13213,13252,13388,94121
45003,626,636,598,645,682,664,697,4548
45005,30704,30403,30432,29997,30092,30195,29963,211786
45011,69558,69888,68750,68475,68127,67301,69677,481776
45013,53059,52777,53539,53697,54097,54588,52613,374370
45014,44029,44266,44297,44172,44152,44260,43917,309093
45015,12665,12333,12064,11893,11316,11036,12038,83345
45030,18392,18023,17939,17854,17662,17473,17921,125264
45032,320,322,361,291,328,355,348,2325
45033,319,454,385,389,341,236,276,2400
45034,1252,1176,977,1051,1204,1280,1184,8124
45036,39283,39324,38853,38476,37983,37639,37504,269062
45039,22847,22859,23404,23034,22500,22416,22814,159874
45040,53879,52551,52052,51469,50859,50265,50627,361702
45041,101,109,103,0,0,64,199,576
45042,26290,26247,26643,26623,26484,27202,26451,185940
45044,53037,53363,52769,52064,52627,52112,52822,368794
45050,9085,8907,9222,9080,8282,7974,8548,61098
45051,204,208,177,179,165,151,177,1261
45052,3921,4036,4310,4720,4671,4493,4004,30155
45053,3642,3557,3123,3075,3229,3194,3420,23240
45054,2774,2538,2256,2209,2377,2338,2471,16963
45056,27244,27314,27400,27537,27484,27568,27038,191585
45062,681,719,677,658,592,638,688,4653
45064,2896,2930,3016,2827,2873,2735,2857,20134
45065,4937,5141,5366,5065,5074,4675,4442,34700
45066,24597,23998,24150,24517,24150,23846,23839,169097
45067,14796,14587,14124,13886,13863,13456,13898,98610
45068,10982,10987,10659,10760,10300,10142,10479,74309
45069,50167,50354,50095,49559,49401,49036,49060,347672
45070,231,232,192,230,204,213,192,1494
45101,2270,2303,2381,2504,2556,2530,2385,16929
45102,22695,23000,22585,22586,22520,22130,22680,158196
45103,33175,33083,33225,31906,31766,31924,31485,226564
45106,12633,12884,12631,12486,12496,12399,12349,87878
45107,9467,9137,9033,8768,8858,9203,9236,63702
45111,255,252,309,423,378,375,376,2368
45112,46,44,43,52,63,66,64,378
45113,3444,3479,3508,3581,3295,3278,3857,24442
45115,80,76,122,60,53,44,78,513
45118,3748,3631,3604,3769,3848,3588,3614,25802
45120,3039,2845,2975,2964,3370,3643,3672,22508
45121,9430,9373,9468,9280,9193,9166,9036,64946
45122,10729,10842,10940,11388,11644,11722,11054,78319
45123,8713,8648,8560,8680,8419,8384,8671,60075
45130,3357,3476,3679,3904,3697,3812,3913,25838
45131,256,247,281,273,261,186,238,1742
45132,286,289,255,222,242,262,262,1818
45133,23898,23840,23239,22816,22966,23428,23900,164087
45135,4704,4752,4726,4811,5136,4984,4761,33874
45140,54915,54488,53720,52417,52009,51769,53267,372585
45142,3893,4156,4304,4530,4573,4678,4444,30578
45144,4778,4761,4880,4736,4423,4217,4272,32067
45145,22,0,0,0,0,0,40,62
45146,1448,1400,1511,1800,1732,1970,1580,11441
45147,50,48,170,240,237,225,147,1117
45148,1462,1539,1523,1448,1553,1360,1588,10473
45150,32475,32156,31825,31776,31916,31694,31394,223236
45152,12164,12072,11189,11644,11474,10882,11329,80754
45153,1937,2018,1898,1706,1822,1762,1665,12808
45154,9387,8886,9214,9573,9408,9088,9172,64728
45155,305,306,307,251,337,372,366,2244
45156,71,58,92,119,108,103,98,649
45157,9862,9714,9831,9723,9758,10120,9758,68766
45158,439,375,388,436,391,307,370,2706
45159,3596,3418,3386,3598,3531,3270,3392,24191
45160,804,774,840,743,742,621,699,5223
45162,2538,2441,2454,2496,2344,2468,2519,17260
45164,309,286,290,331,324,275,271,2086
45166,60,155,170,186,222,160,98,1051
45167,3618,3684,3572,3467,3453,3647,3764,25205
45168,1521,1477,1541,1642,1634,1871,1607,11293
45169,4686,4821,4958,4886,4652,4654,4772,33429
45171,6278,6272,6362,6401,6415,5660,6054,43442
45172,118,107,154,133,120,167,131,930
45174,2363,2336,2258,2271,2294,2333,2258,16113
45176,9066,9215,9011,8947,8757,8954,9100,63050
45177,22291,22318,21950,21955,22190,22417,22260,155381
45202,13761,13623,13259,12537,12044,12014,15483,92721
45203,2340,2287,2239,2121,2156,2435,2236,15814
45204,6065,6660,7167,6996,6989,6921,6972,47770
45205,18709,19312,19439,20678,20954,21398,19389,139879
45206,11075,11331,10428,10648,10157,10235,10745,74619
45207,7371,7446,7515,8137,8139,7740,7974,54322
45208,18517,18557,18844,18659,18480,18681,17614,129352
45209,10151,9744,9458,9529,9810,9745,9605,68042
45211,38131,37692,37317,36846,36096,35604,36111,257797
45212,22111,22159,21993,22032,22072,22151,22253,154771
45213,12111,12598,12352,12294,12147,12080,12013,85595
45214,8557,8014,7875,8341,8482,9181,8738,59188
45215,30847,30492,30578,30003,30014,29708,29623,211265
45216,9459,9950,9649,9628,9216,9228,9570,66700
45217,7010,6789,6675,6944,7286,7037,6566,48307
45218,3730,3792,3818,3838,3814,3861,3846,26699
45219,18253,17986,18214,17673,16648,15555,16526,120855
45220,13961,14443,14934,14792,14268,14327,15313,102038
45223,12522,12634,12226,12147,12096,12916,12360,86901
45224,19878,20295,20049,19907,20129,20460,19837,140555
45225,8692,8524,8783,8807,8964,9206,9040,62016
45226,5249,4918,5224,5651,5472,5530,5476,37520
45227,18235,18024,17999,18267,18714,18441,17486,127166
45229,12638,12267,12744,12076,12698,13029,13020,88472
45230,26908,26617,26622,27142,27810,27959,27536,190594
45231,39765,39860,40703,40728,40393,41310,40893,283652
45232,6714,6274,6342,6944,6672,6630,6358,45934
45233,16151,15624,15581,15674,15809,16040,15808,110687
45236,24350,24106,24246,23962,24159,25060,24552,170435
45237,20013,19923,20090,19833,19762,19263,20021,138905
45238,45361,46532,46053,45376,45802,46624,45760,321508
45239,28273,27212,27579,28010,28727,27923,28315,196039
45240,27457,27757,27438,26829,27450,27590,27286,191807
45241,23707,22768,22853,23515,23359,22899,23044,162145
45242,22616,22284,22157,21971,21945,21071,22055,154099
45243,14995,15040,14634,14384,14353,14440,14891,102737
45244,28996,28709,29177,28583,28580,28404,28565,201014
45245,19690,19812,18903,19487,18601,17919,18542,132954
45246,14896,14567,14903,15146,15067,14773,15133,104485
45247,22222,22189,22331,22620,21605,22001,22082,155050
45248,24779,24362,25230,25562,25954,25617,24915,176419
45249,13144,13220,13372,13421,13195,13328,12902,92582
45251,22767,23157,21951,21500,21485,20722,22391,153973
45252,4649,4818,4820,4681,4905,4883,4600,33356
45255,21175,21253,21419,21803,21761,21823,21775,151009
45301,65,112,132,96,110,106,130,751
45302,4004,4116,4216,4271,4188,4194,4280,29269
45303,2496,2208,2085,1962,1937,1877,2223,14788
45304,7370,7442,7607,7673,7591,7447,7300,52430
45305,11205,11065,11144,11154,11089,11388,10712,77757
45306,2462,2460,2502,2491,2389,2349,2294,16947
45307,322,303,316,311,282,338,338,2210
45308,4088,4083,4164,4397,4550,4499,4682,30463
45309,12470,12418,12599,12505,12302,12035,12123,86452
45310,267,237,216,197,213,193,244,1567
45311,5984,6088,6305,6648,6737,6813,6367,44942
45312,1411,1501,1546,1410,1364,1414,1435,10081
45314,6063,6064,5968,5882,5977,5918,5916,41788
45315,4515,4475,4249,3854,3969,3785,4377,29224
45316,75,121,127,179,199,228,115,1044
45317,1112,992,860,913,1140,1127,1180,7324
45318,5741,5613,5730,5362,5208,5105,5365,38124
45319,429,426,391,345,326,275,293,2485
45320,15372,15319,15219,15384,15272,15319,15691,107576
45321,818,940,1056,975,946,1040,931,6706
45322,21298,21166,21563,22118,21830,21612,21447,151034
45323,5274,5306,5439,5261,5195,5119,5019,36613
45324,40779,40500,40104,40356,40063,40028,40529,282359
45325,2465,2330,2418,2389,2308,2130,2647,16687
45326,1139,1041,944,1016,1103,1097,1179,7519
45327,9520,9328,9289,9165,9143,8901,8917,64263
45328,613,598,591,692,660,569,525,4248
45330,917,895,810,742,746,879,834,5823
45331,22109,22155,22289,22344,22703,22947,22930,157477
45332,761,683,664,726,656,506,612,4608
45333,1324,1204,1196,1174,1176,1121,1345,8540
45334,2150,2264,2286,2231,2197,2220,2037,15385
45335,6714,6682,6589,6772,6921,7011,6939,47628
45336,155,178,184,168,175,197,153,1210
45337,1638,1713,1569,1503,1494,1688,1690,11295
45338,4985,4972,4870,5056,5201,5233,5298,35615
45339,1378,1370,1490,1347,1291,1382,1234,9492
45340,732,476,533,708,800,836,830,4915
45341,3748,3727,3507,3542,3501,3669,3883,25577
45342,36479,36652,36569,36006,36328,36310,36784,255128
45344,16737,16793,16925,17238,17123,16961,16955,118732
45345,6058,6419,5868,6120,6412,6631,6144,43652
45346,2179,2257,2286,2249,2114,1997,2293,15375
45347,4705,4726,4704,4619,4523,4577,4324,32178
45348,1026,899,836,663,763,825,994,6006
45349,370,348,477,478,482,433,427,3015
45350,122,124,131,131,114,110,106,838
45351,261,273,219,236,220,222,274,1705
45352,229,205,181,183,168,214,208,1388
45353,199,214,208,216,130,126,196,1289
45354,470,518,574,584,542,650,642,3980
45356,25279,25316,25504,25504,25486,25545,25172,177806
45358,384,373,438,423,407,374,356,2755
45359,1910,1802,1883,1904,1947,2020,1970,13436
45360,416,403,513,488,473,484,335,3112
45361,310,326,275,276,301,320,288,2096
45362,1343,1399,1384,1203,1145,1080,1076,8630
45363,1717,1867,1824,1768,1665,1711,1770,12322
45365,30366,30341,30150,30409,30761,30677,30561,213265
45368,4976,4605,4674,4725,4620,4825,4727,33152
45369,3531,3674,3472,3735,3677,3634,3545,25268
45370,2388,2512,2316,2480,2252,2279,2452,16679
45371,19360,19525,18755,18802,18848,18117,18333,131740
45372,368,440,468,526,438,401,375,3016
45373,35436,35274,35343,35078,34910,35303,35131,246475
45377,15382,15099,15010,15008,14896,14989,15215,105599
45378,352,335,382,407,376,407,407,2666
45380,5016,5208,5233,5497,5570,5749,5477,37750
45381,5401,5454,5503,5356,5520,5688,5509,38431
45382,1283,1347,1400,1468,1429,1392,1269,9588
45383,7392,7462,7279,7214,7182,6830,7037,50396
45384,1866,1847,1525,1439,1340,1242,2001,11260
45385,38229,38196,38728,38313,38332,37846,37247,266891
45387,5119,5224,5189,5152,5311,5465,5169,36629
45388,767,893,885,1022,917,914,812,6210
45389,556,564,500,485,431,484,521,3541
45390,3336,3262,3310,3355,3406,3575,3461,23705
45402,9972,10101,10639,10505,10535,10931,11420,74103
45403,15729,15934,15298,15645,14789,14861,15006,107262
45404,10380,10119,9918,10230,10918,11146,10833,73544
45405,17400,17848,18321,19049,18659,19158,18948,129383
45406,20214,20211,20428,20536,20717,21505,21914,145525
45409,14876,16027,15627,17107,17048,17611,12868,111164
45410,15833,15539,15765,15667,15209,15352,15339,108704
45414,20522,20429,20995,20567,20780,20464,21055,144812
45415,12610,12684,12675,12187,12359,12812,12631,87958
45416,5811,5905,5871,6249,6545,6517,5740,42638
45417,30606,31228,31752,31027,30871,30492,31281,217257
45418,1975,2014,1802,1687,1465,1274,1351,11568
45419,14899,14453,14491,14845,15083,14632,15159,103562
45420,24965,25157,25905,26155,26376,25877,25438,179873
45424,50670,50467,50359,50366,50226,49202,49930,351220
45426,15501,14992,14943,14625,14459,14744,15239,104503
45428,332,324,311,318,342,345,240,2212
45429,25624,25465,25352,25155,25122,25895,25885,178498
45430,7112,7472,7507,7472,7735,7995,7402,52695
45431,27386,26961,26968,27037,26828,25752,26315,187247
45432,15014,14706,14923,15102,14759,15508,15288,105300
45433,2782,2751,2590,2498,2372,2486,2011,17490
45434,11853,12105,11802,11838,11728,12266,12163,83755
45439,10137,9905,10144,9886,9648,9971,10000,69691
45440,21138,21367,20753,20627,20752,20792,20734,146163
45449,18114,18281,18361,18610,18816,18506,18175,128863
45458,30488,30700,30650,29482,29801,29370,29880,210371
45459,27897,27775,27577,28111,27472,27103,27749,193684
45502,15368,15982,15836,16169,15961,16241,16110,111667
45503,32876,32585,32914,32978,33728,33570,32999,231650
45504,17913,18447,18262,18252,18478,18628,18465,128445
45505,20026,19934,19396,19275,19338,19530,20197,137696
45506,13397,13438,14421,13996,13883,14117,14055,97307
45601,56916,56783,56910,57449,57082,57676,57842,400658
45612,5368,5479,5899,5662,5345,5519,5303,38575
45613,2905,3861,3998,3661,3849,3854,3597,25725
45614,4884,4970,4982,4832,4568,4614,5080,33930
45616,1543,1409,1409,1426,1399,1332,1559,10077
45617,265,253,255,122,119,0,71,1085
45618,10,10,7,16,20,18,30,111
45619,8217,8096,8061,8749,7743,7518,8200,56584
45620,1202,1290,1157,1004,809,833,917,7212
45621,364,395,434,409,339,344,313,2598
45622,220,193,219,299,274,347,321,1873
45623,3047,3145,3177,3127,2946,3050,3494,21986
45624,0,0,0,28,26,29,31,114
45628,4950,4456,4567,4703,4587,4674,5211,33148
45629,3208,3444,3532,3674,3818,3784,3438,24898
45630,117,199,195,243,254,159,118,1285
45631,15095,14875,14712,15500,15815,15767,15048,106812
45634,2020,1961,1920,2183,2271,2256,2112,14723
45636,188,224,176,167,186,115,148,1204
45638,21512,21507,21739,21933,21782,21533,21635,151641
45640,16750,16114,16320,16468,16959,16664,15960,115235
45642,0,0,0,0,0,0,33,33
45644,4605,4458,4635,4632,4263,3978,4249,30820
45645,3115,3286,3254,3249,2957,3457,3036,22354
45646,199,235,257,361,339,396,370,2157
45647,2448,2243,2237,2537,3183,3008,2484,18140
45648,12123,12650,12321,12880,12817,13434,13372,89597
45650,274,257,209,207,294,411,435,2087
45651,5842,6038,6307,5943,5671,5718,6047,41566
45652,4167,3996,4118,3927,3528,3393,3519,26648
45653,4178,4225,4142,4377,4174,4031,4179,29306
45654,868,989,923,828,826,943,917,6294
45656,6263,6704,6745,6295,6085,6111,6639,44842
45657,2180,2640,2925,2757,3172,2661,2744,19079
45658,2718,2612,2620,2133,2164,2429,2787,17463
45659,2632,2742,2894,2782,2981,2844,2973,19848
45660,8093,8149,8400,8557,8312,8251,8297,58059
45661,7394,7483,7021,6998,6813,6969,7657,50335
45662,30120,29643,29515,29505,29861,29897,30219,208760
45663,6176,6366,6464,6657,6709,7067,6762,46201
45669,10093,10124,10260,10193,10899,11025,10399,72993
45671,452,519,552,439,659,706,457,3784
45672,1569,1462,1052,1436,1619,1640,1749,10527
45673,490,312,387,407,256,234,385,2471
45674,726,722,713,757,676,684,584,4862
45678,1242,1210,1143,1306,1421,1244,1101,8667
45679,2519,2718,2832,2764,2955,3043,2812,19643
45680,12459,12435,12571,12140,12685,13033,13074,88397
45681,1602,1910,1855,1897,1937,1870,1689,12760
45682,2163,2338,2366,2554,2517,2745,2420,17103
45684,2177,1718,1787,1862,1951,1989,1804,13288
45685,735,891,1136,1183,1370,1375,1251,7941
45686,3682,3485,3628,3590,3516,3448,3397,24746
45688,615,583,648,533,476,494,475,3824
45690,15195,14279,14113,14244,14499,14089,14412,100831
45692,8358,8518,8518,8449,8319,8511,8773,59446
45693,8305,8219,8056,8207,8538,8608,8981,58914
45694,11950,12205,12635,12375,12164,12210,12147,85686
45695,512,576,608,558,731,942,674,4601
45696,1398,1493,1390,1353,1306,1213,1438,9591
45697,5086,5304,5344,5478,5461,5262,4894,36829
45698,423,407,440,414,416,316,341,2757
45701,35091,34559,34320,33913,33528,33218,34122,238751
45710,5474,5922,5845,5901,5618,5556,5541,39857
45711,1361,1321,1346,1305,1124,1273,1115,8845
45714,9393,9540,9518,9429,9750,9719,9951,67300
45715,2270,2450,2477,2607,2811,2630,2630,17875
45716,439,423,427,434,436,441,469,3069
45719,1232,1220,1258,1218,1108,1143,1046,8225
45721,40,40,42,11,10,0,29,172
45723,3409,3545,3630,3903,4002,3836,3740,26065
45724,1919,1872,1841,1888,1941,1991,1744,13196
45727,505,464,551,504,423,357,516,3320
45729,1513,1513,1374,1533,1475,1578,1289,10275
45732,4534,4410,4419,4484,4487,4377,4776,31487
45734,616,496,613,607,571,527,549,3979
45735,1745,1824,1792,1794,1799,1901,1730,12585
45740,457,582,579,581,557,557,494,3807
45741,905,1069,998,973,863,692,918,6418
45742,2834,2857,2970,3161,3143,3187,3014,21166
45743,1558,1527,1551,1364,1504,1705,1449,10658
45744,2687,2349,2410,2507,2596,2959,2728,18236
45745,1432,1414,1444,1419,1568,1225,1140,9642
45746,488,445,460,319,350,504,433,2999
45750,27252,27464,27710,27535,27662,27549,27785,192957
45760,3473,3294,3680,3861,3874,3859,3892,25933
45761,1625,1604,1955,1973,2027,2170,1745,13099
45764,9239,9259,9221,9046,8938,8985,9431,64119
45766,1088,999,968,1247,1508,1267,1382,8459
45767,2612,2696,2432,2657,2311,2192,2800,17700
45768,1650,1481,1651,1653,1788,2176,1703,12102
45769,6844,7106,6671,6550,6582,6742,6642,47137
45770,487,600,583,500,484,530,620,3804
45771,3736,3539,3567,3497,3381,3205,3432,24357
45772,1938,1870,1786,1991,2036,2033,2149,13803
45773,203,180,131,213,168,0,83,978
45775,1159,1130,1330,1252,1353,1359,1259,8842
45776,628,593,454,610,630,606,765,4286
45778,781,731,593,645,592,532,824,4698
45779,681,652,717,696,736,782,755,5019
45780,3090,3427,3241,3351,3444,3528,3254,23335
45782,468,359,352,407,398,410,343,2737
45784,3419,3339,3616,3336,3234,3216,3386,23546
45786,3795,3644,3662,3499,3151,3045,3253,24049
45787,22,52,33,0,54,53,29,243
45788,1272,1358,1303,1213,1317,1236,1129,8828
45789,106,114,31,159,173,160,177,920
45801,23840,23907,24859,24866,24924,24195,25303,171894
45804,15288,15482,15456,14968,15846,15628,15758,108426
45805,23712,23837,23453,24102,22931,23834,22514,164383
45806,10891,11195,10917,10632,10993,11398,11158,77184
45807,11603,11346,11428,11651,11571,12022,12221,81842
45808,395,401,356,380,349,394,349,2624
45809,153,143,102,75,123,159,157,912
45810,8392,8502,8422,8305,8388,8391,8460,58860
45812,1860,1964,1808,1581,1716,1739,1943,12611
45813,3669,3816,3580,3598,3583,3589,3530,25365
45814,3332,3202,2844,2688,2656,2595,2620,19937
45816,284,347,344,416,343,353,291,2378
45817,6983,6583,6704,6662,6501,6550,6736,46719
45819,290,304,268,259,242,242,233,1838
45820,452,390,470,423,417,351,543,3046
45821,1389,1325,1535,1516,1371,1309,1435,9880
45822,19569,19328,19427,19285,19392,19261,18943,135205
45826,344,363,347,361,309,303,306,2333
45827,1953,2016,1975,2104,2252,2531,2369,15200
45828,6091,6007,6078,6148,6201,6239,6125,42889
45830,5852,6012,6275,6471,6694,6761,6228,44293
45831,3428,3398,3360,3349,3235,2802,3181,22753
45832,2865,3121,2972,3179,3172,3192,2905,21406
45833,10771,10733,10570,10510,10477,10396,10667,74124
45835,593,500,384,348,286,244,490,2845
45836,1365,1472,1573,1560,1513,1512,1479,10474
45838,58,22,31,28,35,25,50,249
45840,55313,54986,54386,54941,54696,54665,54979,383966
45841,873,874,823,781,730,908,929,5918
45843,3974,4067,4143,4012,3890,3925,3701,27712
45844,3348,3308,3402,3228,3287,3276,3256,23105
45845,2886,3067,3068,2785,3042,3231,3178,21257
45846,4077,4226,4211,4236,4295,4479,4437,29961
45849,1295,1251,1393,1274,1150,1339,1219,8921
45850,3663,3590,3565,3847,3767,3865,3653,25950
45851,725,608,631,585,684,542,669,4444
45853,1264,1334,1326,1213,1033,827,1439,8436
45854,452,492,510,478,477,367,498,3274
45855,165,186,182,183,216,193,193,1318
45856,5150,5024,5132,5064,5070,5342,5194,35976
45858,3208,3088,3703,3409,3239,3216,3083,22946
45859,483,451,509,449,463,514,495,3364
45860,2249,2181,2135,2094,2197,2150,2274,15280
45861,149,123,140,156,169,214,296,1247
45862,1394,1418,1327,1583,1426,1505,1507,10160
45863,1168,1064,974,1004,1226,1254,1254,7944
45864,150,130,127,131,146,141,163,988
45865,4841,4807,4863,4937,4800,4750,4745,33743
45866,169,227,205,231,234,223,186,1475
45867,951,879,1073,1071,1131,1115,1189,7409
45868,635,682,668,538,533,612,567,4235
45869,4560,4580,4593,4496,4526,4548,4534,31837
45870,196,202,161,92,194,159,156,1160
45871,2051,2015,1779,1830,1799,1617,1955,13046
45872,4279,4206,4255,4331,4269,4216,4240,29796
45873,2242,2109,2111,2049,2200,2400,2238,15349
45874,2459,2291,2349,2041,1732,1791,2100,14763
45875,11378,11510,11293,11268,11254,11349,10989,79041
45876,777,766,754,804,703,709,863,5376
45877,2287,2159,2096,2178,2316,2172,2139,15347
45879,6171,6442,6284,6479,6258,6274,6284,44192
45880,2358,2279,2356,2316,2516,2456,2395,16676
45881,1290,1487,1545,1780,1902,1794,1461,11259
45882,2834,2873,2843,2764,2997,2982,3004,20297
45883,3987,4044,4037,3979,3821,3771,3883,27522
45884,197,179,212,159,132,86,145,1110
45885,12449,12240,12520,12736,12773,12745,12661,88124
45886,581,609,680,801,732,652,551,4606
45887,4393,4462,4416,4550,4643,4721,4755,31940
45888,166,187,218,197,213,205,220,1406
45889,1389,1627,1478,1294,1524,1418,1351,10081
45890,574,623,761,850,787,760,671,5026
45891,14832,14965,15096,15096,15432,15573,15275,106269
45894,656,627,580,639,783,677,605,4567
45895,18063,18397,18333,18356,18253,18244,17945,127591
45896,2204,2238,2291,2235,2093,1887,2089,15037
45897,39,177,181,155,199,206,101,1058
45898,1203,1209,1285,1326,1150,1094,1314,8581
45899,185,200,200,310,288,201,194,1578
46001,10207,10387,10425,10350,10690,10562,10459,73080
46011,17293,17075,17318,16523,16817,17023,16770,118819
46012,19260,19155,19537,19874,19865,19725,19414,136830
46013,17385,17830,18059,18475,18663,18429,17876,126717
46016,18207,18221,18181,18892,18282,18207,19225,129215
46017,5800,5757,5675,5604,5592,5832,6025,40285
46030,2921,3174,2949,3106,3270,3447,3308,22175
46031,2509,2252,2275,2434,2445,2160,2161,16236
46032,46295,44569,42957,42335,42542,41585,42234,302517
46033,37873,37229,36504,35659,35326,34632,34889,252112
46034,7011,7295,7358,7240,7012,7157,6730,49803
46035,1069,1128,1074,1174,1080,1058,1113,7696
46036,11525,11439,11458,11738,11805,11781,11663,81409
46037,40047,39171,37888,36885,34602,33309,35891,257793
46038,41376,40631,39773,38735,38838,37299,37723,274375
46039,524,664,601,843,960,937,745,5274
46040,11604,11443,11900,11537,11112,10867,9944,78407
46041,23226,23590,23761,23668,23728,23865,23891,165729
46044,2947,2833,2712,2701,2675,2835,2965,19668
46045,57,35,178,243,374,321,93,1301
46047,95,232,231,117,89,84,43,891
46048,2135,2123,2152,2128,2099,2069,2406,15112
46049,738,746,748,884,924,879,850,5769
46050,2203,1732,1987,1902,1978,1845,1706,13353
46051,2835,2928,2879,3148,3023,3095,2826,20734
46052,22370,22064,21884,21879,22067,22161,22060,154485
46055,10929,9945,10081,9706,9130,8775,10193,68759
46056,2224,2284,2202,2131,2489,2529,2246,16105
46057,1251,1033,978,925,989,882,1179,7237
46058,2096,2249,2105,1992,2099,2226,2149,14916
46060,38483,37737,36918,35159,34390,33586,34708,250981
46062,33470,33088,31956,31175,30358,29020,29730,218797
46063,442,420,426,517,443,417,401,3066
46064,17113,17205,15945,15771,15992,16510,17148,115684
46065,3490,3405,3475,3541,3506,3647,3669,24733
46068,2437,2352,2435,2358,2383,2593,2850,17408
46069,7131,7402,7052,7044,6599,6952,6664,48844
46070,2339,2352,2363,2156,2136,2150,2351,15847
46071,3769,3675,3906,3804,3795,3629,3417,25995
46072,9303,9645,9651,9603,9590,9658,9324,66774
46074,30172,29787,29786,28951,26896,25851,26745,198188
46075,4544,4091,3522,3246,2982,2591,2913,23889
46076,1787,1753,1719,1730,1686,1742,1696,12113
46077,27421,27040,26493,25250,24300,23512,24512,178528
46103,193,172,214,223,226,257,159,1444
46104,905,1090,1077,865,791,797,970,6495
46105,2245,2367,2238,2181,2154,2279,1928,15392
46106,6610,6547,6541,6051,5173,4467,5928,41317
46107,12235,12125,12658,12763,12801,13043,12774,88399
46110,529,511,425,540,564,693,500,3762
46111,315,296,306,361,402,304,322,2306
46112,35322,34690,34063,33844,33705,33374,33662,238660
46113,15701,15811,15741,15100,15037,14302,14063,105755
46115,1970,1982,2174,2201,2077,1880,1933,14217
46117,706,622,421,439,397,375,671,3631
46118,5186,4975,5105,5207,5297,4790,5015,35575
46120,5557,5759,6008,6269,6182,6156,5954,41885
46121,5522,5559,5441,5275,5270,5059,5276,37402
46122,15524,15257,14709,14314,14363,14152,14671,102990
46123,34818,34167,32558,32069,31365,30349,31754,227080
46124,8103,7533,7465,7641,7893,7855,8127,54617
46125,36,37,39,48,19,12,51,242
46126,5154,5103,4861,4172,4610,4567,4668,33135
46127,344,305,265,271,311,252,416,2164
46128,1854,1894,1819,1757,1776,1777,1949,12826
46130,2414,2444,2298,2536,2830,2719,2508,17749
46131,31866,31507,31183,31072,30925,30677,31036,218266
46133,697,593,495,897,1010,1034,816,5542
46135,20881,20881,20737,20512,20390,20563,20992,144956
46140,39242,39084,38870,39070,38876,38372,38543,272057
46142,30064,29896,30025,29735,28980,29586,30413,208699
46143,53473,52219,51282,50521,50241,49154,48555,355445
46144,189,195,155,131,108,106,211,1095
46146,72,59,72,72,109,110,117,611
46147,3223,3453,3535,3418,3280,3194,3264,23367
46148,5294,5406,5204,5342,5625,5699,5097,37667
46149,2468,2486,2448,2151,2148,1911,1890,15502
46150,633,518,498,540,661,688,764,4302
46151,31581,30818,30770,30628,30317,30469,30921,215504
46155,65,86,121,136,149,166,103,826
46156,1967,1639,1488,1519,1566,1684,1470,11333
46157,4145,4248,4124,3879,3927,3590,3639,27552
46158,22463,22552,22248,22442,22231,22608,23053,157597
46160,5998,6204,6285,6849,6846,6947,6421,45550
46161,2650,2750,2802,2534,2309,2234,2655,17934
46162,495,467,382,346,279,237,458,2664
46163,11721,11581,11643,11486,12028,11957,11963,82379
46164,3862,3893,3989,3998,4091,4021,3957,27811
46165,1438,1402,1301,1452,1606,1636,1498,10333
46166,1819,2304,2255,2143,2316,2389,2306,15532
46167,6292,6268,6389,6662,6455,6408,6336,44810
46168,32932,32530,32114,31696,30729,30677,30309,220987
46171,1393,1303,1419,1665,1570,1654,1695,10699
46172,2327,2420,2423,2455,2540,2526,2427,17118
46173,10536,10865,11433,11398,11349,11511,11190,78282
46175,624,484,604,707,671,618,597,4305
46176,27533,27515,27529,27766,27834,27866,27816,193859
46180,857,807,1058,1164,1306,1225,1028,7445
46181,4504,4592,4673,4394,4359,4489,4832,31843
46182,1385,1298,1639,1702,1754,2001,1927,11706
46183,275,284,246,263,247,0,82,1397
46184,13220,13094,12462,12358,12532,12330,11806,87802
46186,1849,1831,2027,1961,1802,1775,1753,12998
46201,30538,30737,31080,31369,30487,29994,30962,215167
46202,18288,17443,16690,15966,16021,16204,16335,116947
46203,38248,38717,38000,37400,38313,38365,38950,267993
46204,7001,6510,6309,5825,5903,6067,5125,42740
46205,27870,28339,27471,26487,26351,27151,25356,189025
46208,23504,23346,22565,22779,23312,22998,22239,160743
46214,24246,24709,24930,24240,23747,23153,24306,169331
46216,2044,1730,1718,1653,1496,1669,1697,12007
46217,31508,31389,29891,28722,29558,29816,29358,210242
46218,26831,27379,29124,29589,30516,30866,29028,203333
46219,36057,35735,34829,34377,33646,34332,33930,242906
46220,36128,36384,34571,34838,33833,33261,34830,243845
46221,26177,26272,26316,26345,27054,27089,26393,185646
46222,35467,34457,33892,33954,33061,33759,34044,238634
46224,36148,35995,35510,35147,35177,34804,35094,247875
46225,7664,7226,7097,7008,6524,6410,7319,49248
46226,45401,45559,45795,45341,45998,43677,43904,315675
46227,58930,57840,57935,58348,56449,55392,57086,401980
46228,14847,15135,15257,14611,14876,14931,14755,104412
46229,28040,27809,27988,28640,27913,28073,27262,195725
46231,10316,10683,11312,11476,11440,10870,10440,76537
46234,27770,26935,26939,26291,25002,25417,24810,183164
46235,33459,32465,31964,30524,29507,29435,30825,218179
46236,26880,26518,26872,27509,26751,27541,27294,189365
46237,39793,40665,40654,40329,39803,38315,39624,279183
46239,29187,28796,27196,26317,24348,23037,25345,184226
46240,19474,19390,19835,18808,18817,18448,18731,133503
46241,32081,31155,31125,30955,30918,30044,30670,216948
46250,18400,17872,17840,17861,18545,19175,18546,128239
46254,40335,39490,38256,37545,36530,35667,38095,265918
46256,23119,23324,22803,23078,23541,23153,23647,162665
46259,11364,11341,11878,12161,11777,11087,11617,81225
46260,32692,32341,32932,33273,32779,32539,32406,228962
46268,25036,25530,26049,26488,26411,26698,24965,181177
46278,7985,7504,7506,7814,7968,7813,8197,54787
46280,7511,7051,6857,6963,6595,6879,6793,48649
46290,231,224,231,343,297,171,170,1667
46301,643,562,553,550,571,621,669,4169
46303,14375,14078,13997,13784,13631,13595,14170,97630
46304,24270,24514,24535,24282,24618,24769,24207,171195
46307,61385,60717,60326,60191,59749,58447,60619,421434
46310,14217,13820,13610,13311,13085,12914,13565,94522
46311,21708,21972,22333,21917,21373,20783,20816,150902
46312,28961,29178,29387,29584,29789,30003,29698,206600
46319,17924,17866,17949,18032,18086,18393,18404,126654
46320,14822,15086,14884,15440,15215,14932,15508,105887
46321,23103,23250,23325,23445,23460,23406,23603,163592
46322,23107,23285,23429,23544,23646,23741,23727,164479
46323,22256,22671,23182,22561,22618,23660,22743,159691
46324,22307,22469,22903,23359,22944,23111,23165,160258
46327,11842,11607,11333,11435,12272,11871,12153,82513
46340,859,906,909,1093,1083,1199,1068,7117
46341,10215,9921,10342,10422,10610,10815,10426,72751
46342,30473,30972,31378,31156,31077,31122,31244,217422
46345,225,282,383,337,293,295,249,2064
46346,1304,1470,1558,1600,1539,1594,1423,10488
46347,4885,4769,4803,4860,4844,4838,4760,33759
46348,1003,1026,1131,1034,1014,950,1045,7203
46349,3005,3339,3074,3461,3302,3427,3336,22944
46350,42558,42614,43001,43335,43249,42921,43650,301328
46356,17873,17654,17626,17503,17541,17268,17524,122989
46360,43509,43613,43620,43882,44106,44351,43625,306706
46365,713,881,1001,1185,1151,1241,1068,7240
46366,5431,5614,5661,5673,5573,5677,5791,39420
46368,39062,39143,38930,38517,38310,38001,38691,270654
46371,4003,4370,3942,3636,3559,3482,3599,26591
46373,14849,14679,14092,14089,13694,13326,13859,98588
46374,1033,1113,1039,826,959,1018,1012,7000
46375,23127,23475,23506,23626,23752,23707,23820,165013
46376,280,328,338,372,398,427,398,2541
46377,326,458,401,405,350,313,386,2639
46379,137,268,261,210,291,264,202,1633
46381,81,81,363,372,420,400,235,1952
46382,1858,1962,2071,2200,2212,2194,2108,14605
46383,40866,40250,39630,40009,39202,39159,39687,278803
46385,39743,40337,39921,38675,38335,38026,38866,273903
46390,2925,2728,2533,2517,2541,2591,2796,18631
46391,10252,10264,10558,10275,10153,9836,9726,71064
46392,8022,8111,8216,7834,7856,7877,7957,55873
46393,248,290,199,411,337,412,399,2296
46394,11992,12055,12213,12289,12606,12555,12258,85968
46402,6284,6662,6359,6603,6692,6811,6726,46137
46403,13869,13040,12705,12223,12938,12292,12601,89668
46404,17332,17146,16935,16988,16888,17539,17326,120154
46405,11658,11530,11378,11500,11854,12027,11746,81693
46406,9402,9658,10196,9898,9876,10096,9900,69026
46407,11728,12071,12473,12798,13076,13872,12656,88674
46408,15640,16072,16339,16820,16577,16867,17030,115345
46409,8094,8168,8695,9150,9799,9749,8932,62587
46410,38721,39017,38690,39023,38990,38656,38340,271437
46501,3653,3529,3740,3892,3858,3974,3856,26502
46502,283,329,423,479,454,174,115,2257
46504,3601,3520,3477,3544,3490,3305,3413,24350
46506,9587,10027,9869,10037,10223,10148,10070,69961
46507,9409,9276,9321,8786,8963,8730,9128,63613
46508,143,148,159,140,202,265,217,1274
46510,3786,3666,3438,3142,3178,3217,3631,24058
46511,4228,4426,4384,4292,4589,4724,4435,31078
46514,40956,40108,39975,40147,39298,40130,40263,280877
46516,33885,33760,34257,34372,34309,32956,33501,237040
46517,24162,23959,23361,22891,22970,23851,23764,164958
46524,2213,2405,2471,2541,2581,2818,2326,17355
46526,32827,33236,32957,33137,32644,32470,30671,227942
46528,26053,25379,25116,25001,24966,24399,26104,177018
46530,30783,30859,29932,29699,29892,29771,30614,211550
46531,1431,1721,1577,1365,1498,1626,1458,10676
46532,1905,1972,2177,1983,2031,1903,1905,13876
46534,11731,11211,11048,11272,11393,11199,11263,79117
46536,3471,3490,3510,3454,3369,3208,3445,23947
46537,606,594,448,468,396,328,433,3273
46538,3753,3722,4023,3897,3841,4009,3867,27112
46539,1971,1957,1911,1950,1897,2106,2298,14090
46540,11484,11837,11579,11559,11501,11365,11702,81027
46542,3919,3902,4053,3764,4041,3924,4198,27801
46543,3721,3849,3732,4140,4022,3546,3654,26664
46544,31576,31502,31217,31130,30761,30828,30759,217773
46545,24226,23792,24147,24723,25090,25310,25082,172370
46550,13028,12987,12965,12608,12568,12443,12311,88910
46552,6904,6906,7153,6865,6891,6573,6834,48126
46553,3215,3063,3020,3389,3567,3744,3428,23426
46554,5071,5101,5058,4933,4698,4882,4942,34685
46555,2991,2875,2961,2991,2829,2821,2835,20303
46556,7468,7213,7395,7027,7207,7405,7314,51029
46561,13166,14343,14130,13482,13801,13348,13343,95613
46562,5309,5416,5129,4937,4848,4770,4788,35197
46563,23924,23860,23823,23742,23347,23453,23599,165748
46565,8405,8414,8357,8356,7802,8108,7950,57392
46567,8854,8664,9093,9417,9335,9353,9405,64121
46570,1115,1230,1226,1189,1330,1330,1060,8480
46571,5297,5342,5292,5398,6458,6780,5532,40099
46573,3687,3534,3401,3492,3518,3677,3565,24874
46574,9004,7948,7678,7644,7551,7638,8339,55802
46580,21606,21333,21354,21263,21210,21332,21338,149436
46582,12892,12767,12238,12280,12116,12090,12378,86761
46590,5129,4935,4934,4899,4862,4806,4908,34473
46595,122,87,52,73,66,217,163,780
46601,6418,6568,6543,5851,6094,6021,6090,43585
46613,10872,11336,11110,11196,11193,11536,10893,78136
46614,30581,30179,30236,30780,30730,30551,29573,212630
46615,13720,14076,14877,15869,15167,15583,14609,103901
46616,5661,5715,5342,5232,5593,5498,5667,38708
46617,9169,9403,9699,9947,10190,10182,9601,68191
46619,22350,21117,22114,21045,21229,21027,21408,150290
46628,25263,25017,26020,26475,26702,26423,25650,181550
46635,6499,6504,5868,5719,5641,5696,6654,42581
46637,15247,15766,14446,14748,14532,14558,15314,104611
46701,8000,7837,7707,7798,7724,7952,7979,54997
46702,2207,2251,2092,2142,2241,2427,2304,15664
46703,17624,17532,17608,18016,17894,17916,18029,124619
46704,28,38,131,194,179,150,60,780
46705,1574,1495,1707,1625,1876,1949,1583,11809
46706,18535,18629,19095,19363,18998,18490,18630,131740
46710,3916,4182,4422,4446,4564,5083,4679,31292
46711,7252,7610,7626,7813,7686,8089,7698,53774
46714,14498,14616,14599,14414,14478,14474,14645,101724
46721,4893,5002,5109,5026,5028,5259,5058,35375
46723,7518,7486,7372,7162,7259,6997,7692,51486
46725,22888,23062,23102,23109,22979,22716,23080,160936
46730,1106,1087,1185,1277,1350,1459,1381,8845
46731,546,549,488,605,566,449,559,3762
46732,3518,3598,3297,3128,2922,2830,3169,22462
46733,18776,18397,18274,18411,18896,18938,18777,130469
46737,7430,7621,7260,7012,7112,6954,7068,50457
46738,8387,8265,7858,7777,7913,7679,7918,55797
46740,4646,4610,5032,4534,4113,4161,4060,31156
46741,4579,4462,4574,4798,4748,4812,4647,32620
46742,3369,3416,3492,3332,3539,3579,3488,24215
46743,2177,2282,2061,1938,1824,1631,1971,13884
46745,1774,1922,1901,1931,1940,1859,1841,13168
46746,4263,4221,4113,4051,3985,3902,4036,28571
46747,2981,3026,3054,2923,2503,2589,2693,19769
46748,5471,5971,5769,5371,5374,4888,5134,37978
46750,26965,26957,27337,27432,27475,27103,27221,190490
46755,15381,15372,15092,15239,15203,15360,15062,106709
46759,421,343,411,635,612,673,652,3747
46760,1344,1441,1399,1363,1564,1581,1382,10074
46761,12435,12275,12171,11998,11503,11525,12039,83946
46763,2237,1942,1982,1919,1712,1441,1631,12864
46764,1360,1242,1171,1211,1495,1586,1497,9562
46765,5408,5646,5625,5457,5602,5491,5341,38570
46766,844,625,689,720,832,786,685,5181
46767,8500,8321,8560,8280,8436,8104,8564,58765
46770,2896,2774,2725,2883,2809,2880,2716,19683
46771,0,0,0,0,43,47,105,195
46772,3413,3600,3410,3488,3426,3134,3411,23882
46773,3346,3353,3495,3743,3886,3685,3662,25170
46774,16809,17308,16967,16550,16244,15944,16008,115830
46776,1417,1251,1421,1516,1492,1533,1484,10114
46777,6479,6334,6200,6271,6274,6341,6259,44158
46779,2229,2271,2077,2087,2142,2234,2166,15206
46781,874,902,975,825,915,866,793,6150
46783,6364,6623,6538,6144,5888,6416,6396,44369
46784,2185,2129,2269,2141,2072,1922,2236,14954
46785,1648,2023,1908,1992,1926,1844,1542,12883
46786,157,258,313,371,238,244,102,1683
46787,3698,3647,3734,3946,4000,3951,3893,26869
46788,3541,3210,3125,2798,2628,2810,3260,21372
46791,1052,1027,973,696,761,759,918,6186
46792,3613,3850,3604,3503,3451,3519,3499,25039
46793,4412,4332,4312,4404,4495,4445,4292,30692
46794,1590,1724,2026,2124,2121,2181,1587,13353
46795,6519,6212,5767,5481,5699,5458,5608,40744
46797,3868,4060,4048,4129,3961,4185,3957,28208
46798,1524,1567,1703,2107,2156,1939,1661,12657
46799,228,228,185,169,162,234,212,1418
46802,11073,11280,10588,11136,10976,11192,11086,77331
46803,9766,9544,9737,9314,8932,8202,9758,65253
46804,28865,28618,28089,27105,26719,26619,27245,193260
46805,21017,20565,20828,21166,21462,21463,21306,147807
46806,25100,24830,25316,24414,23990,23833,23560,171043
46807,16895,16233,16008,15819,15632,16281,16072,112940
46808,19220,19053,18951,18939,19495,19891,19309,134858
46809,8583,7944,7900,8186,8230,8286,8947,58076
46814,12272,12285,12615,12993,12883,12365,12281,87694
46815,28068,27522,27366,27158,26936,26294,26522,189866
46816,18447,18391,17970,17688,19003,18632,18116,128247
46818,20767,20370,20498,19746,18998,18359,18790,137528
46819,9550,9441,9199,9407,8865,9038,8765,64265
46825,28890,28560,28740,28800,28901,28668,27931,200490
46835,34463,34090,33268,32855,32278,32957,33604,233515
46845,21802,21972,21560,21528,21406,21129,22117,151514
46901,39867,39174,39096,38943,38946,38464,37633,272123
46902,35993,35949,36239,35465,35497,36115,35697,250955
46910,3354,3482,3247,3373,3463,3451,3360,23730
46911,1224,1230,1369,1398,1580,1716,1439,9956
46913,1232,1204,1198,1201,1210,950,1329,8324
46914,1748,1905,1476,1665,1945,2189,4908,15836
46915,614,624,718,745,800,741,679,4921
46917,1926,2048,2159,2205,1900,1898,1853,13989
46919,2427,2470,2680,2472,2660,2550,2390,17649
46920,1076,983,1071,1068,1144,1188,1045,7575
46922,25,29,0,0,0,0,61,115
46923,8059,8232,7836,7749,7773,7667,8048,55364
46926,1540,1781,1749,1767,1725,1755,1708,12025
46928,4552,4815,4853,4812,4793,4713,4951,33489
46929,3044,3207,3387,3455,3385,3572,3214,23264
46930,95,104,108,139,153,132,133,864
46931,213,231,186,153,101,115,188,1187
46932,3204,3481,3626,4017,3921,4011,3448,25708
46933,6288,6477,6486,6707,6623,6733,6414,45728
46936,5800,5988,6208,6215,6046,6127,5922,42306
46938,3135,2976,2921,2954,3167,3086,3200,21439
46939,1939,2020,1983,2122,2139,2273,2101,14577
46940,2654,2635,2789,2733,2711,2640,2548,18710
46941,1054,1096,1182,1026,931,1150,1125,7564
46943,241,152,129,153,216,164,247,1302
46946,116,118,108,96,14,48,136,636
46947,28327,28341,28626,28874,28817,28623,28866,200474
46950,699,733,651,715,590,761,643,4792
46951,1910,1861,1861,1812,1662,1582,2170,12858
46952,19224,19373,19598,19915,19790,20305,20308,138513
46953,24424,24547,24497,24258,24444,24197,24177,170544
46957,606,536,552,571,580,580,558,3983
46958,460,509,440,323,454,436,460,3082
46959,587,636,660,667,523,515,231,3819
46960,948,979,1069,1066,1057,1039,1218,7376
46961,137,81,78,81,74,87,99,637
46962,10100,9940,10200,10098,10041,9843,9728,69950
46967,139,131,164,127,111,91,98,861
46968,76,81,79,88,108,84,73,589
46970,23537,23443,23270,23780,24112,24129,23766,166037
46974,1489,1606,1660,1710,1822,1951,1699,11937
46975,14607,14259,14845,14841,14685,14456,14691,102384
46978,2107,2150,2220,2102,2039,2120,2059,14797
46979,4876,4920,4851,5108,5298,4919,4733,34705
46982,2447,2471,2643,2942,2692,2563,2573,18331
46984,192,224,124,162,163,249,224,1338
46985,1349,1324,1104,1087,1083,1162,1441,8550
46986,1634,1785,1864,1980,2083,2008,1915,13269
46987,752,705,608,569,476,513,776,4399
46988,958,876,852,1029,1083,1160,823,6781
46989,4939,5010,5135,5203,5196,5216,5195,35894
46990,874,1083,880,1105,1051,911,801,6705
46991,1707,1806,1752,1810,1842,1716,1797,12430
46992,16101,16169,16443,16554,16787,17040,16759,115853
46994,2923,2873,2642,2376,2480,2443,2684,18421
46996,6647,7059,7283,7358,7253,7489,7139,50228
46998,230,104,189,74,74,71,112,854
47001,10567,10547,10473,10171,9802,9866,10422,71848
47003,1041,1002,1021,1029,914,905,1040,6952
47006,11403,11355,11494,11985,11902,11712,11727,81578
47010,311,374,282,235,213,292,306,2013
47011,707,611,764,863,868,991,1277,6081
47012,9896,10048,10382,10371,10393,10406,10188,71684
47016,1136,919,811,780,1100,865,793,6404
47017,327,328,376,446,493,567,507,3044
47018,4495,4317,4328,4370,4306,4288,4275,30379
47020,1225,1309,1468,1745,1782,1777,1309,10615
47022,3420,3254,3285,3288,3293,3111,3358,23009
47023,1461,1400,1531,1675,1881,1829,1636,11413
47024,3486,3301,3264,3187,3313,3436,3226,23213
47025,22390,22789,22871,23160,23153,23304,22932,160599
47030,1707,1586,1526,1501,1453,1457,1636,10866
47031,5234,5289,5213,5161,5245,5318,5368,36828
47032,3167,3186,3153,3092,3108,3216,3289,22211
47034,104,130,123,116,161,206,158,998
47035,264,327,395,392,410,431,233,2452
47036,975,1091,1062,1064,956,1056,1023,7227
47037,4838,4654,4637,4598,4632,4444,4333,32136
47038,1604,1807,1629,1543,1396,1412,1504,10895
47040,5196,5438,5335,5412,5675,5702,5480,38238
47041,6158,6440,6325,6287,6386,6262,6125,43983
47042,4143,4338,4241,4222,4040,4258,4504,29746
47043,5603,5308,5446,5200,5145,5126,5250,37078
47060,6252,6179,6322,6228,6200,6011,6448,43640
47102,7241,7540,7836,7849,7676,7552,7255,52949
47104,34,32,31,0,0,0,41,138
47106,4587,4366,4296,4476,4387,4447,4718,31277
47108,2202,2227,2088,2180,2427,2516,2463,16103
47110,670,656,600,250,254,170,350,2950
47111,15354,15338,14974,14951,14654,14530,14533,104334
47112,16736,16510,16438,16491,16519,16452,16722,115868
47114,408,371,335,344,326,241,399,2424
47115,2587,2504,2602,2647,2684,2582,2622,18228
47116,646,706,903,894,971,841,805,5766
47117,4359,4294,4400,4505,4397,4426,4429,30810
47118,3344,3345,3370,3565,3402,3552,3502,24080
47119,11275,11127,11047,11410,11060,11138,10911,77968
47120,1051,894,1024,1011,929,976,938,6823
47122,10352,10521,10502,10022,10205,9761,9979,71342
47123,80,95,94,147,153,223,189,981
47124,4173,4190,4367,4590,4748,4636,4264,30968
47125,1710,1625,1578,1778,1665,1473,1658,11487
47126,4301,4294,4317,4131,3969,4257,4250,29519
47129,19667,19658,19638,19750,20007,20455,19527,138702
47130,45628,45385,45200,44870,44354,43396,44722,313555
47135,1151,1292,1322,1361,1220,1152,1372,8870
47136,4551,4463,4351,4199,4070,4301,4178,30113
47137,1442,1547,1383,1559,1493,1654,1421,10499
47138,4909,4716,4914,4843,4489,4880,4373,33124
47140,2388,2345,2384,2531,2485,2794,2669,17596
47141,1860,1825,2006,1996,1969,1956,1668,13280
47142,1002,997,949,976,984,1079,1174,7161
47143,3090,3037,3175,3219,3082,3092,3015,21710
47145,2038,2003,2167,1974,1939,1884,1998,14003
47147,1067,1209,994,864,906,931,945,6916
47150,48350,48394,48259,47954,47415,47290,47472,335134
47160,31,27,33,67,177,171,93,599
47161,3479,3775,3928,4265,4014,3658,3735,26854
47162,668,668,672,680,836,796,829,5149
47163,2222,2039,2026,1731,1375,1331,1746,12470
47164,3716,3464,3404,3162,3361,3405,3779,24291
47165,6279,6341,6503,6351,6686,6538,6438,45136
47166,1534,1555,1411,1366,1459,1611,1302,10238
47167,14861,15361,15157,15167,14724,14624,15014,104908
47170,14460,14205,14039,14174,14521,14265,14795,100459
47172,17134,16639,16032,15645,15761,15460,16059,112730
47175,921,778,725,847,982,838,909,6000
47177,1075,1106,1221,1212,1411,1105,1221,8351
47201,43691,43689,43351,42583,41832,41432,41662,298240
47203,27063,27053,26399,26327,26216,25743,25806,184607
47220,5670,5623,5476,5182,5106,5270,5652,37979
47223,1331,1463,1638,1589,1619,1899,1490,11029
47224,500,537,688,545,645,607,636,4158
47226,198,212,267,276,304,288,202,1747
47227,2112,1928,1691,1546,1492,1441,1598,11808
47229,3048,3009,2950,3075,3191,3267,3231,21771
47230,1425,1684,1789,1812,1744,1809,2029,12292
47231,925,993,1018,1011,987,913,1167,7014
47232,2963,2937,3182,3280,3660,3576,2839,22437
47234,1683,1905,1912,1908,1539,1437,1379,11763
47235,1514,1553,1627,1883,2243,2291,1784,12895
47240,21330,21254,21056,21160,21155,21073,20832,147860
47243,6090,5911,6008,5886,6064,5992,5951,41902
47244,786,674,743,833,889,847,786,5558
47246,4487,4660,4570,4585,4372,4514,4342,31530
47247,168,119,103,87,106,98,156,837
47250,22436,22296,21887,22177,21801,21687,21944,154228
47260,1750,1640,1809,2053,1990,1856,1911,13009
47263,218,206,243,275,217,291,236,1686
47264,1526,1754,1677,1794,1918,1700,1428,11797
47265,20975,20595,20411,20456,20518,20420,20911,144286
47270,463,634,657,719,659,867,807,4806
47272,2439,2204,2154,2250,2027,1781,2041,14896
47273,1551,1808,1706,1757,1734,1543,1849,11948
47274,30481,30234,29837,29024,28475,28317,28770,205138
47280,1058,1027,713,701,525,511,813,5348
47281,1328,1257,1310,1495,1518,1707,1324,9939
47282,374,299,265,202,187,162,289,1778
47283,3014,3016,3013,2828,2826,3146,3386,21229
47302,26779,27196,26696,27195,27938,28421,27592,191817
47303,26086,26061,26417,25877,25466,25506,25365,180778
47304,31038,30733,31223,31218,30369,30149,30516,215246
47305,3764,3986,4038,4142,4570,4609,4106,29215
47306,5256,5365,5460,5519,5508,5227,6189,38524
47320,3888,4130,3957,4147,4240,4228,4134,28724
47324,139,150,175,139,175,125,138,1041
47325,444,527,547,634,685,690,667,4194
47326,2328,2210,1862,1911,2002,1891,2295,14499
47327,4478,4489,4621,4664,4812,5109,4597,32770
47330,5651,5707,5773,5663,5494,5423,5755,39466
47331,22797,22922,23357,23184,23165,23269,23429,162123
47334,3221,3264,3272,3178,3246,3275,3263,22719
47335,694,730,664,647,693,524,761,4713
47336,3497,3696,3592,3783,3854,3539,3807,25768
47337,216,208,203,183,159,138,203,1310
47338,2655,2578,2585,2646,2631,2726,2827,18648
47339,627,599,663,744,850,772,669,4924
47340,2762,2944,2922,2875,3131,3132,2914,20680
47341,2283,2179,2289,2390,2207,2035,2283,15666
47342,2723,2972,2981,2846,3062,2793,2693,20070
47344,106,99,130,243,242,237,140,1197
47345,1364,1468,1519,1536,1655,1603,1448,10593
47346,4052,4066,3957,3883,3755,3718,4082,27513
47348,9565,9837,9919,10029,10022,10078,9828,69278
47351,440,435,516,575,614,570,471,3621
47352,1037,1021,1015,770,686,587,965,6081
47353,5718,5879,5831,5778,5934,5840,5879,40859
47354,1063,1095,1044,1083,1095,987,1129,7496
47355,2761,2764,2621,2761,2970,3078,2885,19840
47356,5703,5832,5908,6002,5852,5799,5781,40877
47357,1116,1251,1248,1409,1374,1569,1215,9182
47358,953,1005,1193,1270,1198,1112,996,7727
47359,2875,2834,2886,2891,2873,2874,3143,20376
47360,1356,1452,1474,1523,1805,1616,1546,10772
47361,183,191,135,156,138,137,135,1075
47362,30144,29921,29600,29546,29687,29813,30243,208954
47367,24,117,124,123,123,151,191,853
47368,3358,3085,2862,2807,2351,2321,2845,19629
47369,1387,1473,1578,1578,1483,1309,1343,10151
47371,12394,12280,12521,12591,12495,12718,12226,87225
47373,2326,2081,2172,2011,2088,2304,2226,15208
47374,46200,46333,46333,46361,46669,46879,46875,325650
47380,1772,1916,1962,2015,1939,2100,2004,13708
47381,182,205,153,146,213,193,145,1237
47382,201,156,169,163,154,135,200,1178
47383,2874,2784,2911,2771,2852,3008,2960,20160
47384,1894,1984,1928,1945,1780,1806,2000,13337
47385,1693,1754,2076,1943,1989,1885,1612,12952
47386,1330,1404,1446,1494,1307,1139,1231,9351
47387,709,649,683,767,758,663,726,4955
47388,347,390,433,365,279,270,384,2468
47390,5071,5238,5290,5254,5280,5402,5310,36845
47393,1516,1549,1740,1823,1634,1878,1704,11844
47394,8126,8303,8434,8393,8337,8337,8470,58400
47396,7278,7211,6968,7004,6751,6879,7030,49121
47401,42468,42211,42375,42605,41444,41313,41011,293427
47403,33127,32662,32032,30728,30104,29457,30955,219065
47404,22763,22471,21232,20748,20730,20733,21026,149703
47405,3876,4062,4169,4264,5100,5013,4427,30911
47406,3571,3848,4343,4444,4422,4623,4730,29981
47408,26132,25563,25460,25387,25147,24656,24776,177121
47420,364,76,102,48,49,116,135,890
47421,27514,27827,27755,27649,28064,27776,27831,194416
47424,8941,8850,8570,8631,8833,9286,9525,62636
47427,1080,1039,1281,1298,1306,1080,1093,8177
47429,8616,8910,8678,8504,7999,7614,7986,58307
47431,1331,1309,1201,1268,1370,1506,1366,9351
47432,4491,4434,4443,4557,4441,4523,4537,31426
47433,4328,4058,4286,4457,4115,4080,4025,29349
47434,0,65,108,115,103,177,76,644
47436,1328,1508,1451,1557,1627,1782,1663,10916
47437,56,0,0,0,0,74,123,253
47438,4684,4542,4422,4286,4511,4404,4798,31647
47441,9392,9258,9274,9298,9340,9374,9269,65205
47443,1346,1362,1196,1074,1010,914,1233,8135
47446,10470,10325,10322,10238,10142,9879,9990,71366
47448,7287,7402,7359,7050,7249,7386,7505,51238
47449,380,457,428,538,587,573,413,3376
47451,1111,1103,1249,1377,1324,1388,1228,8780
47452,5076,4982,4769,4952,5169,4871,5359,35178
47453,552,541,516,373,546,562,498,3588
47454,7656,8041,8190,7688,7765,8113,7688,55141
47455,0,0,22,21,48,207,124,422
47456,1364,1224,1117,1057,1122,1216,1200,8300
47457,107,149,51,52,29,40,134,562
47458,0,0,0,0,0,0,36,36
47459,4034,4100,4420,4172,4042,3740,3795,28303
47460,10843,10993,11072,11131,11489,11155,11471,78154
47462,4668,5135,5447,5710,4956,5188,4871,35975
47464,232,183,149,141,119,102,198,1124
47465,651,686,742,631,684,588,750,4732
47467,152,30,33,38,36,23,72,384
47468,1143,1097,1169,1121,1245,1132,1250,8157
47469,1672,1818,1704,1822,1798,1727,1749,12290
47470,1854,1764,1738,2068,1809,1657,1735,12625
47471,2503,2453,2662,2525,2756,2855,2727,18481
47501,17819,17881,17947,17909,17689,17479,17535,124259
47512,4197,4066,3776,3931,3914,3817,3981,27682
47513,2344,2281,2144,1749,1886,1775,1841,14020
47514,1832,1848,1856,1747,1673,1567,1559,12082
47515,903,862,796,862,962,937,965,6287
47516,1141,1293,1440,1353,1373,1330,1249,9179
47519,585,529,436,275,448,462,513,3248
47520,3032,3145,3350,3147,2972,2913,3267,21826
47521,641,724,806,829,649,729,927,5305
47522,339,274,228,206,262,339,246,1894
47523,3367,3376,3334,3328,3488,3450,3435,23778
47524,380,411,620,544,600,694,605,3854
47525,343,243,217,218,188,291,382,1882
47527,1847,2053,2026,1884,1615,1409,1897,12731
47528,424,540,545,653,692,681,476,4011
47529,1152,1021,859,865,874,873,1042,6686
47531,910,904,758,730,745,749,1004,5800
47532,4603,4903,4895,4906,5046,4974,4627,33954
47535,769,593,473,289,339,349,566,3378
47536,0,0,0,0,23,25,40,88
47537,876,837,735,757,792,986,826,5809
47541,1373,1285,1257,1179,1085,971,1224,8374
47542,9895,9853,9856,9724,9779,9753,9622,68482
47546,20960,20693,20568,20673,21167,21447,21009,146517
47550,899,929,815,662,772,600,854,5531
47551,771,816,853,817,839,870,649,5615
47552,167,183,76,97,104,160,182,969
47553,8643,8677,8555,8545,8560,8245,8495,59720
47557,1522,1498,1378,1320,1345,1420,1432,9915
47558,5043,5017,5084,5307,4977,5187,4406,35021
47561,1309,1301,1087,1393,1594,1895,1588,10167
47562,4295,4295,4341,4237,4259,4141,4658,30226
47564,1629,1667,1631,1829,1702,1419,1352,11229
47567,5944,5837,5726,5621,5588,6001,6021,40738
47568,809,841,892,770,673,730,834,5549
47574,224,223,129,146,120,127,148,1117
47575,1161,1024,955,917,995,932,976,6960
47576,215,208,282,343,359,275,388,2070
47577,1127,1131,928,893,992,1053,1143,7267
47578,850,731,705,696,659,558,776,4975
47579,2717,2715,3053,3034,2896,2902,2659,19976
47580,291,346,468,624,567,547,289,3132
47581,3830,3876,3843,3693,3812,3973,3883,26910
47584,133,155,136,102,135,123,179,963
47585,759,615,627,542,536,626,592,4297
47586,11106,11208,11136,11281,11363,11278,10932,78304
47588,615,579,582,642,601,660,698,4377
47590,368,513,486,539,703,801,713,4123
47591,26403,26578,26997,26995,27040,26887,26770,187670
47596,60,79,84,87,140,125,202,777
47597,1098,1163,1220,1194,932,878,1023,7508
47598,3408,3471,3739,3658,3596,3346,3418,24636
47601,14007,14153,14301,14015,13941,14310,13896,98623
47610,5281,5441,5356,5171,5298,5573,5195,37315
47611,1323,1211,1223,1278,1191,1190,1257,8673
47612,748,909,962,1000,1101,1064,861,6645
47613,2890,2832,2567,2809,2647,2697,2679,19121
47615,1674,1526,1593,1704,1553,1486,1611,11147
47616,248,282,257,339,409,348,364,2247
47619,1816,1599,1708,1538,1449,1339,1696,11145
47620,12692,12695,12796,12834,13216,13152,13427,90812
47630,35620,35297,34894,34898,34483,33479,34423,243094
47631,1928,1661,1733,1818,1931,1962,2042,13075
47633,2731,3031,3079,2671,2592,2606,2542,19252
47634,2306,2327,2320,2207,2298,2135,2382,15975
47635,5543,5593,5765,5896,5898,6095,5671,40461
47637,1403,1446,1523,1601,1415,1329,1507,10224
47638,3736,3628,3347,3474,3117,3187,3577,24066
47639,4220,4201,4321,4445,4424,4303,4069,29983
47640,867,950,1050,1100,1019,1078,1089,7153
47648,4545,4699,4659,4613,4696,4458,4373,32043
47649,1478,1415,1510,1532,1498,1773,1402,10608
47654,39,46,67,104,120,124,70,570
47660,4999,5029,5041,5051,4895,4966,4934,34915
47665,3618,3636,3650,3734,3643,3606,3637,25524
47666,1839,1607,1443,1347,1491,1379,1447,10553
47670,12133,12047,12070,12140,12162,12187,12352,85091
47683,131,139,129,172,151,130,210,1062
47708,283,330,291,323,465,379,439,2510
47710,18998,19058,19381,18968,19288,19297,19527,134517
47711,32198,31709,31648,31638,30806,30741,31457,220197
47712,26736,26744,26955,26654,26603,26613,26012,186317
47713,10283,10202,9934,10221,10367,11187,11032,73226
47714,34994,34871,34448,34523,34114,34369,34107,241426
47715,26718,26970,27255,27039,27313,27029,27063,189387
47720,18177,18232,17960,18245,18111,17475,17413,125613
47725,16779,16694,16478,16001,15805,15358,15851,112966
47802,35224,35171,34488,34260,33880,33534,34532,241089
47803,20835,20152,20817,21614,21258,21198,21102,146976
47804,11309,11337,11692,11487,11312,11084,11020,79241
47805,12423,12385,12670,12457,12891,13139,12852,88817
47807,12426,13258,13085,12814,13189,13111,13045,90928
47809,3051,3087,2871,2827,2761,2684,2687,19968
47832,951,1064,949,997,881,1017,1040,6899
47833,1266,1359,1236,1510,1466,1504,1010,9351
47834,19559,19343,19362,19168,19771,19654,19215,136072
47836,42,38,38,41,0,0,47,206
47837,1055,1088,1358,1382,1139,987,1231,8240
47838,3776,3820,3787,4050,4134,4248,4081,27896
47840,1844,1881,1928,1902,1706,1649,1500,12410
47841,2183,2063,1830,1990,1905,1799,2138,13908
47842,9660,9758,9775,9785,9927,9929,10085,68919
47846,463,492,436,437,558,722,638,3746
47847,1188,1062,1004,1057,875,807,1077,7070
47848,1762,1647,1756,1846,1744,1599,1691,12045
47849,341,424,394,366,296,269,496,2586
47850,2467,2283,2402,2344,2201,2214,2456,16367
47853,100,114,86,97,100,66,134,697
47854,963,1085,1156,1119,1153,1332,849,7657
47855,438,407,483,544,547,599,546,3564
47857,551,546,572,545,583,519,571,3887
47858,618,697,897,1036,1094,1204,698,6244
47859,1253,1323,1365,1438,1600,1430,1066,9475
47860,422,367,332,358,291,304,321,2395
47861,700,575,620,532,387,469,616,3899
47862,1386,1532,1514,1526,1448,1389,1610,10405
47863,217,262,214,240,276,358,205,1772
47865,186,221,335,35,42,87,79,985
47866,501,395,389,250,250,272,347,2404
47868,2735,2927,3138,2897,3042,3356,2937,21032
47869,49,162,159,136,112,192,137,947
47871,136,171,165,179,216,203,220,1290
47872,8667,8321,8098,8166,8220,8703,8890,59065
47874,3195,3505,3749,3608,3236,3578,3414,24285
47876,332,346,380,393,426,496,394,2767
47879,3534,3616,3435,3459,3386,3247,3302,23979
47880,97,97,88,94,11,11,67,465
47881,386,456,378,471,482,472,465,3110
47882,8016,8316,8092,8180,8474,8568,8430,58076
47884,134,121,149,222,178,201,229,1234
47885,8934,8977,8970,8935,9068,8964,9009,62857
47901,3649,3570,3471,3258,3489,3588,3518,24543
47904,16940,16713,16192,15475,15033,15478,16277,112108
47905,41176,40834,41010,40910,40191,39375,38910,282406
47906,71987,70917,69529,68328,67388,66392,66972,481513
47907,0,0,0,0,0,0,0,0
47909,41272,40814,40015,40068,39902,38907,39373,280351
47916,57,53,59,36,77,67,64,413
47917,483,475,519,502,509,602,491,3581
47918,5685,5759,5874,5742,6027,6105,6321,41513
47920,2280,2131,2187,2181,2276,2483,2414,15952
47921,1123,1102,1066,1093,1148,1048,1078,7658
47922,1417,1439,1559,1547,1676,1711,1623,10972
47923,3507,3519,3672,3577,3518,3510,3494,24797
47924,154,157,179,176,205,162,141,1174
47925,245,256,226,324,395,432,203,2081
47926,1124,892,954,932,1031,1125,1097,7155
47928,1872,1803,1867,1903,1960,2055,2047,13507
47929,714,661,658,678,694,803,774,4982
47930,1264,1295,1208,1021,1069,1071,1094,8022
47932,5259,5235,5380,5381,5436,5429,5357,37477
47933,27886,27943,27929,28124,28036,28402,27937,196257
47940,1592,1385,1403,1428,1226,1317,1433,9784
47941,1455,1391,1386,1164,1002,929,1300,8627
47942,721,749,734,684,681,663,660,4892
47943,1084,1284,1040,995,1007,970,932,7312
47944,3577,3474,3538,3493,3431,3389,3623,24525
47946,2218,2018,2158,1889,1915,1950,2044,14192
47948,1379,1408,1336,1464,1511,1612,1359,10069
47949,1517,1602,1600,1716,1660,1492,1332,10919
47950,877,952,1063,1003,1027,971,912,6805
47951,2282,2291,2336,2055,2130,2101,2252,15447
47952,2989,2880,2807,2685,2722,2764,2798,19645
47954,2548,2474,2496,2446,2485,2243,2220,16912
47955,950,1057,1086,1114,1220,1071,1088,7586
47957,1900,1884,1913,2162,2310,2161,1894,14224
47958,237,228,210,230,198,204,209,1516
47959,2767,2846,2867,2813,2718,2793,2822,19626
47960,14907,14924,14617,15021,14945,14960,15003,104377
47963,1799,1797,1920,2030,2005,1913,1949,13413
47964,136,116,128,129,165,132,122,928
47965,494,546,640,645,771,757,646,4499
47966,419,469,410,466,475,504,461,3204
47967,704,738,896,924,976,884,772,5894
47968,922,752,655,657,652,767,982,5387
47969,132,183,177,134,144,146,145,1061
47970,2198,2265,2148,2097,2078,2109,2034,14929
47971,1878,2032,1996,1982,1957,1937,1865,13647
47974,1238,1188,1234,1242,1253,1137,1186,8478
47975,511,534,490,457,491,547,653,3683
47977,2160,1945,2287,2256,2312,2175,2206,15341
47978,11500,11172,11008,11622,11491,11673,11793,80259
47980,1013,1170,1196,1115,1251,1122,1096,7963
47981,815,927,826,934,1060,933,849,6344
47982,163,165,133,123,110,115,143,952
47983,412,416,254,457,343,403,347,2632
47987,3882,3836,3870,3939,3802,3918,4049,27296
47989,1538,1484,1416,1386,1363,1137,1281,9605
47990,1570,1820,1681,1571,1439,1507,1627,11215
47991,1169,1213,1017,1112,1134,1084,1070,7799
47992,1795,1457,1657,1391,1217,1260,1465,10242
47993,3691,3865,4116,4308,4297,4169,3918,28364
47994,326,358,310,335,304,351,476,2460
47995,1715,1554,1606,1510,1469,1534,1743,11131
47997,138,137,119,117,106,106,139,862
48001,11840,11860,11865,11924,12075,12192,11986,83742
48002,3236,3231,3246,3257,3286,3297,3285,22838
48003,6035,5911,5823,5850,5951,5951,6070,41591
48005,5471,5433,5407,5402,5390,5404,5379,37886
48006,3975,3913,3927,3988,4049,3932,4007,27791
48009,20653,20489,20382,20241,20153,20037,20107,142062
48014,4224,4457,4492,4470,4410,4381,4256,30690
48015,8313,8306,8279,8272,8289,8339,8257,58055
48017,11982,11979,11943,11913,11885,11932,11805,83439
48021,32576,32515,32481,32405,32454,32618,32353,227402
48022,2605,2618,2620,2636,2647,2652,2654,18432
48023,5083,5087,5072,5135,5250,5409,5178,36214
48025,14762,14687,14616,14576,14610,14593,14543,102387
48026,14620,14582,14544,14529,14563,14620,14480,101938
48027,3201,3208,3227,3229,3243,3237,3249,22594
48028,1081,1101,1147,1175,1158,1215,1190,8067
48030,16587,16600,16532,16528,16579,16703,16422,115951
48032,2196,2360,2467,2276,2237,2272,2322,16130
48033,16420,16322,15976,16553,16258,16481,16064,114074
48034,13348,13807,13997,13463,13296,13095,12590,93596
48035,35101,34704,34367,34439,34667,34695,34788,242761
48036,21830,21795,21271,21314,21240,21184,20980,149614
48038,42287,42074,42221,41711,41391,41321,41057,292062
48039,7667,7679,7718,7756,7817,7935,7807,54379
48040,9775,9797,9842,9894,9933,10005,9956,69202
48041,4535,4569,4558,4421,4392,4426,4561,31462
48042,29413,28756,28195,27708,26680,25850,27291,193893
48043,16377,16372,16338,16352,16345,16455,16305,114544
48044,55783,54986,54009,52927,52258,51027,52289,373279
48045,24907,24817,24754,24706,24680,24728,24604,173196
48047,40290,40012,39681,39280,39232,38375,39415,276285
48048,7193,7243,8008,8166,8225,8201,7548,54584
48049,5480,5490,5515,5531,5563,5612,5582,38773
48050,2068,1958,1823,1614,1430,1365,1653,11911
48051,17741,17683,17014,17027,16634,16952,17319,120370
48054,7205,7231,7264,7309,7321,7363,7339,51032
48059,15008,15020,15072,15108,15098,15169,15123,105598
48060,39830,39975,40055,40361,40784,41156,40831,282992
48062,9539,9442,9389,9464,9409,9416,9373,66032
48063,4006,4009,4020,4058,4090,4152,4070,28405
48064,4058,4048,4069,4093,4151,4212,4107,28738
48065,11041,11007,10745,10661,10593,10516,10547,75110
48066,47678,47599,47453,47499,47542,47743,47388,332902
48067,25017,25210,25366,24944,24457,24760,24458,174212
48069,2562,2555,2544,2539,2541,2531,2526,17798
48070,6330,6333,6310,6280,6236,6231,6238,43958
48071,30168,30123,30028,29933,29854,29850,29694,209650
48072,15239,15178,15135,15089,15034,15037,14970,105682
48073,33832,33488,33017,33123,33321,32850,32798,232429
48074,9179,9202,9259,9287,9313,9354,9356,64950
48075,21651,21372,21238,21246,21684,21809,21790,150790
48076,25825,25567,25456,25276,25141,25215,25386,177866
48079,12122,12122,12185,12232,12307,12378,12304,85650
48080,22386,22301,22353,22798,23019,23148,22494,158499
48081,20867,20804,20773,20839,20700,20610,20635,145228
48082,16626,16738,16719,16180,16225,16503,16549,115540
48083,23002,23307,23671,23305,23265,23005,22507,162062
48084,15655,15254,14573,14689,14440,14433,14231,103275
48085,24963,24931,24410,24292,24362,24402,24660,172020
48088,22255,23110,22766,22844,22953,22850,22255,159033
48089,30923,31049,30929,29960,30197,30854,31978,215890
48091,31074,30142,30505,31746,31229,31060,31106,216862
48092,26946,26914,26741,26516,26508,26214,25680,185519
48093,23871,23642,23457,23310,23663,24120,23037,165100
48094,18807,18562,18446,18424,17730,17316,18028,127313
48095,5327,5182,5115,4778,4906,4975,4906,35189
48096,3953,3923,3870,3830,3810,3748,3739,26873
48097,5197,5203,5253,5278,5249,5428,5499,37107
48098,19362,19050,19452,19414,19240,19201,19582,135301
48101,27519,27622,27814,27933,28072,28278,28200,195438
48103,54120,53840,54769,54593,54256,53874,53057,378509
48104,41352,40528,39381,39125,39094,39109,38315,276904
48105,35754,34711,34189,33729,33127,32898,33905,238313
48108,26457,26249,26402,26657,26549,26395,26164,184873
48109,5435,5722,6618,6878,7585,7970,6904,47112
48111,41560,42062,42026,42081,42366,42089,42313,294497
48114,20756,20600,20555,20575,20406,20593,19702,143187
48116,27156,26624,26556,26103,25969,25909,26432,184749
48117,9847,10018,10145,10049,10328,10386,10124,70897
48118,12755,12563,12761,12562,12494,12484,12552,88171
48120,7516,7605,7350,7454,7388,7509,8274,53096
48122,10437,10564,10639,10661,10676,10759,10727,74463
48124,29575,30513,30529,30922,32356,31856,31732,217483
48125,20344,19755,20056,20241,20569,20951,21273,143189
48126,47789,47217,47986,48100,47394,47990,47465,333941
48127,35985,36901,37007,37050,36885,36818,36501,257147
48128,10640,10734,10874,10664,10371,10658,10682,74623
48130,15554,15486,15209,14627,14580,13793,14420,103669
48131,6733,6605,6539,6303,6501,6589,6764,46034
48133,5860,5753,5808,5560,5516,5577,5753,39827
48134,21223,20433,20775,20868,20718,20598,21408,146023
48135,27001,27155,27349,27499,27639,27903,27665,192211
48137,5249,5164,4715,4872,4688,4575,4796,34059
48138,10161,10209,10264,10294,10354,10414,10371,72067
48139,140,139,113,264,248,239,206,1349
48140,3425,3454,3472,3303,3088,2938,3095,22775
48141,24738,24897,25056,25215,25455,25854,25366,176581
48143,0,0,0,0,0,0,32,32
48144,9649,9757,9882,10164,10301,10256,9952,69961
48145,3385,3477,3559,3398,3561,3683,3503,24566
48146,37037,37243,37458,37651,37836,38265,38098,263588
48150,25905,26558,26958,27327,27241,26750,27127,187866
48152,31172,30843,30998,30840,31060,31713,31173,217799
48154,37772,37911,37932,38066,38331,38751,38642,267405
48157,1395,1341,1397,1405,1454,1388,1436,9816
48158,7562,7594,7792,7760,7486,7463,7309,52966
48159,2505,2544,2484,2422,2304,2508,2582,17349
48160,13375,13542,13519,13640,13842,14399,13785,96102
48161,26469,26546,26712,27201,27035,27120,26470,187553
48162,28300,28453,28721,28592,28861,28982,29344,201253
48164,8720,8948,9171,9477,9755,9598,9175,64844
48165,6799,6353,6224,5886,5888,5754,6339,43243
48166,11480,11472,11302,11482,11473,11368,11569,80146
48167,21982,21780,22193,21911,22089,22085,21534,153574
48168,21798,22001,21971,22320,22004,21405,21781,153280
48169,21047,21142,20968,20880,20698,21086,20813,146634
48170,39352,39512,39628,39578,39459,39751,39963,277243
48173,12481,12559,12647,12745,12515,12492,12700,88139
48174,31267,31251,31602,31719,31558,31248,31515,220160
48176,22433,21937,21443,20923,20443,20375,21447,149001
48177,271,277,224,267,302,244,218,1803
48178,32362,31513,30288,29815,29729,29173,29320,212200
48179,3763,3515,3374,3351,3215,3069,3274,23561
48180,61716,62021,62331,62592,62916,63332,63131,438039
48182,21175,21430,21281,21455,21579,21732,21708,150360
48183,42374,42943,42789,42277,42225,42434,43182,298224
48184,17143,17251,17341,17447,17585,17801,17643,122211
48185,48027,48329,47872,47787,47519,47031,47618,334183
48186,34199,34319,35323,35689,36251,37235,36506,249522
48187,48278,48286,48113,48028,47914,48049,49148,337816
48188,41373,41231,41559,41460,41190,40572,41025,288410
48189,13865,13800,13979,13582,13414,13965,13632,96237
48190,72,64,62,82,56,41,107,484
48191,4093,4056,4014,3736,3781,3543,4054,27277
48192,25225,25376,25470,25621,25839,26073,25883,179487
48193,15288,15342,15260,15398,15520,15813,15623,108244
48195,29355,29518,29710,29800,29879,30035,30047,208344
48197,66915,65545,63357,62684,61339,60495,61132,441467
48198,38191,37970,37879,38095,37995,38356,38186,266672
48201,14045,13049,12465,11748,11033,10347,12814,85501
48202,16762,16696,16227,15866,16265,16368,16603,114787
48203,23498,25027,25134,26861,28577,29682,28409,187188
48204,25096,25637,26692,27227,28011,28394,27997,189054
48205,35925,36834,37556,38688,41947,44083,44045,279078
48206,18049,18424,19383,21182,22436,23046,21954,144474
48207,21832,21455,21828,20439,20085,19805,20252,145696
48208,9180,9327,9413,9997,10084,9968,10234,68203
48209,32879,34411,33590,33446,34583,35164,32262,236335
48210,30948,31557,31881,31895,31141,29903,31017,218342
48211,6536,6833,6372,6175,6318,7392,7082,46708
48212,38133,38329,38046,39369,39592,39992,39038,272499
48213,24137,25534,26745,27981,28729,29031,27712,189869
48214,21805,20867,20646,22286,22673,21663,22759,152699
48215,12180,12663,12606,13364,14568,14998,13565,93944
48216,5600,5712,5169,5556,5117,4841,5645,37640
48217,7252,7478,7701,7723,8159,8887,8210,55410
48218,7609,7673,7761,7857,7951,8081,7903,54835
48219,49326,48759,47476,47821,48391,50947,46931,339651
48220,22646,22598,22809,22773,22761,22838,22319,158744
48221,39611,39836,39766,39455,40152,41902,38727,279449
48223,24323,24122,24221,24321,24185,26351,25336,172859
48224,42361,41935,44420,44877,45296,46612,44439,309940
48225,14294,14556,14698,14692,14532,14680,14554,102006
48226,6406,6027,5522,5370,5232,5002,5302,38861
48227,41571,42106,43639,45214,47007,48604,45380,313521
48228,52342,52243,52336,52191,53145,54172,52130,368559
48229,9388,9457,9591,9625,9707,9722,9556,67046
48230,16532,16638,16762,16860,16920,17077,16976,117765
48233,0,0,0,0,0,0,0,0
48234,34083,34368,34862,35769,36211,37483,36140,248916
48235,45101,45705,45979,46368,46133,46977,45063,321326
48236,29968,30316,30539,30358,30528,30517,30607,212833
48237,29751,29727,29622,29573,29523,29663,29319,207178
48238,29181,29865,30683,31109,33116,34113,31743,219810
48239,35711,35825,35711,36245,35738,35793,35524,250547
48240,17568,17615,17671,17212,17649,17837,17722,123274
48242,0,0,0,0,0,0,0,0
48243,0,0,0,0,0,0,0,0
48301,14572,14319,14228,14104,13839,13832,14127,99021
48302,15203,15520,15414,15155,15240,15754,15360,107646
48304,16687,16434,16395,16667,16652,16367,16009,115211
48306,27936,28195,27836,27177,27433,27466,26691,192734
48307,43014,42417,41196,40878,40691,40219,41369,289784
48309,28999,29082,29839,29555,28838,29079,29135,204527
48310,43944,43370,43519,43399,42868,43215,42766,303081
48312,33491,33227,32834,32499,32955,33227,32720,230953
48313,33594,33365,33553,33692,33599,33178,33952,234933
48314,20610,21129,20654,20570,20465,20116,20245,143789
48315,27248,27016,26982,26719,26766,26442,26563,187736
48316,27020,26710,26386,25854,25543,25037,25404,181954
48317,27435,27102,26601,26694,26275,26507,26610,187224
48320,4596,4553,4391,4415,4390,4437,4589,31371
48322,32766,32728,32478,31947,31532,31059,31265,223775
48323,17661,17782,17536,17664,17373,17183,17708,122907
48324,17235,17049,17026,17010,17393,17722,17350,120785
48326,21115,20994,20589,21025,20988,20605,20298,145614
48327,21824,22397,22870,22185,22026,22037,21559,154898
48328,26011,25434,24698,25223,25142,24932,24960,176400
48329,25338,24990,24911,24526,24489,24571,25009,173834
48331,21220,21252,21616,22184,21913,21671,21503,151359
48334,18867,18535,18272,17506,16966,16426,18540,125112
48335,22486,22667,22765,22323,23001,23649,22398,159289
48336,26716,26679,26325,26619,26516,26508,25486,184849
48340,25862,25804,25371,25577,25089,25104,24307,177114
48341,17350,17701,17112,16790,16937,17569,17139,120598
48342,17060,16823,17655,17854,18541,18153,18407,124493
48346,23009,23070,23047,22888,22823,22682,22567,160086
48348,23017,23300,23000,23263,23376,23474,23387,162817
48350,7420,7380,7136,7201,6989,6869,7100,50095
48353,6372,6583,6494,6444,6345,6267,6481,44986
48356,8585,8386,8319,8405,8366,8361,8407,58829
48357,8414,8438,8832,8649,8488,8325,8170,59316
48359,9128,8559,8148,7882,7784,7800,8044,57345
48360,11847,11888,11713,11863,11847,11882,11651,82691
48362,16073,16080,15743,15439,15431,14901,15141,108808
48363,5772,5468,5333,4842,4776,4393,4978,35562
48367,4397,4544,4634,4637,4584,4570,4727,32093
48370,2130,2012,1880,1844,1788,1778,1685,13117
48371,23905,23311,23061,22826,22187,22247,23155,160692
48374,15386,15316,14863,14359,14229,13895,14049,102097
48375,23211,22613,22437,22189,21461,20884,21801,154596
48377,15702,15858,15810,15529,15165,15324,15244,108632
48380,7175,7370,7171,7388,7244,7342,7404,51094
48381,13315,13136,12868,12800,12677,12565,12605,89966
48382,22596,22266,22153,21683,21532,21593,21945,153768
48383,13414,13272,12956,12279,12534,12282,12701,89438
48386,17489,17581,17669,18081,17579,17630,17434,123463
48390,23484,23390,23370,23246,23002,22535,22898,161925
48393,16750,16765,16445,16560,16512,16338,16111,115481
48397,0,0,0,0,0,0,0,0
48401,1628,1536,1526,1662,1710,1707,1439,11208
48411,90,86,65,34,81,61,156,573
48412,5637,5859,5901,5792,5662,5647,5682,40180
48413,7296,7269,7315,7502,7478,7651,7551,52062
48414,2841,2960,3081,2946,2986,2898,2492,20204
48415,9265,9068,9349,9639,9707,9878,9471,66377
48416,4884,4940,4833,4986,4976,5080,5002,34701
48417,2755,2862,2751,2741,2830,2770,2983,19692
48418,4039,4356,4386,4387,4573,4728,4312,30781
48419,2360,2409,2633,2636,2716,2669,2740,18163
48420,21553,21645,21778,22100,21868,22386,22078,153408
48421,6294,6280,6404,6836,6800,6956,6647,46217
48422,6427,6551,6242,6068,6147,6465,6400,44300
48423,31869,31967,32057,32169,32457,32578,32708,225805
48426,957,1008,979,993,1079,1069,1022,7107
48427,2797,2728,2864,2854,3001,2968,2879,20091
48428,5029,4860,4803,4920,5044,5122,5027,34805
48429,8322,7939,7954,8127,8403,8597,8944,58286
48430,37299,37261,37156,36202,36668,36494,36738,257818
48432,668,651,716,667,646,689,636,4673
48433,26288,26245,26275,26450,26551,26290,26497,184596
48434,65,61,59,63,68,74,104,494
48435,2051,2142,2146,1964,1934,1850,2083,14170
48436,3596,3573,3728,3723,3707,3610,3764,25701
48437,617,625,519,424,392,376,581,3534
48438,7221,7448,7140,7063,6975,7276,6951,50074
48439,47164,47467,48036,48594,48992,49098,49209,338560
48440,290,281,579,396,395,380,157,2478
48441,3861,3859,3848,3933,3930,4077,4085,27593
48442,20799,21243,21311,21401,21404,20828,20669,147655
48444,9361,9235,9165,9151,9276,9352,9327,64867
48445,1397,1331,1381,1381,1380,1366,1370,9606
48446,30447,30402,30540,30843,30874,31296,30749,215151
48449,2811,2874,2675,2990,2922,2968,3147,20387
48450,4830,4722,4775,4630,4719,4690,4780,33146
48451,14378,14317,14358,15056,14672,14378,14767,101926
48453,5021,4893,4953,5149,5107,5234,5146,35503
48454,1216,1273,1300,1337,1424,1302,1324,9176
48455,8442,8323,8250,8224,8021,7891,7974,57125
48456,786,836,807,887,935,918,858,6027
48457,8284,8304,8306,8150,8519,8606,8436,58605
48458,19618,20924,21178,21631,21737,21882,20538,147508
48460,2292,2172,2204,2331,2302,2376,2330,16007
48461,8458,8452,8634,8556,8917,8832,8428,60277
48462,13968,13723,13671,13425,13702,13766,13266,95521
48463,4498,4465,4224,4331,4216,4266,4627,30627
48464,2128,2197,2161,2019,2003,2084,2231,14823
48465,690,618,602,544,589,536,629,4208
48466,1632,1642,1737,1796,1615,1592,1578,11592
48467,2306,2400,2431,2327,2286,2258,2337,16345
48468,1189,1282,1423,1440,1371,1351,1294,9350
48469,1144,1168,1144,1175,1166,1199,1245,8241
48470,809,785,749,794,797,749,784,5467
48471,5197,5349,5445,5640,5765,5776,5745,38917
48472,1960,1900,1941,1964,1903,1997,1912,13577
48473,21631,21485,22243,22030,21778,22349,22507,154023
48475,2470,2532,2604,2527,2629,2667,2766,18195
48476,562,715,790,741,668,646,577,4699
48502,1142,1022,1088,1068,1091,1066,1164,7641
48503,25902,25899,25428,24866,25180,25619,25168,178062
48504,28303,28412,29510,30615,30329,31585,30926,209680
48505,21231,21938,22416,23343,25258,25824,25710,165720
48506,29168,29153,29319,29071,30181,30685,30019,207596
48507,32425,31877,31359,31512,30974,30958,30607,219712
48509,8858,9262,9526,9889,9973,10312,9470,67290
48519,7493,7518,7813,7771,7758,7548,7465,53366
48529,10117,9904,9543,9426,9487,9456,10271,68204
48532,19709,19999,20052,19689,20014,20424,19375,139262
48551,0,0,0,0,0,0,0,0
48553,0,0,0,0,0,0,0,0
48554,0,0,0,0,0,0,0,0
48601,35986,36537,36939,38232,38877,39371,38406,264348
48602,30589,30658,30369,29833,29656,29730,30119,210954
48603,26608,26592,26703,26593,26802,26772,26913,186983
48604,13348,13230,13108,13217,13083,13095,13074,92155
48607,1236,1305,1584,1392,1628,1813,1774,10732
48609,11821,11965,12019,11952,12157,12239,12461,84614
48610,2873,2918,3283,3071,3298,3423,3083,21949
48611,6633,6903,6846,6937,7085,7089,6554,48047
48612,8927,8959,9130,9335,9248,9443,9259,64301
48613,1096,1221,1098,1108,1121,1092,1158,7894
48614,1511,1466,1410,1375,1387,1318,1376,9843
48615,2844,2975,3022,3112,3168,3191,3058,21370
48616,7348,7430,7564,7459,7575,7440,7513,52329
48617,8433,8487,8538,8612,8803,9037,8857,60767
48618,5492,5514,5555,5521,5624,5428,5393,38527
48619,515,483,433,390,420,353,465,3059
48621,1285,1242,1231,1195,1167,1077,1359,8556
48622,6469,6364,6432,6251,6254,6489,6491,44750
48623,14055,14010,14032,14018,13663,13479,13993,97250
48624,15756,16116,16075,16032,16052,15947,15810,111788
48625,13163,13225,13256,13593,13642,13558,13152,93589
48626,5852,5973,5982,6105,6113,6204,6078,42307
48627,134,128,115,99,111,95,141,823
48628,2177,2041,2041,2020,1993,1933,1938,14143
48629,7615,7688,7720,7857,7691,7873,7854,54298
48630,37,9,84,121,144,147,69,611
48631,4456,4436,4386,4568,4526,4402,4643,31417
48632,5031,5089,5015,4778,4902,4851,5125,34791
48633,159,140,163,241,236,203,210,1352
48634,4255,4447,4493,4406,4607,4736,4371,31315
48635,1563,1564,1526,1640,1676,1740,1573,11282
48636,766,906,894,881,831,777,864,5919
48637,3326,3320,3384,3308,3181,3253,3359,23131
48638,12492,12784,12890,13161,12980,13194,12922,90423
48640,33374,33253,32328,32054,32229,32563,32690,228491
48642,31861,31826,32626,32933,32792,32372,32277,226687
48647,4327,4289,4475,4562,4602,4930,4420,31605
48649,1413,1459,1420,1439,1569,1626,1576,10502
48650,7415,7115,7125,7115,6894,6651,7253,49568
48651,4736,4752,4845,4789,4787,4773,4690,33372
48652,1676,1556,1482,1450,1517,1592,1548,10821
48653,9868,9810,9732,9901,10293,10392,10293,70289
48654,2260,2267,2351,2350,2393,2347,2521,16489
48655,6017,6120,6321,6327,6304,6393,6460,43942
48656,3926,3993,4119,4104,4144,4220,4058,28564
48657,7735,7855,7953,8002,7918,8006,7981,55450
48658,4969,5054,5205,5417,5578,5914,5138,37275
48659,2875,2942,2957,2781,2686,2555,2850,19646
48661,10359,10335,10067,10062,10210,10213,10691,71937
48662,1629,1506,1542,1464,1489,1510,1594,10734
48667,0,0,0,0,0,0,0,0
48701,1431,1374,1334,1328,1306,1420,1368,9561
48703,3063,3032,2952,3020,3058,3040,3238,21403
48705,489,509,460,461,435,449,535,3338
48706,39637,40199,40153,40208,40144,40564,40596,281501
48708,26956,27106,27243,27205,27493,27147,27262,190412
48710,0,0,0,0,0,0,0,0
48720,980,1057,1056,1066,1055,1108,1042,7364
48721,429,418,342,365,366,364,411,2695
48722,3217,3254,3350,3255,3234,3100,3123,22533
48723,12155,12283,12405,12431,12156,12126,12479,86035
48724,214,267,266,372,266,297,359,2041
48725,2203,2370,2424,2434,2575,2329,2464,16799
48726,5951,6228,6229,6270,6417,6556,6172,43823
48727,1314,1248,1281,1344,1304,1259,1269,9019
48728,336,319,311,319,315,281,290,2171
48729,1580,1658,1586,1539,1540,1451,1586,10940
48730,4432,4410,4434,4543,4504,4582,4716,31621
48731,1674,1768,1801,1718,1799,1820,1683,12263
48732,11116,11064,11210,11377,11581,11819,11483,79650
48733,1648,1651,1590,1752,1889,2037,1758,12325
48734,7740,7604,7601,7643,7729,7673,7444,53434
48735,893,1010,905,912,960,1142,1051,6873
48737,1224,1204,1224,1258,1287,1392,1245,8834
48738,1203,1297,1319,1290,1267,1199,1269,8844
48739,3838,3913,4091,4165,4302,4287,4043,28639
48740,2274,2346,2384,2454,2528,2627,2556,17169
48741,2005,1989,2123,2113,2165,2287,2086,14768
48742,1681,1563,1551,1505,1620,1664,1647,11231
48743,83,80,29,11,3,4,63,273
48744,4301,4527,4503,4572,4786,4854,4615,32158
48745,1246,1320,1374,1481,1419,1356,1346,9542
48746,8701,8762,8672,8653,8751,8311,8528,60378
48747,1365,1355,1444,1404,1454,1573,1494,10089
48748,1767,1641,1847,1706,1836,1897,1693,12387
48749,911,937,1008,1038,1090,1137,1094,7215
48750,8577,8636,8569,8667,8731,8739,8846,60765
48754,985,940,852,913,928,913,1001,6532
48755,3230,3051,3024,3045,3124,3060,3110,21644
48756,4715,4720,4588,4780,4606,4473,4640,32522
48757,3664,3735,3795,3929,3946,3976,3817,26862
48759,3163,3174,3187,3249,3277,3320,3293,22663
48760,1441,1375,1148,1262,1274,1356,1351,9207
48761,920,953,956,960,1008,1105,1026,6928
48762,1179,1163,1203,1103,1133,1119,1139,8039
48763,5185,5168,5075,5370,5355,5422,5012,36587
48765,739,662,675,650,722,682,725,4855
48766,1324,1415,1399,1419,1326,1281,1270,9434
48767,1925,1857,2057,2080,2210,2258,2162,14549
48768,9490,9367,9641,9651,9794,9931,9832,67706
48770,1893,1965,2119,1980,1972,2164,1891,13984
48801,12836,12945,12954,13118,13114,13184,12923,91074
48806,1502,1645,1686,1697,1698,1675,1676,11579
48807,768,753,828,836,800,769,916,5670
48808,5272,5716,5818,5707,5769,5650,5178,39110
48809,10861,10690,10715,10848,11041,11307,11015,76477
48811,5376,5488,5517,5655,5602,5556,5641,38835
48813,21433,21468,21181,21058,21121,21041,21182,148484
48815,2221,2216,2304,2197,2438,2271,2259,15906
48816,90,70,82,67,31,44,121,505
48817,6254,6362,6364,6397,6597,6365,6422,44761
48818,2503,2441,2389,2287,2220,2148,2407,16395
48819,2718,2811,2690,2842,2763,2882,2701,19407
48820,17842,17483,17321,17032,17227,17290,16641,120836
48821,5969,5898,5790,5763,5862,5906,5836,41024
48822,2990,2992,2905,2934,2666,2604,2714,19805
48823,50531,51070,50081,49813,48961,48480,51302,350238
48825,12928,12586,13230,13696,14344,14691,12596,94071
48827,15972,15931,16151,16134,16063,15927,15971,112149
48829,3034,3133,3156,3212,3309,3321,3254,22419
48831,3686,3610,3509,3438,3473,3375,3512,24603
48832,1398,1349,1297,1222,1234,1349,1393,9242
48834,2032,2114,2202,2188,2207,2460,2090,15293
48835,2906,2633,2569,2581,2691,2571,2680,18631
48836,13748,13648,13843,13825,13600,13767,13510,95941
48837,19439,19216,19073,18829,18511,18343,18926,132337
48838,18016,17925,17909,17928,17774,17870,17863,125285
48840,13150,13232,13308,12939,12952,12517,12501,90599
48841,830,944,962,1026,936,979,826,6503
48842,21061,20487,20470,20285,20297,20079,20432,143111
48843,44635,44113,43858,43397,43422,43400,42931,305756
48845,1040,1035,939,996,940,1000,1003,6953
48846,19827,20178,20157,20655,20611,20721,20269,142418
48847,6083,5941,5824,5763,5886,5957,6041,41495
48848,7479,7413,7470,7589,7306,7257,7789,52303
48849,5952,5649,5787,5593,5727,5655,5717,40080
48850,4371,4243,4207,4215,4460,4496,4474,30466
48851,2260,2348,2515,2493,2621,2597,2365,17199
48852,128,133,104,75,75,57,150,722
48853,737,718,659,676,594,588,671,4643
48854,19050,18835,18609,18616,18277,18355,18598,130340
48855,14633,14750,14251,14112,14251,14049,14752,100798
48856,838,849,977,962,938,912,966,6442
48857,2806,2778,2663,2678,2489,2647,2453,18514
48858,49990,49969,49669,49502,49470,49379,50025,348004
48860,1507,1363,1283,1271,1238,1179,1334,9175
48861,1558,1671,1763,1606,1652,1622,1522,11394
48864,21914,21205,20729,20058,19547,19900,20148,143501
48865,1961,1900,1768,1692,1693,1769,1903,12686
48866,4950,4841,4894,4999,5076,4899,4851,34510
48867,27375,27412,27636,27713,27928,28354,28264,194682
48870,186,145,159,164,190,181,148,1173
48871,2054,2135,2132,1976,2001,1912,1952,14162
48872,7256,7071,7408,7280,7534,7572,7840,51961
48873,1526,1543,1550,1613,1443,1663,1615,10953
48874,118,196,199,212,268,217,180,1390
48875,10640,10561,10511,10558,10458,10427,10186,73341
48876,3838,3966,3992,3956,3966,4024,4014,27756
48877,2508,2537,2474,2450,2521,2630,2392,17512
48878,1579,1422,1592,1550,1645,1538,1677,11003
48879,17934,18190,18468,18240,18143,18340,18075,127390
48880,10059,10137,10309,10554,10531,10551,10669,72810
48881,5733,5671,5360,5042,5151,5180,5501,37638
48883,7214,7285,7452,7364,7303,7227,7122,50967
48884,4289,4250,4218,4514,4429,4569,4427,30696
48885,902,922,886,937,1051,802,927,6427
48886,2061,2034,2062,2203,2128,2178,2116,14782
48888,6035,6403,6483,6139,6316,6536,6366,44278
48889,1278,1299,1258,1364,1444,1466,1322,9431
48890,1999,2102,2096,1945,1933,2030,2152,14257
48891,2928,2858,3063,3130,2987,2790,2985,20741
48892,4799,4633,4629,4661,4597,4416,4382,32117
48893,5290,5344,5333,5472,5412,5399,5212,37462
48894,1932,1932,1990,2030,2083,1965,2059,13991
48895,11194,11277,11291,11299,11490,11275,11189,79015
48896,226,254,210,138,179,133,154,1294
48897,1487,1365,1463,1505,1652,1474,1525,10471
48906,26115,26720,26047,25641,25729,25708,26634,182594
48910,35338,35306,35520,35218,35035,34503,34560,245480
48911,39063,39605,39303,39922,40732,41602,40111,280338
48912,17646,17459,18093,17931,17665,18030,17035,123859
48915,9580,8537,8520,8870,8759,8451,9218,61935
48917,32205,32240,32134,32082,32142,32135,32062,225000
48921,0,0,0,0,0,0,0,0
48933,2392,2694,2610,2478,2506,2825,2530,18035
49001,22552,22038,21874,22581,22219,21883,22095,155242
49002,20584,20112,19257,19528,19581,19001,18786,136849
49004,15828,15620,15602,15575,15613,15640,15645,109523
49006,28517,28350,27959,26908,26733,26845,26455,191767
49007,10441,10539,10245,10208,9509,9320,10762,71024
49008,16182,16404,16828,16599,17500,17812,16186,117511
49009,44653,44208,43972,43385,42595,41664,42362,302839
49010,17523,17856,17628,17741,17558,17725,17374,123405
49011,2172,2182,2114,2151,2187,2274,2285,15365
49012,3246,3302,3227,3389,3346,3351,3339,23200
49013,5560,5394,5218,4890,4785,4722,5508,36077
49014,21386,21307,21957,21546,22088,22011,22127,152422
49015,26920,26715,26055,26378,26684,27051,26782,186585
49017,21947,21486,21059,21560,20243,20298,20785,147378
49021,6514,6363,6296,6236,6053,5954,6182,43598
49022,31498,31611,31799,31647,31782,31982,31814,222133
49024,28651,28584,29089,28561,28190,28414,28552,200041
49026,2364,2564,2187,2396,2289,2292,2186,16278
49027,148,136,123,114,106,102,161,890
49028,6422,6464,6620,6438,6164,6384,6387,44879
49029,1535,1585,1635,1708,1628,1507,1606,11204
49030,2693,2552,2488,2356,2367,2364,2523,17343
49031,7469,7460,7526,7658,7507,7601,7884,53105
49032,3263,3358,3463,3726,3753,3835,3105,24503
49033,1452,1758,1794,1931,2127,2298,1760,13120
49034,2596,2603,2511,2142,2129,2185,2389,16555
49036,23380,23281,23316,23706,24311,25169,24868,168031
49037,21337,21707,22551,22204,22581,22460,22576,155416
49038,9193,9029,9134,9091,9005,9078,9310,63840
49040,3137,3263,3224,3311,3285,3374,3388,22982
49042,4710,4568,4470,4507,4614,4762,4892,32523
49043,2501,2780,2957,2806,2719,2696,2462,18921
49045,5253,5532,5519,5826,6087,6123,5598,39938
49046,7606,7466,7086,7201,7352,7658,7281,51650
49047,14238,14637,14646,14493,14851,14896,14805,102566
49048,25352,25857,26019,25434,25399,25114,25432,178607
49050,1457,1548,1559,1337,1697,1781,1557,10936
49051,2755,2872,2674,2747,2704,2691,2436,18879
49052,890,904,1006,1038,1160,1152,975,7125
49053,7073,6793,6659,6724,6648,6408,7028,47333
49055,6172,5906,6006,6079,6368,6410,6276,43217
49056,3449,3587,4192,4296,4481,4659,4016,28680
49057,6982,6888,6909,7145,6930,6930,6795,48579
49058,19036,19012,18988,19031,19009,19116,19127,133319
49060,1800,1898,1994,1898,1978,1932,1738,13238
49061,1661,1656,1613,1527,1355,1449,1622,10883
49064,3623,3689,3753,3698,3676,3696,3717,25852
49065,6431,6358,6641,6643,6745,6816,6662,46296
49066,665,705,611,549,564,627,722,4443
49067,4406,4347,4214,4446,4682,4612,4522,31229
49068,14584,14427,14613,14415,14424,14200,14646,101309
49070,2405,2487,2472,2451,2500,2506,2451,17272
49071,9632,9585,9199,8710,9239,9205,9174,64744
49072,3351,3352,3328,3126,3020,2842,3164,22183
49073,4784,4771,4650,4689,4734,4869,4951,33448
49074,175,168,177,208,238,193,149,1308
49075,114,100,114,90,53,53,121,645
49076,4433,4328,4242,4316,4342,4394,4589,30644
49078,9140,8743,8817,8964,8942,8938,8902,62446
49079,13127,13160,13040,13332,12890,12962,13606,92117
49080,16244,16238,15679,15624,15373,15626,15802,110586
49082,6192,6344,6690,6797,6788,6557,6579,45947
49083,7706,7705,7520,7363,7186,7153,6961,51594
49084,39,36,7,5,28,25,36,176
49085,23049,23136,22998,23268,23870,23800,23804,163925
49087,6363,6211,6176,6438,6418,6300,6126,44032
49088,3313,3175,3473,3747,3503,3562,3648,24421
49089,1578,1640,1524,1566,1761,1873,1875,11817
49090,13898,13910,13851,14137,14195,14345,13810,98146
49091,19500,19426,19661,19625,19887,20082,19872,138053
49092,2033,2248,2263,2118,2142,2213,2187,15204
49093,18021,18208,18305,18412,18395,18503,18380,128224
49094,4285,4336,4229,4252,4093,4247,4104,29546
49095,2136,2084,1921,2048,2061,1832,1960,14042
49096,3357,3235,3087,3285,3329,3155,3316,22764
49097,10760,10621,10269,10050,9967,9943,10326,71936
49098,6093,5953,6347,6388,6289,6306,5966,43342
49099,5606,5856,5747,5731,5784,5814,5629,40167
49101,3008,2923,2965,2989,3111,3004,3104,21104
49102,1553,1463,1494,1504,1457,1455,1563,10489
49103,11189,11277,11180,11168,11273,11239,11082,78408
49104,863,825,818,722,593,512,868,5201
49106,4471,4394,4271,4407,4854,4965,4636,31998
49107,10123,10242,10362,10299,10467,10331,10382,72206
49111,3462,3383,3448,3573,3614,3616,3346,24442
49112,10162,10119,10216,10253,10272,10076,10171,71269
49113,1772,1807,1821,1837,1786,1821,1904,12748
49115,443,290,224,200,170,127,294,1748
49116,269,328,419,414,347,270,394,2441
49117,3837,3956,3771,3812,3703,3719,3951,26749
49119,169,136,137,73,107,115,136,873
49120,37178,37161,37276,37376,37262,37186,37122,260561
49125,1877,1785,1762,1923,1848,2098,2046,13339
49126,1141,1250,1360,1521,1435,1589,1341,9637
49127,11092,11098,11009,10793,10389,10581,10694,75656
49128,3749,4051,4144,4116,4111,4021,3715,27907
49129,616,500,444,361,347,578,609,3455
49130,1765,1885,2098,2042,2182,2187,1659,13818
49201,44536,45462,44842,44338,45146,44823,45190,314337
49202,20071,19963,20662,20866,21235,20874,20661,144332
49203,38842,37921,37646,38660,38037,38234,38280,267620
49220,2154,2261,2168,2474,2508,2746,2290,16601
49221,41103,41446,41793,41712,42267,41944,41310,291575
49224,13886,14037,14375,14539,14683,14785,14224,100529
49227,1235,1176,1151,1152,1173,1150,1284,8321
49228,5328,5532,5679,5735,5718,5939,5545,39476
49229,3359,3217,3060,3192,2946,3153,3245,22172
49230,10473,10316,10274,10099,9787,9911,10475,71335
49232,2553,2700,2736,2980,3059,2991,2801,19820
49233,2189,2295,2394,2619,2721,2551,2646,17415
49234,2755,2570,2811,2665,2766,2823,2579,18969
49235,2232,2288,2212,2250,2070,1894,2117,15063
49236,4634,4830,4811,4773,4653,4594,4838,33133
49237,2964,3026,2939,2807,3007,3045,2980,20768
49238,1805,1862,1941,1977,1736,1754,1735,12810
49240,9783,9710,9370,9335,9058,8971,8703,64930
49241,2472,2494,2502,2439,2306,2739,2579,17531
49242,15280,15051,14728,14872,15100,14867,15248,105146
49245,4945,4881,4811,4910,4798,4916,4845,34106
49246,3267,3244,3336,3345,3398,3249,3255,23094
49247,5694,5871,5839,5622,5503,5539,5768,39836
49248,791,847,873,817,813,809,899,5849
49249,3884,3791,3638,3417,3429,3348,3408,24915
49250,5946,5664,6150,6183,5817,6167,6182,42109
49251,6508,6693,6631,6699,6575,6387,6229,45722
49252,2472,2505,2502,2472,2442,2492,2605,17490
49253,2962,2874,3007,2989,3061,3144,3166,21203
49254,2698,2780,3092,3215,3790,3855,3321,22751
49255,2282,2007,1871,1946,1955,1809,1939,13809
49256,4047,4092,3907,3779,3852,3862,3888,27427
49259,2037,2279,2308,2242,2147,2274,2523,15810
49261,370,346,340,406,274,246,290,2272
49262,1313,1314,1359,1305,1317,1446,1280,9334
49263,39,42,36,11,0,37,85,250
49264,2281,2297,2236,2138,1983,1853,1992,14780
49265,5135,5321,5282,5225,5153,5166,4958,36240
49266,3120,3042,3062,2945,2845,2839,2942,20795
49267,3957,3947,3894,4087,4226,4223,4072,28406
49268,963,871,805,885,1010,1140,1059,6733
49269,6397,6286,6146,5954,5863,5930,5998,42574
49270,5615,5714,5807,5842,5872,5999,5874,40723
49271,1928,2016,2211,2196,2321,2583,2256,15511
49272,2124,2266,2288,2309,2114,2364,2417,15882
49274,3572,3941,3740,3917,3776,3854,3670,26470
49276,947,982,1130,1131,1162,1068,1003,7423
49277,3103,3109,3435,3339,3473,3660,3668,23787
49279,770,672,614,603,668,668,797,4792
49282,373,469,481,463,331,405,372,2894
49283,4450,4420,4355,4443,4298,4288,4362,30616
49284,2956,2917,2942,3082,3278,3386,3028,21589
49285,5797,5830,5783,5788,5781,5689,5720,40388
49286,14622,14252,14381,14508,14559,14793,14797,101912
49287,1879,1885,1797,1874,2045,2173,2099,13752
49288,1520,1533,1508,1376,1772,1428,1384,10521
49289,173,223,205,178,164,152,167,1262
49301,20101,19768,19549,19366,18990,18371,18701,134846
49302,8356,8332,8507,8241,7830,7755,7585,56606
49303,1114,1025,1027,1109,1055,1002,1129,7461
49304,3961,4054,4182,4054,4169,4285,4328,29033
49305,2125,2104,2122,2260,2198,2194,2264,15267
49306,10083,10085,10045,10450,10015,10160,9244,70082
49307,20737,20835,20683,20473,20565,20332,20112,143737
49309,1588,1558,1739,1660,1635,1732,1843,11755
49310,3570,3280,3236,3163,2803,2766,3016,21834
49312,289,286,240,213,202,149,274,1653
49315,21996,21046,20734,20135,19552,19581,19915,142959
49316,21940,21598,20912,20073,20081,19552,20074,144230
49318,1485,1544,1566,1572,1523,1464,1398,10552
49319,16507,16569,16401,15987,15674,15763,16181,113082
49320,79,10,18,16,75,75,21,294
49321,16875,16698,16479,16115,15792,15850,16241,114050
49322,1635,1419,1281,1313,1306,1285,1212,9451
49323,9853,9634,9590,9578,9457,9418,9410,66940
49325,1810,1739,1601,1625,1683,1763,1909,12130
49326,4032,4000,4015,3943,3928,3545,3752,27215
49327,8518,8471,8349,8426,8661,8497,8406,59328
49328,3970,3878,3928,4195,4264,4228,3885,28348
49329,8651,8576,8598,8646,8624,8322,8641,60058
49330,5384,5383,5399,5277,5356,5519,5440,37758
49331,17454,17165,16998,17266,16666,16463,16627,118639
49332,3165,3062,3084,3081,2945,2829,3019,21185
49333,10917,10987,11144,11239,11126,11355,11191,77959
49335,500,404,500,534,466,359,314,3077
49336,4465,4739,4766,4844,4666,4583,4352,32415
49337,11442,11794,11888,11682,11665,11947,12088,82506
49338,1587,1494,1529,1586,1681,1808,1842,11527
49339,2159,2258,2318,2453,2513,2377,2283,16361
49340,2963,3070,2865,2945,3000,3040,2912,20795
49341,35546,34971,34518,33588,33697,33085,33737,239142
49342,2043,2019,2107,2018,1654,1688,1649,13178
49343,6079,5692,5651,5441,5277,5611,5489,39240
49344,3662,3767,3959,3652,3567,3197,3410,25214
49345,13505,13248,13123,13572,13800,13445,13040,93733
49346,5228,5377,5420,5331,5369,5364,5446,37535
49347,1343,1181,1223,1067,1186,1155,1257,8412
49348,12130,12045,12029,12007,12169,12114,12153,84647
49349,8098,8204,7976,8220,8399,8349,8087,57333
49401,22253,20516,20398,19903,19437,19331,20735,142573
49402,1236,1273,1366,1400,1379,1382,1380,9416
49403,2424,2350,2170,2221,2289,2423,2473,16350
49404,9079,9046,8927,8961,8724,8350,8269,61356
49405,1408,1447,1491,1439,1570,1532,1559,10446
49406,869,845,799,778,810,609,884,5594
49408,9337,9241,9208,8944,8848,8750,9091,63419
49410,1954,2073,2089,2047,2080,2097,2005,14345
49411,1536,1484,1458,1523,1576,1492,1538,10607
49412,11074,11014,11207,11292,11228,11618,11065,78498
49415,6870,6578,6271,6260,6530,6462,6480,45451
49417,30714,30537,30147,29759,29669,29313,29183,209322
49418,27986,27968,27496,27524,27476,28000,27417,193867
49419,8125,8013,8080,7757,8001,7898,7791,55665
49420,6592,6745,6977,7408,7450,7351,6420,48943
49421,5933,5706,5816,5829,5857,5853,5991,40985
49423,45559,45188,45374,45291,45359,45252,44977,317000
49424,47218,46341,44658,44524,44193,44238,44760,315932
49425,3737,3608,3734,3756,3519,3757,3660,25771
49426,34783,35153,34632,34183,33896,33391,33244,239282
49428,27298,26798,26377,26315,26127,25771,25420,184106
49431,17175,17120,16987,16935,16810,16763,16875,118665
49434,14,12,7,6,0,0,20,59
49435,4172,4122,3756,3286,3135,3177,3549,25197
49436,1574,1640,1541,1436,1406,1344,1622,10563
49437,6934,6919,7004,6990,6938,7026,6902,48713
49440,807,824,1033,1008,1149,1167,953,6941
49441,36012,35863,35578,36322,36654,37009,36308,253746
49442,41550,41236,42822,42437,42775,43149,41214,295183
49444,29178,29205,27796,27091,26882,27199,29456,196807
49445,20047,20014,20457,20655,20539,20855,20784,143351
49446,2507,2408,2533,2599,2461,2457,2321,17286
49448,3795,3911,3429,3393,3256,3247,3410,24441
49449,2404,2513,2449,2382,2371,2451,2675,17245
49450,3609,3398,3216,2926,2938,2811,3302,22200
49451,6144,6132,6231,6129,6260,5939,6012,42847
49452,2026,2131,1891,1718,1668,1665,1952,13051
49453,2651,2431,2497,2704,2409,2413,2626,17731
49454,4882,4603,4677,4738,4727,4689,4574,32890
49455,4662,4712,4538,4615,4781,5026,5034,33368
49456,19041,18821,18944,18976,18972,18862,18581,132197
49457,10619,10916,10767,10798,10847,10602,10565,75114
49458,54,69,58,52,39,135,119,526
49459,1226,1189,1304,1274,1250,1260,1351,8854
49460,8161,8390,8489,8473,8738,8548,8126,58925
49461,9418,9226,8893,8678,8825,8712,8929,62681
49464,28961,29275,29038,28202,27226,27016,27481,197199
49503,35484,34985,35128,35157,34625,34908,35940,246227
49504,38877,38825,39168,39533,39832,40692,39994,276921
49505,31720,31617,31388,31380,31093,30855,31216,219269
49506,33741,33281,33230,33159,33171,32036,31354,229972
49507,38390,38512,37912,37418,37871,37703,35459,263265
49508,41139,41613,41389,40609,40101,39589,39148,283588
49509,26495,26150,26186,26466,26074,26232,26720,184323
49512,17117,16853,16331,16269,15377,14981,15448,112376
49519,29051,29141,28416,28019,27888,26964,27424,196903
49525,29326,28975,28007,27483,27113,26553,27383,194840
49534,21349,21172,21697,21528,21777,21856,21570,150949
49544,9586,9232,8828,8853,8781,8510,8944,62734
49546,33178,33337,32102,31140,31145,32195,31880,224977
49548,31938,30234,30052,29775,30155,30448,30524,213126
49601,21061,20899,20884,21155,21502,21843,21236,148580
49611,260,266,237,237,210,177,236,1623
49612,1114,1105,1099,1151,1222,1252,1121,8064
49613,703,653,553,596,590,626,680,4401
49614,2753,2864,2825,2890,2987,2973,2790,20082
49615,4116,4065,4119,4232,4235,4333,4131,29231
49616,2263,2102,1956,1884,1928,1924,1974,14031
49617,3203,3333,3402,3443,3376,3305,3363,23425
49618,758,780,756,786,719,674,761,5234
49619,1156,1071,972,1007,895,904,1110,7115
49620,2684,2601,2608,2349,2460,2291,2445,17438
49621,3241,2927,3046,3006,2983,3008,3096,21307
49622,2443,2415,2571,2542,2612,2594,2494,17671
49623,1099,1157,1004,1041,1224,1226,1164,7915
49625,1260,1214,1278,1283,1306,1346,1379,9066
49626,362,372,401,459,496,455,421,2966
49627,186,207,161,144,113,107,206,1124
49628,163,208,221,251,301,305,372,1821
49629,2104,2167,2159,2251,2344,2457,2223,15705
49630,1430,1387,1436,1387,1302,1241,1429,9612
49631,6174,5977,5725,5659,5801,5833,6357,41526
49632,1246,1188,1172,1164,1111,1073,1126,8080
49633,3717,3492,3566,3475,3439,3457,3703,24849
49634,157,133,128,144,160,141,116,979
49635,3623,3674,3724,3799,3692,3679,3350,25541
49636,403,504,425,447,457,495,560,3291
49637,3256,2854,3015,3013,3618,3341,3405,22502
49638,962,863,852,831,758,687,824,5777
49639,2203,2242,2566,2617,2847,2937,2557,17969
49640,1355,1364,1397,1406,1567,1785,1618,10492
49642,768,823,920,941,855,682,842,5831
49643,6406,6522,6389,6204,5978,5719,6253,43471
49644,2008,1988,1910,1853,1716,1801,2033,13309
49645,1457,1617,1547,1576,1616,1702,1632,11147
49646,8290,8345,8193,8207,8274,8297,8229,57835
49648,2153,2143,1993,2002,2064,2042,2098,14495
49649,8078,8406,8220,8115,7854,7928,7789,56390
49650,3256,3212,3234,3340,3252,3186,3144,22624
49651,7790,8033,7899,7739,7528,7586,7665,54240
49653,1797,1857,1833,1973,1956,1993,1922,13331
49654,576,763,740,654,642,770,690,4835
49655,3077,3117,3039,3264,3118,3083,3173,21871
49656,1608,1638,1557,1526,1376,1476,1534,10715
49657,3731,3663,3767,3695,3776,3695,3683,26010
49659,6838,6897,6896,6922,6756,6656,6801,47766
49660,14166,14093,14131,13920,13872,13957,14066,98205
49663,6134,6051,6162,6198,6204,6176,5874,42799
49664,1937,1961,2022,2054,2234,2145,2067,14420
49665,4236,4234,4338,4323,4294,4223,4413,30061
49666,0,39,35,86,62,66,106,394
49667,471,454,475,503,637,664,549,3753
49668,3581,3622,3618,3562,3335,3271,3625,24614
49670,2127,2140,2068,1956,1911,1892,1891,13985
49674,72,63,115,70,158,113,110,701
49675,1035,1048,1113,1151,1176,1218,1030,7771
49676,3659,3441,3336,3265,3372,3590,3407,24070
49677,7209,7174,7246,7137,7408,7446,6631,50251
49679,1294,1386,1414,1473,1426,1462,1428,9883
49680,1739,1909,1993,2060,1997,1982,1916,13596
49682,4334,4169,4149,4186,4275,4235,4253,29601
49683,2144,2111,2082,2103,2109,2053,1939,14541
49684,39614,39439,38609,38597,37672,37944,37963,269838
49686,32747,32661,32934,32271,32553,32182,32056,227404
49688,2609,2547,2561,2621,2486,2652,2703,18179
49689,1482,1523,1604,1517,1594,1435,1560,10715
49690,6931,6698,6423,6500,6125,5966,6182,44825
49701,865,916,902,865,1034,1043,1036,6661
49705,861,1021,1030,968,1019,1103,937,6939
49706,4493,4378,4389,4510,4677,4736,4585,31768
49707,22037,22298,22357,22429,22478,22695,22701,156995
49709,3649,3679,3528,3693,3727,3715,3618,25609
49710,556,486,531,468,348,361,409,3159
49712,8055,7964,7852,7848,8076,8017,7890,55702
49713,1923,1931,1970,1987,2042,2029,1864,13746
49715,3202,3021,3034,3103,2969,3208,3130,21667
49716,857,817,798,863,866,919,806,5926
49717,198,195,136,142,58,47,72,848
49718,741,713,746,806,752,728,701,5187
49719,1320,1385,1338,1342,1337,1388,1362,9472
49720,8917,8966,8997,9186,9319,9306,9172,63863
49721,14291,14258,14313,14315,14386,14688,14436,100687
49722,278,337,264,220,202,170,220,1691
49724,1166,1210,1151,1134,1245,1183,1146,8235
49725,637,690,662,655,680,598,766,4688
49726,1120,1126,1117,1029,1015,1017,1058,7482
49727,7397,7369,7426,7222,7168,7177,7145,50904
49728,250,251,281,310,356,342,334,2124
49729,1461,1436,1503,1520,1590,1722,1446,10678
49730,2010,1918,2000,2044,2113,2212,2187,14484
49733,2354,2302,2208,2042,1901,1816,1965,14588
49735,19577,19542,19600,19658,19640,19822,19515,137354
49736,497,518,504,504,501,554,578,3656
49738,9625,9720,9684,9851,9962,10062,9924,68828
49740,7094,7037,6966,6884,6805,6827,7042,48655
49743,837,759,821,782,786,814,769,5568
49744,980,963,908,860,822,815,823,6171
49745,1016,1184,1276,1217,1264,1205,1089,8251
49746,3519,3642,3852,3742,3700,3674,3685,25814
49747,1946,1813,1742,1779,1784,1922,1921,12907
49748,174,126,121,113,138,244,170,1086
49749,3947,3956,4218,4194,4166,4175,4283,28939
49751,2066,1985,1864,1765,1747,1663,2087,13177
49752,794,912,691,857,891,961,515,5621
49753,1890,1879,1984,2097,2339,2253,2057,14499
49755,1978,1913,1995,1914,1989,1868,1892,13549
49756,3433,3514,3647,3736,3792,4024,3857,26003
49757,763,710,600,516,396,395,492,3872
49759,1541,1506,1496,1531,1612,1453,1682,10821
49760,656,602,586,608,600,680,713,4445
49762,545,559,580,549,585,606,639,4063
49764,202,243,222,155,156,147,139,1264
49765,3837,3905,3932,4045,3998,4056,4154,27927
49766,2212,2268,2304,2468,2455,2565,2417,16689
49768,357,375,411,460,471,405,476,2955
49769,1657,1676,1675,1804,1617,1565,1644,11638
49770,17148,17199,17078,17038,17011,17232,16862,119568
49774,2012,2161,2030,2080,1895,1683,1851,13712
49775,76,78,72,76,74,68,95,539
49776,1772,1803,1823,1839,1868,1909,1888,12902
49777,1744,1762,1778,1715,1610,1611,1640,11860
49779,4553,4662,4664,4676,4753,4866,4639,32813
49780,1781,1840,1791,1863,1836,1904,1946,12961
49781,4014,3997,4147,4303,4383,4368,4020,29232
49782,584,584,597,610,543,558,657,4133
49783,19672,19731,19898,19843,19991,19981,19668,138784
49788,6298,6223,6488,6415,6567,6567,6609,45167
49791,331,327,311,251,264,239,329,2052
49793,281,335,358,377,433,407,322,2513
49795,2119,2194,2071,2062,2137,2045,2097,14725
49796,335,430,404,361,238,228,320,2316
49799,2309,2272,2266,2421,2458,2319,2327,16372
49801,11583,11510,11459,11447,11266,11287,11424,79976
49802,6104,6242,6244,6467,6462,6717,6230,44466
49805,178,175,222,303,295,290,336,1799
49806,549,536,555,521,547,516,627,3851
49807,3141,3195,3294,3357,3343,3489,3390,23209
49808,217,209,243,258,228,206,352,1713
49812,954,919,945,939,847,755,925,6284
49814,1356,1396,1445,1482,1473,1369,1429,9950
49815,426,423,514,580,628,593,488,3652
49816,602,636,777,906,914,912,724,5471
49817,578,545,587,514,538,553,615,3930
49818,917,943,1003,978,959,936,988,6724
49819,20,15,20,21,61,64,36,237
49820,190,207,190,216,236,260,382,1681
49821,1207,1237,1236,1255,1348,1457,1354,9094
49822,290,242,323,272,224,185,220,1756
49825,206,296,267,295,334,291,299,1988
49826,191,216,183,143,135,167,137,1172
49827,940,906,966,959,924,929,897,6521
49829,17345,17508,17367,17445,17371,17299,17347,121682
49831,810,733,717,704,784,821,780,5349
49833,289,184,167,115,288,274,266,1583
49834,281,301,262,276,253,247,284,1904
49835,877,849,813,796,798,770,802,5705
49836,883,890,948,931,1032,1016,938,6638
49837,9590,9589,9552,9561,9658,9775,9795,67520
49838,556,558,495,481,525,487,504,3606
49839,380,421,345,261,387,352,479,2625
49840,692,756,800,830,806,798,771,5453
49841,7331,7400,7369,7466,7181,7151,7016,50914
49847,986,959,991,922,824,777,998,6457
49848,99,89,119,142,132,126,128,835
49849,12734,12684,12601,12604,12536,12423,12242,87824
49852,119,110,106,97,100,93,120,745
49853,1273,1314,1299,1415,1520,1378,1278,9477
49854,6264,6396,6370,6456,6438,6542,6469,44935
49855,33500,33760,33852,33767,33563,33524,33561,235527
49858,11808,11856,11862,11935,12004,12105,12088,83658
49861,490,497,546,454,522,509,616,3634
49862,5224,5226,4729,4795,4792,4731,5025,34522
49863,165,153,145,114,98,101,130,906
49864,88,83,59,63,65,86,54,498
49866,8040,8015,7995,7966,7952,7891,8034,55893
49868,5279,5244,5269,5173,5129,5341,5409,36844
49870,3292,3353,3454,3382,3402,3475,3329,23687
49871,484,485,580,611,761,759,510,4190
49872,181,193,181,171,237,199,206,1368
49873,117,133,131,116,166,124,120,907
49874,1046,1126,1129,1208,1162,1212,1126,8009
49876,1034,999,1111,985,1227,1038,1240,7634
49877,36,49,41,39,33,36,67,301
49878,3584,3585,3622,3713,3581,3490,3583,25158
49879,830,906,991,950,896,1022,1038,6633
49880,1073,1052,1096,1079,1144,1177,1142,7763
49881,345,360,370,341,348,392,345,2501
49883,134,122,74,81,89,97,151,748
49884,376,415,481,711,812,960,552,4307
49885,2302,2092,1889,1626,1649,1610,1897,13065
49886,635,626,558,472,447,373,435,3546
49887,2594,2529,2499,2574,2730,2718,2474,18118
49891,715,788,731,732,613,660,816,5055
49892,1930,1939,1912,1929,1899,1845,1948,13402
49893,1728,1808,1910,2008,1988,2006,1784,13232
49894,621,609,677,660,669,836,680,4752
49895,616,547,949,785,744,756,765,5162
49896,1591,1621,1644,1566,1592,1658,1749,11421
49901,341,300,282,273,272,297,346,2111
49902,175,75,83,97,101,91,145,767
49903,123,131,180,162,162,167,133,1058
49905,1987,1914,1820,1852,1876,1918,2005,13372
49908,3725,3825,3490,3682,3542,3375,3292,24931
49910,295,357,403,391,378,373,385,2582
49911,2795,2780,2810,2744,2944,2896,2744,19713
49912,908,929,969,943,948,1008,1081,6786
49913,7222,7458,7495,7599,7434,7469,7248,51925
49915,468,505,542,554,579,533,630,3811
49916,3105,2851,2750,2548,2775,2632,2765,19426
49917,255,246,291,261,236,216,205,1710
49918,104,89,104,124,132,82,120,755
49919,231,194,390,230,249,339,242,1875
49920,4139,4278,4292,4224,4222,4343,4273,29771
49921,286,281,254,260,261,226,360,1928
49922,654,771,807,736,813,760,1043,5584
49925,462,453,426,497,503,538,494,3373
49927,461,451,423,424,352,375,483,2969
49929,167,250,209,224,239,224,216,1529
49930,7072,7026,7025,7026,7036,7095,6987,49267
49931,9820,9885,9947,9904,9824,9657,9630,68667
49934,937,939,1020,1012,1077,1105,900,6990
49935,5979,6029,6049,6234,6402,6424,6096,43213
49938,7545,7612,7641,7762,7870,7822,7945,54197
49942,68,52,90,71,124,131,156,692
49945,2639,2550,2515,2409,2454,2436,2621,17624
49946,3822,3869,3837,3914,3965,3978,4040,27425
49947,1717,1862,1874,1772,1843,1966,1818,12852
49948,491,524,521,524,573,504,590,3727
49950,1315,1395,1377,1308,1304,1314,1121,9134
49952,89,97,102,125,144,135,143,835
49953,2692,2720,2865,2952,2964,3136,2879,20208
49955,541,538,589,482,431,424,371,3376
49958,842,971,1050,1145,1206,1427,1270,7911
49959,325,270,327,358,414,416,344,2454
49960,179,150,143,129,123,153,185,1062
49961,96,100,100,94,89,88,107,674
49962,160,137,192,137,159,159,260,1204
49963,851,1026,880,978,861,840,1024,6460
49965,508,315,382,478,433,382,440,2938
49967,515,545,472,480,513,536,492,3553
49968,2120,2140,2195,2320,2153,2180,2247,15355
49969,1248,1266,1322,1352,1211,1287,1401,9087
49970,229,208,310,235,237,270,243,1732
49971,452,395,402,392,402,348,483,2874
50001,575,734,781,825,866,854,680,5315
50002,1364,1442,1355,1338,1479,1551,1297,9826
50003,6893,7109,7034,6921,6506,6530,6594,47587
50005,1007,861,690,668,849,769,730,5574
50006,1524,1556,1427,1528,1655,1686,1676,11052
50007,595,598,681,619,710,656,474,4333
50008,978,945,880,920,867,841,878,6309
50009,18600,17561,17083,16687,16367,15880,16136,118314
50010,32111,31870,30493,29802,29522,27799,29359,210956
50011,1587,1554,1941,1913,1952,1941,1390,12278
50012,4743,4527,3917,3699,3611,3469,4062,28028
50014,29725,28682,28398,28064,27746,28657,28094,199366
50020,1198,1354,1347,1554,1627,1682,1407,10169
50021,24993,24936,23435,21778,21132,20822,21595,158691
50022,8148,8171,8117,8028,8273,8228,8494,57459
50023,33001,30700,29895,29494,28105,26288,27986,205469
50025,3107,3151,3176,3294,3325,3205,3325,22583
50026,612,673,722,638,594,549,584,4372
50027,312,353,297,313,359,408,285,2327
50028,1499,1471,1523,1553,1756,1744,1681,11227
50029,651,673,686,737,713,662,691,4813
50032,104,32,267,429,414,530,399,2175
50033,41,28,23,33,29,11,44,209
50034,365,393,354,356,367,434,490,2759
50035,6562,6103,5639,5458,5545,5200,5387,39894
50036,16251,16239,16206,16052,16258,16187,16287,113480
50038,72,105,105,114,192,202,205,995
50039,319,508,537,463,454,446,329,3056
50041,53,70,57,92,67,53,92,484
50042,267,326,324,342,319,381,309,2268
50044,1088,1123,1052,1123,1092,1066,887,7431
50046,1401,1277,1318,1395,1445,1594,1524,9954
50047,5931,5733,5584,5447,5480,5155,5559,38889
50048,784,762,754,848,862,908,861,5779
50049,6604,6703,6602,6754,6481,6586,6493,46223
50050,706,635,607,553,589,595,710,4395
50051,361,404,377,391,312,329,283,2457
50052,166,197,188,245,245,207,138,1386
50054,2908,2987,3255,3371,3646,3859,3356,23382
50055,917,912,899,859,857,867,913,6224
50056,1459,1428,1349,1349,1367,1445,1372,9769
50057,256,353,301,281,228,313,238,1970
50058,2107,2004,2057,2042,1997,1912,1927,14046
50060,2512,2328,2249,2304,2473,2501,2507,16874
50061,1599,1679,1628,1676,1788,1741,1701,11812
50062,677,664,599,640,672,704,741,4697
50063,2734,2704,2825,2837,2870,2789,2604,19363
50064,122,100,100,79,101,97,126,725
50065,620,629,568,522,581,615,583,4118
50066,299,367,349,260,258,216,262,2011
50067,225,228,292,321,422,427,302,2217
50068,272,280,369,416,470,462,366,2635
50069,1151,1258,1239,1228,1263,1071,1118,8328
50070,1567,1699,1508,1426,1424,1403,1489,10516
50071,909,836,822,869,924,909,1007,6276
50072,2468,2780,2850,2807,2878,2795,2671,19249
50073,1120,982,1069,1029,955,930,1195,7280
50074,432,404,328,300,304,317,334,2419
50075,851,794,845,918,934,960,862,6164
50076,1591,1596,1502,1402,1430,1485,1502,10508
50078,137,133,108,115,128,119,126,866
50101,78,92,88,88,59,38,66,509
50102,99,64,36,44,52,76,87,458
50103,399,445,434,373,471,603,452,3177
50104,105,124,125,153,138,138,128,911
50105,1219,1290,1501,1389,1276,1177,1158,9010
50106,1065,1186,1042,939,879,886,1039,7036
50107,1116,1186,1178,1152,1116,1024,1099,7871
50108,385,418,433,542,551,589,471,3389
50109,2826,3217,2966,2812,2685,2957,2762,20225
50111,12346,11100,10681,9939,9649,9353,9407,72475
50112,11532,11633,11877,11752,11701,11659,11536,81690
50115,2791,2825,2613,2670,2864,2657,2674,19094
50116,313,242,217,174,180,189,299,1614
50117,78,119,176,205,216,238,193,1225
50118,1027,1078,924,970,903,900,1027,6829
50119,518,496,524,574,498,469,498,3577
50120,318,320,310,291,296,216,323,2074
50122,1462,1563,1554,1648,1510,1460,1373,10570
50123,688,794,876,791,775,732,818,5474
50124,3864,3794,3700,3662,3728,3604,3750,26102
50125,19792,19609,19384,19543,19536,19490,19556,136910
50126,6879,6958,7078,6770,6822,6883,6853,48243
50127,18,17,17,0,0,9,29,90
50128,387,340,361,362,368,413,360,2591
50129,4933,5071,5099,5128,5230,5402,5228,36091
50130,1661,1655,1606,1517,1514,1565,1648,11166
50131,19683,19696,19033,18263,17364,16418,17499,127956
50132,235,348,342,320,313,377,367,2302
50133,403,414,515,515,522,549,567,3485
50134,701,588,609,590,573,612,660,4333
50135,1770,1716,1641,1666,1659,1712,1605,11769
50136,422,375,341,406,401,426,445,2816
50138,11324,11315,11603,11830,11700,11710,11720,81202
50139,1535,1452,1486,1432,1391,1305,1288,9889
50140,3191,3161,3152,3059,3074,3111,2969,21717
50141,626,577,644,640,541,595,569,4192
50142,988,1036,950,957,934,950,931,6746
50143,647,618,704,635,633,710,600,4547
50144,2703,2732,2691,2696,2696,2541,2901,18960
50146,385,342,328,342,380,403,438,2618
50147,380,373,448,496,365,384,440,2886
50148,397,476,393,352,368,383,432,2801
50149,922,967,968,870,878,759,964,6328
50150,928,994,1071,1113,1164,1040,984,7294
50151,555,503,542,533,660,853,724,4370
50153,836,814,781,897,903,749,734,5714
50154,418,440,474,523,571,546,466,3438
50155,292,299,246,274,254,208,255,1828
50156,4268,4343,4376,4242,4213,4302,4412,30156
50157,942,653,601,622,620,618,762,4818
50158,31273,31364,31634,31589,31524,31427,31591,220402
50160,452,463,482,515,493,446,465,3316
50161,1738,1893,1971,2058,2013,1968,2047,13688
50162,1297,1389,1397,1227,1210,1265,1233,9018
50163,723,760,762,824,955,888,858,5770
50164,554,587,523,514,578,660,652,4068
50165,113,29,59,74,75,84,49,483
50166,1630,1581,1526,1606,1650,1733,1582,11308
50167,497,565,636,588,549,514,748,4097
50168,644,749,771,665,792,764,842,5227
50169,3259,3235,3403,3613,3651,3492,3093,23746
50170,2623,2824,2769,2716,2790,2837,2745,19304
50171,2753,2845,2944,2943,2951,2969,2923,20328
50173,820,760,872,842,783,716,696,5489
50174,1403,1308,1245,1250,1345,1399,1429,9379
50201,8432,8528,8382,8139,8021,7998,8199,57699
50206,558,355,393,469,423,385,526,3109
50207,2466,2523,2403,2499,2473,2357,2537,17258
50208,20545,20667,20478,20675,20550,20475,20417,143807
50210,1633,1575,1687,1531,1647,1725,1691,11489
50211,12282,12216,12058,11849,11385,10859,11192,81841
50212,3194,3328,3372,3515,3448,3615,3131,23603
50213,6877,6898,6892,7027,6877,6811,6812,48194
50214,874,907,881,808,656,627,850,5603
50216,2548,2613,2819,2740,2707,2835,2824,19086
50217,612,650,660,719,722,757,631,4751
50218,155,127,113,110,84,84,139,812
50219,13802,13938,14009,14190,14335,14110,13939,98323
50220,9140,9306,9280,9213,8985,8858,9020,63802
50222,553,559,567,645,628,701,498,4151
50223,542,490,413,423,498,482,480,3328
50225,2895,2961,3162,2736,2864,3043,2940,20601
50226,5919,5644,5370,5306,5018,4801,4724,36782
50227,32,28,38,22,21,12,40,193
50228,2673,2501,2240,2177,1916,1835,2417,15759
50229,755,784,752,713,783,871,932,5590
50230,1059,1044,1309,1314,1125,1130,1083,8064
50231,188,174,146,143,144,168,173,1136
50232,474,487,515,485,449,502,537,3449
50233,1355,1305,1384,1441,1214,1328,1388,9415
50234,588,653,612,536,525,495,613,4022
50235,384,362,341,343,500,494,483,2907
50236,1606,1699,1780,1783,1635,1484,1550,11537
50237,3413,3205,3289,3052,2827,2790,3095,21671
50238,1303,1136,1122,938,1086,912,1182,7679
50239,159,145,161,146,199,215,210,1235
50240,2875,2819,2871,2815,2673,2801,2453,19307
50242,520,416,429,375,413,452,439,3044
50243,187,200,185,250,225,207,244,1498
50244,1923,2126,1937,2102,1991,2001,1813,13893
50246,667,656,682,680,706,707,735,4833
50247,2199,2164,2245,2378,2250,2243,2515,15994
50248,4506,4310,4256,4406,4555,4540,4420,30993
50249,1154,1126,1186,1176,1230,1229,1332,8433
50250,2349,2347,2528,2595,2510,2530,2330,17189
50251,1322,1288,1376,1282,1211,1202,1270,8951
50252,280,189,139,133,129,161,243,1274
50254,286,247,276,330,339,483,282,2243
50255,75,95,83,62,52,38,65,470
50256,528,603,692,590,630,682,501,4226
50257,1037,1068,1024,875,822,924,992,6742
50258,1023,979,965,950,1035,1064,1002,7018
50261,2487,2526,2385,2297,2565,2396,2211,16867
50262,442,383,485,539,410,383,453,3095
50263,20205,19928,18943,17390,16195,15205,16069,123935
50264,486,455,343,350,383,342,466,2825
50265,31754,34198,33016,32214,31733,31290,31653,225858
50266,27651,25061,24728,24636,23905,23405,23625,173011
50268,990,940,943,1011,1060,1094,993,7031
50271,646,706,707,806,861,829,628,5183
50272,113,108,123,130,133,145,152,904
50273,8342,8078,8297,8217,8284,8089,8251,57558
50274,343,376,324,358,376,325,398,2500
50275,576,600,654,602,633,562,532,4159
50276,3151,2764,2641,2594,2608,2621,2517,18896
50277,475,460,432,436,333,381,483,3000
50278,801,883,942,943,928,960,842,6299
50309,5912,5684,5622,5431,5315,5508,5431,38903
50310,32300,31132,30506,30138,30029,29655,30221,213981
50311,15460,15487,15241,15155,15013,15269,15113,106738
50312,15713,15150,15138,14873,15373,15531,15339,107117
50313,18300,17814,17526,17632,17542,17460,17376,123650
50314,12102,11716,11765,11925,12006,11729,12465,83708
50315,35577,35672,36270,35873,35930,36600,35853,251775
50316,17443,16957,17060,16983,16976,16601,16440,118460
50317,37148,36323,35944,35391,35686,35487,36207,252186
50319,0,0,0,0,0,0,0,0
50320,21603,21226,21115,21195,20259,19930,20027,145355
50321,9007,8666,8357,8501,8156,8040,7846,58573
50322,31168,31956,31484,31526,31085,30879,31530,219628
50323,12678,12169,11405,10566,10331,9917,10201,77267
50324,4980,4888,4877,4874,4857,4854,4903,34233
50325,16937,16510,16191,16010,15658,15237,15448,111991
50327,11156,10991,10727,10833,10268,10102,10467,74544
50401,29216,29387,29321,29322,29617,29542,29837,206242
50420,366,383,403,376,297,268,377,2470
50421,3336,3132,3050,2871,2729,2747,3032,20897
50423,2789,2919,2994,3222,3072,3035,2976,21007
50424,1414,1344,1364,1254,1483,1620,1482,9961
50426,24,42,49,46,54,47,56,318
50428,9424,9122,9255,9274,9283,9479,9384,65221
50430,440,421,437,444,463,484,518,3207
50431,205,268,347,376,414,427,273,2310
50432,202,185,172,190,209,223,252,1433
50433,174,200,234,206,242,236,256,1548
50434,389,387,401,382,413,427,498,2897
50435,702,615,548,628,517,619,721,4350
50436,5984,6061,6037,5919,5733,5568,5848,41150
50438,3964,4015,3980,3903,3918,4151,4159,28090
50439,322,354,462,491,468,212,289,2598
50440,662,590,540,475,407,439,422,3535
50441,5537,5554,5666,5846,5834,5910,5776,40123
50444,373,358,375,330,408,433,353,2630
50446,539,623,597,668,604,567,548,4146
50447,1199,1305,1135,1203,1270,1314,1081,8507
50448,847,766,730,741,611,588,695,4978
50449,698,596,640,664,808,966,724,5096
50450,2646,2571,2458,2681,2524,2722,2897,18499
50451,449,527,433,477,471,474,537,3368
50452,810,813,750,802,950,978,804,5907
50453,576,621,704,685,754,670,588,4598
50454,68,94,101,180,163,137,127,870
50455,648,528,473,356,413,379,450,3247
50456,1888,1815,1815,1789,1749,1716,1741,12513
50457,308,361,342,378,473,565,441,2868
50458,2102,2043,2159,2148,2039,2089,2097,14677
50459,2683,2793,2795,2870,2947,3057,3018,20163
50460,383,409,370,306,169,180,364,2181
50461,5684,5706,5694,5786,5642,5690,5613,39815
50464,498,608,667,723,776,800,673,4745
50465,279,278,322,250,250,147,250,1776
50466,1723,1715,1856,1962,1985,1913,1828,12982
50467,73,73,86,100,67,66,94,559
50468,1481,1601,1611,1587,1663,1589,1615,11147
50469,1612,1636,1563,1694,1482,1550,1574,11111
50470,191,219,220,213,262,291,275,1671
50471,704,736,663,741,735,655,689,4923
50472,2216,2122,2214,2224,2568,2625,2394,16363
50473,254,294,283,185,228,198,268,1710
50475,1885,1761,1823,1676,1686,1634,1757,12222
50476,800,906,882,719,748,795,804,5654
50477,320,365,377,427,393,318,347,2547
50478,867,879,909,962,1017,1022,775,6431
50479,574,602,540,569,656,713,684,4338
50480,926,900,787,793,777,834,880,5897
50482,871,908,879,884,895,877,774,6088
50483,647,677,676,743,833,773,781,5130
50484,414,409,399,362,389,345,444,2762
50501,28015,27866,27963,28492,28659,28918,29078,198991
50510,1004,1012,1019,1001,1035,1073,1116,7260
50511,7184,7203,7252,7223,7006,7161,7137,50166
50514,1427,1436,1460,1507,1541,1459,1452,10282
50515,238,247,277,230,222,224,279,1717
50516,602,724,656,576,616,573,719,4466
50517,983,1008,1042,1132,1200,1071,1051,7487
50518,447,475,442,414,443,476,381,3078
50519,696,630,657,605,592,579,624,4383
50520,80,115,161,125,137,144,144,906
50521,245,174,36,30,41,68,104,698
50522,813,806,916,703,753,823,857,5671
50523,779,822,923,825,793,671,604,5417
50524,562,678,638,525,462,486,521,3872
50525,3455,3414,3413,3491,3590,3715,3583,24661
50527,246,213,266,282,221,234,223,1685
50528,329,349,467,525,508,475,383,3036
50529,707,777,764,822,779,805,837,5491
50530,1223,1300,1297,1318,1315,1353,1205,9011
50531,239,266,286,313,291,295,242,1932
50532,1000,895,858,879,930,931,873,6366
50533,3885,3880,3952,3952,3998,4008,4130,27805
50535,944,950,885,807,813,808,885,6092
50536,4557,4619,4540,4541,4619,4570,4541,31987
50538,499,477,490,473,441,518,503,3401
50539,623,602,553,591,609,628,566,4172
50540,798,872,809,916,955,1020,1022,6392
50541,890,808,860,800,885,786,872,5901
50542,862,967,984,1067,1027,1011,933,6851
50543,1458,1503,1456,1562,1650,1671,1492,10792
50544,423,509,601,565,624,609,515,3846
50545,251,282,355,270,247,256,205,1866
50546,293,322,411,400,367,476,346,2615
50548,5659,5812,5749,5818,5935,5970,5869,40812
50551,168,120,108,128,97,71,158,850
50554,1578,1649,1641,1632,1620,1681,1625,11426
50556,281,278,256,281,271,283,292,1942
50557,785,794,855,831,843,706,750,5564
50558,761,738,683,756,730,681,618,4967
50559,334,296,282,274,318,333,348,2185
50560,563,568,640,618,576,560,590,4115
50561,367,445,493,599,513,544,520,3481
50562,471,496,530,567,560,514,527,3665
50563,2546,2613,2522,2517,2578,2460,2500,17736
50565,479,563,611,591,603,513,468,3828
50566,441,416,394,344,275,316,433,2619
50567,295,268,237,216,196,210,226,1648
50568,1656,1677,1706,1515,1434,1346,1398,10732
50569,662,696,826,875,812,918,836,5625
50570,199,219,226,229,202,200,248,1523
50571,434,439,348,313,321,353,394,2602
50573,51,37,34,44,77,79,68,390
50574,2033,1992,2081,2156,2188,2240,2181,14871
50575,1170,1237,1348,1195,1050,986,969,7955
50576,360,331,406,393,439,413,423,2765
50577,412,416,440,395,342,334,410,2749
50578,663,653,650,677,685,702,646,4676
50579,2779,2696,2735,2686,2939,2839,2405,19079
50581,952,948,869,885,991,938,996,6579
50582,242,231,183,189,160,191,234,1430
50583,2878,2857,2668,2662,2647,2614,2855,19181
50585,1152,1007,932,911,891,1005,1176,7074
50586,275,360,319,288,283,194,307,2026
50588,12810,12932,12847,12906,12824,12553,12756,89628
50590,920,916,940,914,918,824,879,6311
50591,311,249,263,220,283,299,320,1945
50593,77,77,108,92,46,52,64,516
50594,177,244,292,229,256,309,298,1805
50595,9125,9156,9122,9185,9115,9046,9165,63914
50597,1231,1271,1327,1185,1147,1245,1293,8699
50598,826,821,816,1005,1056,1071,912,6507
50599,369,424,466,489,510,565,380,3203
50601,2375,2542,2439,2339,2413,2517,2464,17089
50602,1684,1745,1817,1643,1627,1684,1603,11803
50603,662,685,719,728,707,668,625,4794
50604,1698,1772,1672,1684,1604,1675,1850,11955
50605,157,165,147,126,144,147,168,1054
50606,846,914,950,936,1005,1057,885,6593
50607,693,668,630,687,692,566,481,4417
50609,469,467,351,360,456,476,446,3025
50611,433,471,464,400,377,345,392,2882
50612,317,314,345,308,345,380,335,2344
50613,43930,43612,42766,42337,42067,41382,42031,298125
50616,10399,10443,10506,10340,10562,10444,10344,73038
50619,2246,2269,2354,2306,2460,2532,2410,16577
50620,42,50,40,44,52,104,54,386
50621,1563,1631,1507,1682,1651,1567,1530,11131
50622,3439,3339,3304,3292,3108,2959,3206,22647
50624,1634,1788,1953,1841,1817,1985,1743,12761
50625,1150,1123,1053,1183,1232,1132,1004,7877
50626,1873,1964,1950,2028,1716,1664,1804,12999
50627,3327,3435,3528,3529,3530,3525,3456,24330
50628,1346,1450,1378,1398,1538,1487,1374,9971
50629,2031,2114,2155,2331,2523,2403,2418,15975
50630,2067,2031,1878,1848,1733,1922,1728,13207
50632,977,947,1076,1144,1164,1143,1107,7558
50633,350,421,414,467,402,391,373,2818
50634,745,723,656,682,803,713,713,5035
50635,1706,1685,1704,1808,1818,1828,1602,12151
50636,1757,1894,1866,1935,1924,1920,1982,13278
50638,3236,3320,3282,3260,3179,3135,3313,22725
50641,1879,2034,1975,1939,1758,1883,2017,13485
50642,547,484,593,669,753,656,581,4283
50643,2573,2690,2606,2607,2706,2736,2747,18665
50644,8828,8688,8560,8426,8190,8321,8648,59661
50645,929,1014,962,1066,942,1047,1204,7164
50647,1664,1740,1831,1850,1919,2039,1894,12937
50648,4599,4366,4627,4513,4554,4282,4054,30995
50650,639,560,528,511,648,688,737,4311
50651,3626,3489,3665,3821,3927,3817,3578,25923
50652,91,82,90,95,101,136,128,723
50653,626,535,667,741,677,682,639,4567
50654,379,338,338,385,399,520,499,2858
50655,740,771,733,755,708,833,873,5413
50658,2371,2453,2468,2584,2620,2634,2518,17648
50659,5399,5466,5697,5716,5808,5673,5488,39247
50660,1330,1334,1314,1317,1394,1386,1333,9408
50662,6911,6898,6930,7144,7218,7259,7238,49598
50664,65,65,58,18,15,46,53,320
50665,3002,2799,2780,2676,2690,2756,2841,19544
50666,1128,961,1130,920,976,930,1027,7072
50667,829,824,872,851,818,746,795,5735
50668,1265,1319,1319,1327,1353,1366,1249,9198
50669,2593,2473,2399,2624,2365,2469,2436,17359
50670,2339,2196,2115,2155,1963,1733,2024,14525
50671,173,255,271,303,401,398,269,2070
50672,513,444,505,499,651,629,594,3835
50673,162,191,237,260,215,211,219,1495
50674,3666,3529,3449,3423,3494,3460,3555,24576
50675,2381,2394,2560,2570,2728,2606,2456,17695
50676,2182,2222,2346,2355,2241,2302,2105,15753
50677,12078,12092,11925,11936,11897,11954,12131,84013
50680,1357,1354,1312,1258,1158,1083,1095,8617
50681,397,437,508,552,490,526,457,3367
50682,1745,1679,1636,1758,1693,1775,1572,11858
50701,30231,29913,29343,29075,29410,29924,30324,208220
50702,20210,20199,20328,20036,19724,19680,19970,140147
50703,19200,19633,19986,20380,20153,19896,19863,139111
50707,8648,8512,8580,8489,8570,8551,8509,59859
50801,9612,9598,9544,9468,9514,9276,9590,66602
50830,1749,1771,1814,1879,1852,1780,1743,12588
50833,2259,2194,2182,2358,2376,2353,2305,16027
50835,117,119,134,131,122,84,92,799
50836,337,432,401,388,375,347,457,2737
50837,254,262,292,272,276,306,376,2038
50839,37,27,21,21,24,17,34,181
50840,561,565,610,607,553,562,560,4018
50841,2659,2682,2785,2851,2854,3037,2824,19692
50842,100,91,85,86,69,62,105,598
50843,658,652,651,646,587,593,596,4383
50845,842,872,847,902,936,948,811,6158
50846,1054,1020,1155,1133,1143,1082,1123,7710
50847,100,82,43,60,68,46,87,486
50848,416,441,404,366,305,271,378,2581
50849,2556,2629,2616,2732,2678,2731,2740,18682
50851,1987,1979,1929,1812,1898,1861,2087,13553
50853,681,688,729,756,728,731,702,5015
50854,2427,2260,2053,2027,2075,2199,2303,15344
50857,215,243,281,239,202,268,272,1720
50858,726,687,718,700,685,731,796,5043
50859,660,685,664,693,645,579,584,4510
50860,392,501,691,675,652,507,474,3892
50861,249,329,314,324,293,369,274,2152
50862,167,134,195,180,155,162,148,1141
50863,308,318,321,275,276,323,293,2114
50864,1950,1914,1983,1990,2102,2368,2057,14364
51001,2397,2385,2408,2367,2467,2348,2432,16804
51002,2877,2813,2689,2678,2579,2728,2741,19105
51003,1746,1712,1616,1649,1585,1734,1700,11742
51004,1114,1315,1320,1294,1360,1253,1033,8689
51005,1365,1457,1499,1582,1593,1603,1491,10590
51006,1012,1012,1195,1127,1192,1146,1075,7759
51007,599,709,730,705,699,687,730,4859
51008,105,93,98,110,94,76,151,727
51009,187,202,304,281,309,284,164,1731
51010,365,371,267,220,313,333,456,2325
51011,82,69,68,59,44,61,79,462
51012,6335,6342,6326,6316,6387,6568,6642,44916
51014,490,498,448,494,517,467,528,3442
51016,1290,1215,1267,1392,1445,1572,1378,9559
51018,424,387,384,400,317,333,404,2649
51019,868,844,785,762,819,876,773,5727
51020,682,691,671,723,761,707,658,4893
51022,794,802,748,756,892,880,789,5661
51023,3157,3119,3183,3116,3167,3166,3216,22124
51024,1907,1885,1878,1942,1955,1815,2070,13452
51025,2008,1933,1805,1791,1867,1869,1989,13262
51026,825,850,887,745,730,706,862,5605
51027,1144,1060,1050,1032,1342,1491,1260,8379
51028,2069,2182,2172,2136,2116,2229,2065,14969
51029,356,340,360,429,331,269,251,2336
51030,1537,1585,1658,1778,1758,1810,1737,11863
51031,12130,12106,12114,12023,12070,11954,12336,84733
51033,326,381,360,506,509,480,428,2990
51034,1852,1943,1815,1859,1756,1763,1820,12808
51035,1381,1602,1765,1647,1717,1683,1685,11480
51036,755,661,594,678,628,664,726,4706
51037,520,383,355,328,323,273,322,2504
51038,1577,1708,1695,1761,1658,1725,1535,11659
51039,2528,2411,2421,2477,2528,2389,2475,17229
51040,3531,3557,3576,3763,3998,4023,3712,26160
51041,7593,7579,7519,7356,7369,7033,6976,51425
51044,203,208,179,214,210,229,253,1496
51046,1690,1649,1644,1364,1737,1704,1660,11448
51047,645,684,698,762,802,975,646,5212
51048,634,616,619,654,647,640,554,4364
51049,505,507,467,476,500,485,506,3446
51050,2604,2627,2752,2882,2765,2821,2631,19082
51051,119,71,103,102,119,119,90,723
51052,837,829,908,797,790,894,1027,6082
51053,1094,1129,1274,1145,1296,1239,1161,8338
51054,5428,5440,5183,4979,4881,4843,5110,35864
51055,1578,1455,1364,1396,1172,1179,1319,9463
51056,411,413,464,499,473,465,478,3203
51058,903,1062,1091,1199,1077,1077,1007,7416
51060,575,566,591,592,552,579,615,4070
51061,726,653,698,630,473,489,510,4179
51062,552,563,636,532,536,699,526,4044
51063,1220,1227,1302,1253,1100,1088,1100,8290
51101,826,790,702,716,767,828,809,5438
51103,17688,17680,17592,17490,17831,17497,17453,123231
51104,22223,22801,23222,22509,21878,22112,22104,156849
51105,10333,9585,9465,9463,9509,8920,10216,67491
51106,26012,26316,26127,25854,26107,26825,26544,183785
51108,5931,5714,5582,6376,6401,5962,5566,41532
51109,3107,3073,2925,3122,3066,3111,3098,21502
51111,168,139,269,209,228,292,94,1399
51201,6020,6036,6156,6232,6069,6059,6193,42765
51230,468,493,512,581,588,595,462,3699
51231,398,433,362,284,256,160,282,2175
51232,663,772,761,910,993,1036,875,6010
51234,1171,1085,1167,1106,1142,1079,1268,8018
51235,1235,1115,1038,995,1007,1006,1079,7475
51237,1563,1665,1635,1597,1598,1560,1703,11321
51238,1132,1156,1273,1295,1284,1156,1184,8480
51239,3244,3291,3364,3318,3081,3250,3123,22671
51240,2180,1944,1755,1739,1672,1696,1746,12732
51241,1658,1755,1771,1846,1727,1680,1737,12174
51242,224,226,206,248,230,225,212,1571
51243,973,967,825,772,748,853,807,5945
51244,67,77,91,84,60,61,79,519
51245,1239,1237,1389,1517,1492,1595,1359,9828
51246,3385,3533,3752,3801,3918,3853,3844,26086
51247,5223,5189,5171,4954,4721,4380,4870,34508
51248,1782,1691,1576,1499,1495,1478,1857,11378
51249,3297,3195,3371,3455,3440,3514,3593,23865
51250,8391,8501,8332,8472,8425,8450,8249,58820
51301,12778,12897,12905,12879,12867,12490,12691,89507
51331,1023,1128,1111,1007,1007,968,1140,7384
51333,497,419,395,470,477,541,522,3321
51334,7197,7273,7334,7360,7513,7556,7661,51894
51338,974,947,913,901,895,1003,1000,6633
51341,35,56,68,72,74,71,49,425
51342,1200,1078,1112,1165,1232,1423,1249,8459
51343,333,296,222,169,189,223,238,1670
51345,419,455,401,380,417,453,403,2928
51346,2352,2299,2148,2269,2248,2389,2451,16156
51347,1443,1398,1336,1359,1515,1495,1431,9977
51350,621,622,637,566,486,454,411,3797
51351,4581,4518,4468,4521,4392,4365,4365,31210
51354,1028,1087,1109,1056,1122,1088,1096,7586
51355,843,850,929,766,693,696,874,5651
51357,589,593,797,801,795,807,728,5110
51358,1103,1220,1150,1284,1354,1298,1310,8719
51360,8346,8341,8365,8593,8581,8592,8031,58849
51363,168,184,155,138,162,188,130,1125
51364,653,663,668,579,577,620,690,4450
51365,382,376,451,436,419,464,453,2981
51366,343,372,355,367,398,462,379,2676
51401,11900,12096,12145,12086,12166,12153,12373,84919
51430,849,804,816,812,742,683,761,5467
51431,441,464,449,385,366,338,394,2837
51433,520,482,503,582,563,612,676,3938
51436,790,721,830,956,957,1087,904,6245
51439,1095,1198,1242,1149,1087,1021,1047,7839
51440,372,365,367,366,361,404,400,2635
51441,448,465,436,340,381,320,353,2743
51442,9908,9726,9747,9596,9614,9591,9838,68020
51443,1905,1865,1899,1836,1813,1772,1798,12888
51444,243,262,231,237,166,116,246,1501
51445,2786,2847,2799,2900,2830,2946,2867,19975
51446,513,524,585,517,505,609,511,3764
51447,187,171,162,150,175,167,228,1240
51448,484,484,592,653,662,641,611,4127
51449,2126,2086,2090,2000,1926,2008,2128,14364
51450,1393,1523,1533,1775,1767,1766,1583,11340
51451,133,106,102,112,101,102,116,772
51453,751,709,693,801,696,657,695,5002
51454,1616,1590,1345,1525,1534,1461,1346,10417
51455,2217,2302,2330,2358,2364,2586,2306,16463
51458,1476,1517,1588,1583,1623,1655,1467,10909
51459,72,74,79,91,130,112,75,633
51461,1026,1092,1159,1158,1144,1215,1165,7959
51462,1005,968,1007,1109,1003,1066,1013,7171
51463,657,662,669,649,639,587,552,4415
51465,766,764,666,751,789,749,733,5218
51466,1096,913,914,945,923,953,1092,6836
51467,661,681,670,624,668,719,615,4638
51501,34774,34701,34847,35025,35173,35076,35406,245002
51503,37603,37698,37381,36878,36673,36460,36376,259069
51510,3765,3771,3771,3763,3743,3720,3785,26318
51520,183,284,244,248,230,286,233,1708
51521,1882,1815,1856,1807,1831,1895,2036,13122
51523,375,367,355,359,302,285,357,2400
51525,1209,1116,1114,1089,1042,1096,1184,7850
51526,1406,1473,1315,1561,1861,1736,1753,11105
51527,454,429,493,438,498,512,530,3354
51528,750,749,788,846,788,946,931,5798
51529,1833,1948,1827,1944,1990,1805,1671,13018
51530,837,1042,1216,1198,1162,1050,854,7359
51531,710,727,823,825,828,858,914,5685
51532,779,671,644,689,657,573,622,4635
51533,909,894,1026,1014,930,975,895,6643
51534,9430,9464,9464,9495,9319,9219,9236,65627
51535,1910,1745,1901,1689,1616,1714,1923,12498
51536,399,344,415,433,387,399,448,2825
51537,6658,6764,6558,6598,6746,6503,6703,46530
51540,444,425,489,525,528,526,449,3386
51541,285,354,319,332,322,372,363,2347
51542,1109,936,1003,1071,972,1066,1011,7168
51543,543,473,453,449,423,401,445,3187
51544,827,887,870,984,1018,941,721,6248
51545,301,294,338,328,425,470,378,2534
51546,2774,2744,2742,2649,2778,2808,2915,19410
51548,365,337,343,367,311,359,433,2515
51549,401,419,396,408,364,377,465,2830
51550,151,157,148,144,173,206,181,1160
51551,1642,1767,1741,1652,1758,1831,1828,12219
51552,245,299,281,319,223,231,301,1899
51553,1074,1042,1232,1256,1167,1115,1013,7899
51554,130,140,157,195,204,167,187,1180
51555,5113,5154,5224,5425,5209,5225,5245,36595
51556,430,416,426,512,484,520,437,3225
51557,803,747,723,820,925,1074,873,5965
51558,430,471,609,567,665,553,560,3855
51559,1642,1739,1647,1660,1774,1722,1788,11972
51560,2307,2379,2371,2159,2121,2137,2099,15573
51561,1288,1224,1212,1151,1276,1454,1455,9060
51562,435,389,349,382,414,562,449,2980
51563,632,611,622,578,576,535,779,4333
51564,399,416,445,457,437,486,501,3141
51565,514,505,558,545,513,583,501,3719
51566,6497,6728,6831,6897,6961,6938,7035,47887
51570,998,884,841,768,838,961,1039,6329
51571,611,550,571,763,765,687,649,4596
51572,437,404,420,420,328,387,398,2794
51573,1175,1193,1160,1147,1121,1076,1093,7965
51575,1670,1726,1722,1640,1570,1463,1616,11407
51576,1984,2029,2187,1937,1987,1936,2110,14170
51577,1210,1186,1247,1316,1308,1441,1184,8892
51578,101,93,97,87,79,53,79,589
51579,2395,2429,2508,2499,2356,2284,2340,16811
51601,5938,5815,5833,5980,6007,6003,6025,41601
51630,200,231,213,172,152,174,173,1315
51631,266,279,260,270,266,250,306,1897
51632,7168,7103,7019,7062,7145,7031,7297,49825
51636,437,462,457,515,451,513,405,3240
51637,194,221,212,228,250,278,214,1597
51638,1301,1415,1476,1367,1369,1434,1299,9661
51639,719,748,850,942,981,1059,795,6094
51640,1552,1556,1562,1616,1687,1643,1748,11364
51645,296,303,303,257,253,240,262,1914
51646,656,672,721,809,867,949,763,5437
51647,92,92,95,156,197,211,141,984
51648,210,155,137,112,148,217,255,1234
51649,277,291,296,285,337,330,328,2144
51650,355,421,421,430,380,367,370,2744
51652,1573,1664,1639,1689,1621,1626,1783,11595
51653,1585,1539,1518,1525,1597,1508,1379,10651
51654,470,502,532,479,446,546,526,3501
51656,59,78,100,74,74,85,71,541
52001,43821,43787,43674,43799,43560,43698,43173,305512
52002,15877,15621,15519,14869,14569,14201,14559,105215
52003,13450,13297,13240,13377,13560,13578,13436,93938
52030,519,441,399,409,430,371,434,3003
52031,5368,5200,5444,5508,5490,5712,5120,37842
52032,1430,1541,1476,1397,1445,1238,1456,9983
52033,2961,3087,3276,3069,2950,3176,3202,21721
52035,1190,1145,1137,986,996,908,1010,7372
52037,1118,1150,1250,1310,1309,1351,1223,8711
52038,586,564,427,449,456,459,491,3432
52039,1115,1073,1094,904,808,878,1158,7030
52040,5749,5836,5727,5688,5535,5387,5526,39448
52041,1683,1798,1528,1481,1518,1682,1608,11298
52042,1515,1468,1718,1832,1791,1823,1999,12146
52043,2209,2146,2236,2269,2275,2338,2321,15794
52044,136,120,156,204,301,288,153,1358
52045,2599,2611,2549,2604,2537,2486,2589,17975
52046,2149,2352,2170,2241,2385,2326,2127,15750
52047,603,497,454,464,537,595,567,3717
52048,415,432,405,417,249,219,333,2470
52049,1492,1430,1299,1309,1394,1414,1270,9608
52050,712,742,767,725,613,609,515,4683
52052,3099,2968,2935,2849,3003,2888,3136,20878
52053,1033,1051,1053,983,886,985,1163,7154
52054,821,910,866,882,830,803,940,6052
52057,7555,7549,7694,7961,7973,8073,8222,55027
52060,8459,8469,8534,8555,8622,8703,8658,60000
52064,947,983,885,858,824,821,847,6165
52065,1097,1108,1149,1139,1071,1055,1130,7749
52066,70,57,79,80,72,120,80,558
52068,4403,4340,4195,4141,4011,3926,3924,28940
52069,1637,1620,1555,1589,1624,1633,1609,11267
52070,890,935,931,953,1013,1039,1128,6889
52072,221,241,225,294,301,385,381,2048
52073,1285,1289,1260,1341,1538,1263,1414,9390
52074,395,377,409,417,364,318,310,2590
52076,2331,2470,2462,2700,2479,2301,2295,17038
52077,424,415,440,456,412,403,398,2948
52078,856,921,843,884,1047,1025,914,6490
52079,865,808,854,835,657,753,782,5554
52101,13745,13910,13803,13845,13816,13938,13864,96921
52132,1774,1798,1888,1939,1822,1849,1938,13008
52133,604,615,592,625,575,558,558,4127
52134,368,358,376,448,403,350,285,2588
52135,731,798,942,787,975,865,864,5962
52136,5931,5905,6056,5937,5784,5836,5967,41416
52140,558,585,526,449,518,663,532,3831
52141,1582,1614,1514,1390,1456,1427,1435,10418
52142,1746,1640,1662,1662,1695,1765,1871,12041
52144,1508,1403,1291,1300,1265,1127,1261,9155
52146,975,1037,1007,1065,958,992,1039,7073
52147,1154,1245,1262,1109,1001,1028,1050,7849
52151,1796,1953,1919,1889,1977,2064,2138,13736
52154,796,810,831,817,754,727,995,5730
52155,1205,1128,1123,1076,1094,1125,1323,8074
52156,686,723,740,802,782,776,659,5168
52157,1656,1792,1863,1733,1790,1880,1828,12542
52158,257,262,264,259,275,289,314,1920
52159,2288,2448,2527,2583,2584,2596,2330,17356
52160,1207,1239,1123,1075,910,742,867,7163
52161,1536,1550,1473,1617,1569,1584,1505,10834
52162,3375,3284,3354,3378,3419,3369,3285,23464
52163,244,270,239,264,306,285,276,1884
52164,252,249,201,158,169,169,212,1410
52165,753,772,853,810,926,897,1004,6015
52166,125,126,105,109,83,77,104,729
52168,255,254,192,179,158,159,188,1385
52169,382,433,495,476,509,487,432,3214
52170,533,530,523,551,659,623,599,4018
52171,984,960,943,997,1027,1002,1048,6961
52172,5774,5607,5874,5949,6273,6351,6303,42131
52175,3582,3679,3745,3889,3718,3657,3492,25762
52201,1306,1384,1329,1194,1178,1113,1267,8771
52202,1011,1027,949,1003,1006,993,1152,7141
52203,1733,1875,1957,1926,1957,1941,1932,13321
52205,8685,8712,8636,8683,8595,8884,8682,60877
52206,2298,2498,2424,2482,2383,2464,2303,16852
52207,449,427,413,304,433,356,383,2765
52208,3098,2967,3084,3198,3051,3080,3153,21631
52209,1271,1264,1289,1281,1059,1022,1074,8260
52210,656,829,825,871,800,834,697,5512
52211,2382,2483,2499,2735,2714,2873,2624,18310
52212,180,187,201,194,246,279,285,1572
52213,4019,4139,4400,4437,4332,4217,4340,29884
52214,3642,3347,3355,3003,2981,3184,3090,22602
52215,650,727,706,749,832,856,843,5363
52216,1536,1526,1334,1555,1430,1402,1428,10211
52217,523,432,530,447,512,555,590,3589
52218,1855,1813,1864,1880,1921,1760,1788,12881
52219,184,156,199,180,186,207,178,1290
52220,375,304,313,285,248,179,237,1941
52221,218,229,202,171,196,184,221,1421
52222,591,662,700,720,644,576,709,4602
52223,1503,1608,1722,1592,1583,1574,1351,10933
52224,1852,2083,2127,2475,2411,2476,2016,15440
52225,318,311,314,305,335,322,447,2352
52227,3025,3035,2987,2988,2556,2639,2461,19691
52228,3292,3079,3035,2756,2669,2547,2772,20150
52229,801,818,904,813,776,715,721,5548
52231,232,254,254,299,253,283,328,1903
52232,179,181,194,139,143,140,178,1154
52233,7038,7079,7024,6974,7046,6998,6981,49140
52235,730,784,801,783,824,720,698,5340
52236,771,669,692,744,619,688,592,4775
52237,1482,1346,1306,1337,1405,1417,1522,9815
52240,33477,33679,33277,33544,32052,32113,32230,230372
52241,20107,20069,19709,19328,18931,18566,18911,135621
52242,1729,1700,1670,1688,1735,1767,1592,11881
52245,24606,24000,23391,22745,22786,22164,22573,162265
52246,22392,22374,22476,21360,21453,21300,21114,152469
52247,6129,5943,5618,5431,5273,5390,5645,39429
52248,1874,1858,1799,1951,1892,1913,1815,13102
52249,1052,1085,1142,1084,993,970,965,7291
52251,633,600,579,552,513,523,590,3990
52253,2961,3030,2821,2761,2853,3016,3192,20634
52254,842,820,812,765,724,819,895,5677
52255,1338,1202,1107,1108,1009,999,1208,7971
52257,273,270,206,178,158,142,210,1437
52301,3904,3604,3615,3641,3936,3743,3873,26316
52302,39070,38691,38349,37903,37247,36517,36980,264757
52305,569,573,453,625,596,562,629,4007
52306,1661,1787,1875,1944,1864,1964,1754,12849
52307,78,88,52,54,65,147,90,574
52308,133,179,161,148,138,170,132,1061
52309,460,372,341,373,416,421,397,2780
52310,6609,6445,6465,6592,6475,6249,6431,45266
52312,128,107,155,130,114,150,115,899
52313,352,433,384,389,355,387,397,2697
52314,6401,6507,6042,6027,6163,5869,5865,42874
52315,1208,1098,1158,958,947,921,1222,7512
52316,1637,1668,1509,1563,1553,1655,1659,11244
52317,18435,16635,16204,15310,14688,13882,14775,109929
52318,802,870,858,1158,1180,1188,1033,7089
52320,1166,1174,1107,1109,1215,1078,1203,8052
52321,523,548,580,522,531,618,404,3726
52322,2718,2785,2357,2466,2549,2681,2436,17992
52323,918,1083,1141,1138,1221,1193,867,7561
52324,1871,2068,1822,1956,1757,1689,1890,13053
52325,864,863,926,971,919,996,873,6412
52326,473,500,447,461,487,487,547,3402
52327,3221,3364,3430,3640,3841,3619,3012,24127
52328,2895,2906,2719,2713,2646,2619,2826,19324
52329,898,805,751,667,764,744,803,5432
52330,841,871,883,888,871,750,900,6004
52332,2210,2159,2056,1903,1910,1899,2006,14143
52333,6629,6476,6761,6763,6516,5883,6168,45196
52334,176,199,220,222,204,224,311,1556
52335,644,560,553,591,595,594,709,4246
52336,2154,2143,2437,2363,2317,2273,2363,16050
52337,718,814,920,969,1028,959,845,6253
52338,3435,3445,3323,3073,3138,3067,3283,22764
52339,4422,4525,4438,4435,4560,4561,4504,31445
52340,2548,2399,1963,2183,2140,2301,2180,15714
52341,923,1031,1229,1129,1338,1248,1093,7991
52342,3342,3107,2884,2880,2940,2992,3274,21419
52345,1472,1435,1455,1428,1437,1478,1468,10173
52346,1210,894,1104,1112,982,957,1085,7344
52347,1614,1659,1512,1515,1562,1336,1410,10608
52348,70,67,74,49,47,56,51,414
52349,7604,7433,7381,7350,7731,7746,7643,52888
52351,1410,1563,1607,1540,1673,1595,1455,10843
52352,1668,1679,1790,1668,1794,1929,2025,12553
52353,9551,8957,9014,8933,8858,8885,9173,63371
52354,345,390,338,327,326,322,379,2427
52355,325,331,297,241,267,266,277,2004
52356,2495,2638,2878,2912,2815,2961,2656,19355
52358,3638,3834,3810,3843,3622,3545,3733,26025
52359,281,346,252,254,284,313,279,2009
52361,4478,4593,4617,4395,4446,4470,4527,31526
52362,879,764,736,670,682,763,1041,5535
52401,2122,2103,2125,2116,2021,2123,2017,14627
52402,41189,40902,40029,40175,39847,38974,40149,281265
52403,22961,23197,22848,22718,22487,22745,23673,160629
52404,38337,38431,38687,38222,38614,38800,37796,268887
52405,25420,24664,24704,24901,24420,24134,23621,171864
52411,7456,7094,7255,7151,7394,7275,6896,50521
52501,29655,29898,29846,29993,29729,29759,30220,209100
52530,907,913,1016,1036,1068,995,1005,6940
52531,6073,6007,6067,5948,5978,6072,5976,42121
52533,1644,1558,1465,1626,1474,1519,1215,10501
52534,272,266,209,205,184,132,284,1552
52535,1034,930,847,884,769,725,888,6077
52536,1068,1091,835,896,818,834,967,6509
52537,7186,6904,6643,6430,6576,6650,7098,47487
52540,1271,1405,1376,1334,1441,1481,1420,9728
52542,541,516,438,380,340,250,435,2900
52543,392,331,543,517,518,595,291,3187
52544,7346,7546,7603,7657,7641,7502,7847,53142
52548,97,102,102,94,91,88,97,671
52549,791,567,573,564,556,574,762,4387
52550,391,410,483,480,603,581,585,3533
52551,426,496,543,605,625,630,688,4013
52552,839,953,1206,1231,1030,1083,830,7172
52553,1860,2031,1885,1708,1580,1595,1745,12404
52554,1277,1354,1453,1387,1683,1639,1373,10166
52555,357,316,306,343,388,424,344,2478
52556,13433,13279,12851,12637,12679,12341,13247,90467
52557,82,86,72,77,78,86,85,566
52560,534,511,565,483,446,444,430,3413
52561,989,973,913,882,968,927,962,6614
52563,1548,1615,1670,1755,1760,1765,1583,11696
52565,1943,2006,2035,1987,2057,2082,2027,14137
52566,179,177,173,158,155,149,168,1159
52567,782,707,688,628,639,614,615,4673
52569,579,611,572,633,549,659,610,4213
52570,924,969,778,1000,1034,1050,954,6709
52571,1632,1580,1587,1537,1552,1489,1407,10784
52572,1179,1209,1212,1318,1287,1443,1132,8780
52573,80,128,121,102,84,144,162,821
52574,762,836,846,776,816,910,826,5772
52576,488,487,449,475,449,467,568,3383
52577,15180,15020,15041,15091,14946,14956,15055,105289
52580,499,433,476,406,456,473,460,3203
52581,330,347,476,532,492,426,305,2908
52583,194,360,371,371,370,429,342,2437
52584,484,446,458,492,701,606,438,3625
52585,975,980,926,963,944,1002,988,6778
52586,371,370,366,400,429,477,521,2934
52588,29,30,88,97,131,88,134,597
52590,1234,1387,1404,1278,1239,1262,1246,9050
52591,3149,3177,3302,3099,3011,2903,3028,21669
52593,113,104,121,150,209,210,142,1049
52594,384,359,359,451,442,444,399,2838
52595,482,506,492,512,541,481,416,3430
52601,29315,29590,29806,30090,29837,29642,29723,208003
52619,597,477,504,524,559,631,594,3886
52620,799,838,892,849,814,880,938,6010
52621,588,783,728,711,597,647,668,4722
52623,2056,2057,2030,1966,1999,1954,1993,14055
52624,194,235,197,215,160,137,290,1428
52625,2568,2541,2551,2678,2874,2916,2802,18930
52626,1591,1458,1636,1477,1499,1476,1346,10483
52627,13103,13139,13417,13414,13062,13770,13105,93010
52630,456,554,538,493,642,579,445,3707
52632,13184,13040,13013,13194,12943,12675,13086,91135
52635,762,825,884,765,905,982,675,5798
52637,2409,2274,2457,2359,2532,2781,2449,17261
52638,592,519,500,466,429,410,514,3430
52639,1898,2000,2049,1939,2257,2090,2002,14235
52640,1511,1484,1600,1606,1681,1706,1447,11035
52641,11917,12234,12210,12114,12095,12129,12357,85056
52644,324,316,271,323,463,501,412,2610
52645,3304,3091,3171,3109,2891,2809,3176,21551
52646,379,346,350,289,325,380,376,2445
52647,197,200,247,232,226,242,229,1573
52649,933,805,847,1030,1036,1034,887,6572
52650,805,769,691,706,807,782,826,5386
52651,695,660,934,820,797,833,646,5385
52653,3413,3543,3502,3480,3588,3670,3570,24766
52654,1557,1693,1618,1866,1779,1780,1728,12021
52655,4606,4804,4595,4502,4314,4211,4219,31251
52656,2311,2542,2524,2292,2382,2183,2359,16593
52657,73,54,42,42,54,45,95,405
52658,788,867,746,863,810,888,1071,6033
52659,1560,1487,1573,1523,1701,1826,1553,11223
52660,171,137,137,155,151,143,226,1120
52701,113,88,101,103,120,116,108,749
52720,940,1024,1167,965,1203,1067,861,7227
52721,689,659,689,795,849,794,798,5273
52722,36393,36110,35647,35289,35022,34462,34754,247677
52726,5300,5199,4978,4739,4337,3860,4468,32881
52727,239,392,409,451,556,571,409,3027
52728,1093,1069,986,909,864,810,1110,6841
52729,873,844,782,763,829,763,874,5728
52730,4888,4785,4924,4937,4940,4860,4950,34284
52731,898,827,703,712,726,613,894,5373
52732,27424,27958,28130,28379,28613,28621,28293,197418
52737,445,403,417,398,279,265,384,2591
52738,3789,3762,3574,3536,3713,3476,3567,25417
52739,796,687,788,860,785,1065,745,5726
52742,7778,7972,7958,7830,7537,7565,7618,54258
52745,634,606,567,526,607,494,633,4067
52746,869,846,967,977,942,1002,967,6570
52747,2233,2223,2189,2184,2099,2034,2106,15068
52748,10235,9899,9671,9253,8967,8365,8850,65240
52749,1164,1249,1264,1341,1316,1424,925,8683
52750,621,566,627,547,493,550,619,4023
52751,924,943,952,864,893,1010,1054,6640
52752,449,494,463,520,477,535,515,3453
52753,5505,5395,5244,5483,5340,5205,5153,37325
52754,1374,1330,1322,1447,1334,1375,1274,9456
52755,2037,1937,1988,2032,1963,1881,1928,13766
52756,2068,2060,2082,2040,2106,2442,2133,14931
52757,203,146,154,153,183,191,201,1231
52758,189,193,194,202,231,220,199,1428
52760,358,312,312,372,361,390,533,2638
52761,30273,30479,30542,30409,30635,30328,30678,213344
52765,418,377,424,359,346,353,453,2730
52766,957,924,836,831,851,843,820,6062
52767,169,189,199,174,177,248,349,1505
52768,1440,1430,1333,1177,1184,1280,1426,9270
52769,656,681,777,835,836,853,671,5309
52772,4791,4748,4997,4951,5070,5294,5029,34880
52773,2046,2083,2240,2199,2317,2347,2380,15612
52774,119,101,112,115,107,137,136,827
52776,4701,4553,4570,4473,4431,4566,4947,32241
52777,1323,1298,1265,1442,1472,1394,1357,9551
52778,4374,4207,4001,3735,3951,3983,4043,28294
52801,1015,945,1006,978,1130,1233,1122,7429
52802,10520,10436,10208,10500,10102,10156,10868,72790
52803,22676,22858,23308,23308,23291,23020,22174,160635
52804,27007,27218,27142,26954,27300,28006,27379,191006
52806,28498,28268,27837,27998,27622,27019,27503,194745
52807,15054,14770,14537,13847,13366,12904,13470,97948
53001,1866,1886,1912,1880,1820,1787,1901,13052
53002,2632,2655,2556,2501,2281,2293,2299,17217
53003,130,63,136,111,160,122,141,863
53004,3461,3371,3243,3360,3303,3205,3330,23273
53005,20032,19792,19739,19669,19749,19678,19425,138084
53006,1830,1915,1887,1814,1896,1900,1779,13021
53007,1816,1763,1746,1783,1816,1768,1841,12533
53010,7503,7559,7737,7700,7866,7693,7681,53739
53011,2373,2365,2292,2290,2121,2053,2260,15754
53012,18404,18409,18724,18868,18478,18662,18097,129642
53013,3260,3221,3209,3243,3321,3415,3308,22977
53014,7837,8023,8074,8069,8187,8203,7962,56355
53015,2559,2634,2612,2647,2630,2653,2609,18344
53016,386,408,342,351,390,344,384,2605
53017,5890,6132,5894,5714,5440,5550,5538,40158
53018,7951,8002,8001,8120,7784,7590,7899,55347
53019,1894,1922,1927,1863,1840,1884,2027,13357
53020,3653,3536,3419,3468,3406,3386,3500,24368
53021,4834,4875,4887,4879,4770,4758,4709,33712
53022,19234,19204,19179,19090,19041,18908,18920,133576
53023,2593,2598,2565,2430,2341,2316,1496,16339
53024,16819,16952,16866,16725,16930,16459,16579,117330
53027,22355,22075,22117,22076,22119,21905,22041,154688
53029,20551,20839,21005,21019,20889,20757,20799,145859
53031,0,14,35,33,78,78,43,281
53032,4759,4706,4693,4684,4616,4739,4757,32954
53033,4889,4704,4650,4617,4776,4780,4885,33301
53034,1744,1903,1889,1960,1945,2069,1811,13321
53035,2550,2515,2509,2370,2353,2257,2406,16960
53036,2786,2718,2660,2460,2400,2704,2720,18448
53037,9741,9359,9195,8955,9098,8688,9260,64296
53038,4239,4132,4080,4060,3917,3911,4013,28352
53039,4669,4671,4740,4942,5006,4902,4863,33793
53040,8102,8118,8010,8357,8401,8166,8064,57218
53042,6880,6923,7145,7001,7197,7093,6690,48929
53044,2508,2595,2465,2392,2495,2332,2297,17084
53045,21218,21342,21292,21383,21428,21504,21686,149853
53046,1053,1108,1139,1106,1147,1112,1107,7772
53047,50,104,123,123,109,91,78,678
53048,3095,3023,3187,3121,3237,3198,3364,22225
53049,2692,2458,2295,2211,2291,2404,2451,16802
53050,6787,6793,6868,6860,6782,6933,6986,48009
53051,36177,35920,35859,35755,35656,35529,35651,250547
53057,1605,1661,1700,1671,1742,1817,1928,12124
53058,3705,3519,3490,3500,3734,3695,3243,24886
53059,1790,1810,1788,1784,1851,1847,1767,12637
53061,5264,5346,5174,5229,5089,5048,5196,36346
53063,1686,1567,1603,1598,1548,1504,1552,11058
53065,2346,2364,2279,2281,2258,2265,2226,16019
53066,34738,34584,34185,34097,34039,33499,33830,238972
53069,639,632,524,600,477,470,697,4039
53070,5028,5060,4907,4875,4642,4523,4713,33748
53072,24879,24907,24547,24027,24026,24077,23907,170370
53073,14496,14573,14719,14821,14972,15369,15757,104707
53074,12961,13034,13119,12700,12712,12877,12880,90283
53075,3102,3045,3000,3202,3352,3249,3345,22295
53076,3497,3355,3216,3282,3445,3398,3648,23841
53078,1794,1859,1917,2024,2084,1987,1912,13577
53079,1391,1338,1370,1360,1334,1298,1413,9504
53080,5882,5597,5495,5630,5432,5556,5715,39307
53081,43072,43310,43168,42804,43462,43357,43129,302302
53083,20031,19892,20128,20581,20062,20248,20362,141304
53085,11261,11160,11275,11016,11109,11128,11267,78216
53086,7992,8180,8089,8178,7799,8316,8255,56809
53088,442,424,454,477,438,462,379,3076
53089,18976,18691,18470,18241,18080,18211,18568,129237
53090,21894,21758,21948,22193,21906,21883,21873,153455
53091,1900,2040,2037,2071,2099,2034,2018,14199
53092,21221,21236,20917,20845,20472,20538,20024,145253
53093,1982,1992,2028,2053,1954,1885,1981,13875
53094,19492,19431,19354,19292,19197,18804,19169,134739
53095,27256,27317,27221,26755,27516,27062,27139,190266
53097,5626,5461,5534,5585,5883,5779,6319,40187
53098,11908,11952,11772,11837,11914,11841,11965,83189
53103,3728,3804,3911,3698,3749,3754,3724,26368
53104,5312,5373,5501,5703,5718,5652,5426,38685
53105,28985,29262,29413,29520,29632,29487,29225,205524
53108,3317,3116,3369,3470,3534,3773,3329,23908
53110,18478,18406,18382,18326,18275,18209,18320,128396
53114,2907,2930,2801,2703,2584,2743,2678,19346
53115,15998,15768,15861,16072,15863,15881,15788,111231
53118,7352,7370,7177,7248,6920,6724,7202,49993
53119,5441,5491,5665,5426,5503,5397,5608,38531
53120,9757,9798,9851,9811,9951,9909,9679,68756
53121,18874,19343,19331,19206,19672,19312,19045,134783
53122,6085,6077,6080,6036,6058,6065,5985,42386
53125,1888,1642,1619,1673,1654,1571,1895,11942
53126,7218,7044,6611,6472,6179,5996,6431,45951
53128,9020,8864,8588,8759,8123,8256,8947,60557
53129,14272,14275,14189,14143,14068,13949,13973,98869
53130,7802,7775,7768,7728,7713,7733,7755,54274
53132,35732,35502,35298,34983,34680,34112,34863,245170
53137,1661,1673,1878,2006,1951,1855,1702,12726
53139,2885,3069,3059,3030,3036,2847,2802,20728
53140,30015,30152,29689,30400,30856,30010,30017,211139
53142,31928,31513,32399,32273,31999,31993,32375,224480
53143,24159,24617,24007,23872,22829,23105,23264,165853
53144,27091,26955,27207,26609,27174,27504,27256,189796
53146,7919,7862,7601,7256,6993,7270,7458,52359
53147,16579,16709,16757,16984,16978,16972,16457,117436
53149,19515,19136,18899,19271,19221,19146,19057,134245
53150,25273,25221,25070,25048,24992,24751,24850,175205
53151,31745,31748,31994,32321,32484,32171,31987,224450
53153,2501,2305,2280,2239,2263,2247,2328,16163
53154,35218,34974,34823,34580,34190,33643,34451,241879
53156,2962,2979,3064,3054,2983,3227,2992,21261
53158,16420,16404,16380,16015,15951,15594,15917,112681
53167,573,533,493,463,415,541,399,3417
53168,8629,8774,8855,8711,8487,8124,8643,60223
53170,2472,2219,2232,2141,2157,2209,2380,15810
53172,21197,21229,21210,21163,21119,21068,21156,148142
53177,8329,8510,8557,8622,8641,8645,8329,59633
53178,2739,2664,2651,2750,2711,2730,2626,18871
53179,6729,6296,5961,6122,6370,6637,6310,44425
53181,7442,7359,7369,7208,7261,7124,7357,51120
53182,9419,9485,9534,9421,9327,9254,9412,65852
53183,2733,2962,2888,2951,2955,2997,2815,20301
53184,4291,4273,4368,4277,4385,4371,4271,30236
53185,18713,18542,18418,18360,18295,18370,18551,129249
53186,34025,34745,34879,34570,34685,34595,33592,241091
53188,35562,34580,34409,34950,34532,34044,35195,243272
53189,26212,26274,26444,25758,25240,25442,26228,181598
53190,19649,19587,19479,19330,18984,18936,19200,135165
53191,2870,2921,2920,2827,2870,2837,2842,20087
53192,69,101,132,108,155,229,217,1011
53195,111,89,98,79,86,129,114,706
53202,24830,24604,23947,23933,23290,23289,23386,167279
53203,1263,1177,1154,1106,1103,976,938,7717
53204,39895,39611,40650,42129,41529,41624,42355,287793
53205,10309,10091,10342,9575,9522,9635,10050,69524
53206,24805,26661,27426,29334,29046,29100,28210,194582
53207,36917,36700,36790,36058,36050,35233,35149,252897
53208,30979,31295,31116,32196,32518,31564,31133,220801
53209,45814,45350,45066,45906,45295,45687,46917,320035
53210,26683,26868,26661,26686,28052,27586,28126,190662
53211,35414,35402,34767,35125,35175,35142,35406,246431
53212,31788,31595,31138,31224,31065,31529,30416,218755
53213,26360,26772,26384,26046,25924,25860,26020,183366
53214,34752,34755,34397,34696,34789,34557,34725,242671
53215,61368,62120,61990,60508,59066,58677,60953,424682
53216,33174,33386,32801,32590,32231,32440,32264,228886
53217,29705,29383,29496,29051,28979,28746,29192,204552
53218,41387,41846,42503,40327,40323,40924,40625,287935
53219,34580,35234,35548,35358,35504,36202,33880,246306
53220,26388,26431,26974,26666,26286,25327,26303,184375
53221,40007,40295,39338,38135,37707,37137,37701,270320
53222,26082,25722,25777,25830,26362,26151,25165,181089
53223,28514,28918,28984,28177,28411,29101,29230,201335
53224,22416,21478,22096,22484,22849,21556,21284,154163
53225,26235,25879,25395,24755,24259,24163,25706,176392
53226,19247,18951,18932,19178,19246,18759,18370,132683
53227,23548,23112,23074,22833,22591,22777,23357,161292
53228,14838,14731,14250,14858,14579,14948,14369,102573
53233,15786,15731,15208,15341,15421,15379,16453,109319
53235,9335,9497,9411,9403,9325,9205,9270,65446
53295,213,224,161,135,104,73,359,1269
53402,32852,32679,32392,32223,31876,32278,33174,227474
53403,26251,27067,27323,27770,27413,28239,27432,191495
53404,15538,15354,15340,15272,16081,15258,15658,108501
53405,25166,25196,25187,25280,25619,25434,25193,177075
53406,26249,26057,26063,25862,25555,25415,25845,181046
53501,183,189,0,0,0,0,23,395
53502,2479,2517,2328,2347,2419,2439,2421,16950
53503,1921,1997,1898,1894,1891,1943,1947,13491
53504,2078,1969,2002,2021,2048,2093,2084,14295
53505,444,490,498,425,421,453,354,3085
53506,1031,1045,1066,1090,1137,1124,1125,7618
53507,2242,2293,2255,2265,2209,2202,2196,15662
53508,5597,5611,5552,5380,5454,5268,5262,38124
53510,1555,1573,1508,1540,1501,1438,1482,10597
53511,48764,48754,48760,48785,48932,48862,48929,341786
53515,2167,2241,2297,2301,2251,2253,2268,15778
53516,2304,2313,2224,2153,1994,1885,2152,15025
53517,1767,1753,1779,1694,1632,1578,1752,11955
53518,1328,1276,1250,1212,1124,1171,1330,8691
53520,6522,6522,6772,6741,6617,6676,6810,46660
53521,3764,3697,3643,3567,3603,3410,3656,25340
53522,1119,1067,1211,1246,1176,1163,1085,8067
53523,4770,4661,4835,4770,4653,4631,4949,33269
53525,3951,4022,3853,3740,3665,3826,4052,27109
53526,607,657,633,573,532,493,565,4060
53527,11018,10982,10878,10405,10072,9640,9963,72958
53528,6014,5826,5779,5699,5794,5700,5734,40546
53529,2118,2302,2260,2234,2153,2252,2031,15350
53530,4639,4724,4770,4863,4602,4466,4566,32630
53531,4537,4677,4439,4570,4430,4376,4338,31367
53532,14799,14312,14145,13676,13532,12871,13606,96941
53533,7381,7244,7227,7095,6937,6969,7276,50129
53534,11971,11731,11465,11442,11108,11330,11512,80559
53536,8944,8747,8806,8835,8782,8599,8503,61216
53537,692,625,706,674,681,647,781,4806
53538,18754,18663,18593,18671,18731,18685,18468,130565
53540,222,222,229,210,154,259,169,1465
53541,789,748,745,721,797,862,861,5523
53543,1660,1647,1658,1593,1729,1787,1641,11715
53544,725,760,783,731,762,791,800,5352
53545,22766,22837,22777,22376,22703,22547,23117,159123
53546,31470,31440,32039,32265,31906,31687,30648,221455
53548,18188,18046,17619,18042,18293,18562,18558,127308
53549,10213,10116,10133,10037,10147,10140,10414,71200
53550,1123,1235,1206,1295,1352,1352,1239,8802
53551,8343,8339,8421,8315,8267,8262,8273,58220
53553,551,555,618,625,659,622,624,4254
53554,1319,1270,1183,1134,1112,1042,1134,8194
53555,8360,8446,8493,8523,8469,8470,8465,59226
53556,2655,2571,2620,2681,2750,2682,2594,18553
53557,378,442,472,467,481,531,482,3253
53558,11450,11221,11037,10844,10681,10136,10742,76111
53559,6046,6017,6044,6087,6121,6147,6063,42525
53560,3656,3570,3510,3488,3538,3414,3458,24634
53561,1703,1577,1469,1505,1519,1511,1618,10902
53562,25209,24904,24595,24448,24071,23560,23627,170414
53563,10648,10679,10677,10448,10529,10613,10728,74322
53565,4866,4849,4978,5014,5147,5159,4765,34778
53566,15124,15133,15059,15180,15225,15280,15217,106218
53569,1253,1150,1109,1081,1098,1028,1155,7874
53570,2690,2682,2676,2615,2550,2456,2627,18296
53571,277,297,227,317,327,399,280,2124
53572,10634,10269,10051,9849,9676,9721,9970,70170
53573,3126,3262,3184,3082,3056,3017,3062,21789
53574,3894,3897,4001,3830,3820,3855,3877,27174
53575,15825,16070,15818,15558,15437,15338,15494,109540
53576,2351,2431,2405,2452,2528,2458,2319,16944
53577,1477,1445,1409,1451,1448,1481,1371,10082
53578,6293,6152,6262,6225,5953,6013,5924,42822
53579,1695,1690,1719,1911,1834,1940,1760,12549
53580,586,586,606,711,717,705,564,4475
53581,10299,10438,10723,10846,11099,11155,10699,75259
53582,1058,1013,953,987,998,982,1079,7070
53583,5934,5839,5828,5770,5827,5606,5747,40551
53585,2285,2164,2083,1969,2029,2026,2215,14771
53586,2237,2239,2270,2257,2357,2363,2284,16007
53587,1225,1225,1250,1271,1292,1282,1290,8835
53588,3926,4013,3977,3831,3898,4008,4077,27730
53589,20249,19919,19876,19850,20129,20208,19427,139658
53590,38697,37989,37430,36715,36112,35308,36294,258545
53593,21822,21240,20995,20431,19546,19050,19225,142309
53594,5060,5152,5098,5103,5136,5155,5144,35848
53597,18247,17792,17142,17050,16883,16594,16844,120552
53598,2267,2558,2520,2682,2652,2995,2511,18185
53599,70,75,88,95,70,57,69,524
53702,64,39,42,38,37,0,50,270
53703,30214,29286,28255,28111,27280,25973,27958,197077
53704,45295,45130,44208,44206,43142,44075,44034,310090
53705,24301,23703,23661,23267,23683,23886,23494,165995
53706,6228,6271,6168,6281,6251,6516,5133,42848
53711,48328,46539,45589,43977,43555,43487,45728,317203
53713,22922,23734,24095,23044,23506,22027,22146,161474
53714,16243,16686,16266,16081,15735,16064,16463,113538
53715,14466,14009,13754,13406,12738,12235,12136,92744
53716,18602,18318,18333,18320,18195,18538,18419,128725
53717,12554,12227,11997,11775,11753,11673,11962,83941
53718,12092,12013,12342,12396,12510,11693,11753,84799
53719,31341,30845,29865,30564,30151,29538,28487,210791
53726,5623,5982,6090,6033,5740,5738,5177,40383
53792,0,0,0,9,15,0,0,24
53801,944,1005,1032,1028,934,867,878,6688
53802,38,32,42,49,50,36,58,305
53803,1307,1385,1317,1379,1405,1420,1306,9519
53804,1447,1372,1387,1446,1419,1398,1372,9841
53805,5237,5275,5478,5385,5377,5407,5269,37428
53806,1797,1726,1739,1826,1856,1833,1831,12608
53807,4963,4772,4654,4524,4671,4549,4843,32976
53808,1145,1155,1007,1069,927,996,1049,7348
53809,4234,3980,3851,3801,3827,3852,4120,27665
53810,397,416,401,437,441,408,429,2929
53811,3056,3077,3176,3218,3291,3393,3371,22582
53813,5859,5949,6087,6077,6128,6163,6075,42338
53816,807,823,927,942,923,923,810,6155
53817,151,148,160,186,217,243,205,1310
53818,15652,15431,15131,14800,14681,14610,15091,105396
53820,2396,2632,2668,2698,2715,2806,2532,18447
53821,8311,8300,8351,8360,8423,8408,8456,58609
53825,546,639,626,601,620,646,487,4165
53826,1166,1324,1296,1286,1378,1480,1332,9262
53827,255,232,219,235,265,253,292,1751
53901,14529,14370,14799,15046,14992,15136,14445,103317
53910,2976,3044,3055,2945,3138,3219,3508,21885
53911,1346,1421,1397,1330,1294,1283,1351,9422
53913,20486,20605,19981,19937,20159,19685,19881,140734
53916,22551,22492,22482,22383,22361,22433,22507,157209
53919,2747,2667,2677,2669,2814,2808,2629,19011
53920,421,378,401,369,387,339,414,2709
53922,906,976,958,966,1009,1061,1036,6912
53923,2131,2070,2139,2084,2082,2156,2098,14760
53924,1469,1402,1272,1241,1149,1134,1360,9027
53925,7965,7865,7857,7837,7758,7671,7781,54734
53926,1639,1592,1569,1624,1555,1455,1628,11062
53928,123,137,190,193,174,183,128,1128
53929,2817,2788,2592,2623,2695,2597,2782,18894
53930,1285,1259,1209,1277,1241,1249,1285,8805
53931,240,229,254,229,280,240,237,1709
53932,2439,2481,2366,2361,2354,2368,2573,16942
53933,4641,4333,4261,4174,4135,4174,4117,29835
53934,4582,4559,4603,4632,4536,4421,4396,31729
53935,307,317,354,322,320,305,307,2232
53936,2595,2342,2410,2555,2691,2838,1610,17041
53937,1057,1002,983,1048,1120,1118,1053,7381
53939,255,241,237,227,227,260,244,1691
53941,3118,3163,3185,2994,2860,2726,2932,20978
53943,1065,1038,1049,1032,954,905,1065,7108
53944,2062,2270,2331,2299,2283,2223,2224,15692
53946,4641,4630,4681,4416,4287,4391,4386,31432
53947,130,124,106,81,87,86,137,751
53948,8180,8106,8102,8276,8311,8384,8414,57773
53949,5869,5834,5934,6000,6117,6120,6011,41885
53950,5630,5390,5537,5502,5435,5567,5449,38510
53951,2490,2346,2692,2565,2484,2541,2601,17719
53952,3261,3419,3385,3344,3208,3223,4377,24217
53953,207,280,295,334,336,350,282,2084
53954,6754,7084,7156,7083,7002,7010,6926,49015
53955,5604,5621,5345,5324,5356,5261,5692,38203
53956,3268,3272,3309,3287,3280,3301,3397,23114
53959,13957,13821,13641,13507,13268,13129,13384,94707
53960,3531,3570,3242,3224,3285,3238,3268,23358
53961,834,821,855,770,834,804,837,5755
53963,13859,13961,13866,13822,13761,13917,13910,97096
53964,3601,3703,3684,3590,3531,3655,3604,25368
53965,9936,9887,9925,10265,10308,10141,10398,70860
53968,2322,2444,2460,2554,2472,2577,2329,17158
53969,345,324,390,379,464,510,419,2831
54001,7995,8151,8160,8175,8032,7856,8155,56524
54002,6535,6472,6293,6320,6474,6331,6278,44703
54003,900,888,903,900,1002,1073,1013,6679
54004,2590,2489,2551,2451,2382,2265,2317,17045
54005,2946,2822,2893,2983,2987,3056,3056,20743
54006,657,750,707,685,709,755,743,5006
54007,1195,1219,1390,1382,1488,1374,1188,9236
54009,2559,2398,2387,2337,2367,2460,2509,17017
54010,46,44,43,34,15,0,50,232
54011,6709,6630,6591,6492,6504,6730,6819,46475
54013,3359,3377,3329,3323,3303,3290,3475,23456
54014,2049,2109,2244,2401,2505,2476,2232,16016
54015,3475,3496,3416,3655,3435,3472,3586,24535
54016,31786,31349,31257,31006,30424,29694,30108,215624
54017,17302,17014,16741,16589,16442,16117,16743,116948
54020,6991,7167,7160,7424,7450,7195,7260,50647
54021,6724,6637,6676,6740,6675,6722,6622,46796
54022,22237,22264,21918,21786,21920,21771,22358,154254
54023,4022,3985,3980,3802,3882,4054,3833,27558
54024,4687,4717,4672,4544,4595,4700,4811,32726
54025,7224,7304,7109,7179,7010,7107,6864,49797
54026,1897,1757,1965,2053,2013,2076,1809,13570
54027,1052,1026,987,959,984,1051,989,7048
54028,2208,2246,2334,2178,2248,2243,2493,15950
54082,1400,1563,1678,1719,1860,1945,1696,11861
54101,2700,2666,2802,2758,2877,2829,2751,19383
54102,815,787,849,796,839,857,875,5818
54103,431,450,423,356,304,388,418,2770
54104,1136,1069,1080,1234,1129,1136,1051,7835
54106,5178,5130,4946,4941,4812,4967,4997,34971
54107,3655,3617,3574,3736,3713,3653,3727,25675
54110,5421,5291,5332,5390,5373,5509,5338,37654
54111,2186,2265,2353,2289,2349,2264,2132,15838
54112,2284,2261,2185,2189,2279,2164,2284,15646
54113,3486,3444,3407,3337,3294,3227,3325,23520
54114,5181,5263,5328,5280,5352,5414,5178,36996
54115,44141,43806,42463,41206,40335,39493,41178,292622
54119,890,1020,1101,1069,1052,971,1083,7186
54120,212,193,185,111,144,196,245,1286
54121,3212,3247,3279,3190,3102,3171,2982,22183
54123,275,278,244,230,234,201,238,1700
54124,3623,3656,3603,3843,3929,3987,3881,26522
54125,507,604,607,556,565,513,519,3871
54126,3807,3889,3844,3797,3725,3817,3625,26504
54127,94,94,29,34,48,87,76,462
54128,1719,1736,1706,1763,1756,1680,1778,12138
54129,3175,3102,2964,3161,3146,3246,3477,22271
54130,25919,25919,25865,25315,25194,24570,25108,177890
54135,3212,3056,3261,3320,3099,3037,3096,22081
54136,6343,6304,6377,6396,6356,6393,6406,44575
54137,1068,992,1034,1071,1131,1093,1115,7504
54138,868,804,763,832,867,907,821,5862
54139,3160,3124,3165,3140,3237,3252,3096,22174
54140,9315,9043,8788,8764,8727,8685,8533,61855
54141,2415,2638,2649,2561,2521,2508,2549,17841
54143,14946,14776,14694,14648,14870,14817,15225,103976
54149,1383,1307,1292,1213,1207,1108,1184,8694
54150,1191,1249,1048,832,1057,1118,1037,7532
54151,3411,3398,3404,3376,3494,3474,3556,24113
54153,7216,7314,7346,7228,7294,7136,7252,50786
54154,5474,5626,5488,5568,5545,5740,5548,38989
54155,6760,6298,6384,6327,6160,5678,5451,43058
54156,1494,1492,1345,1552,1661,1771,1535,10850
54157,5706,5961,6107,6188,6134,6140,5986,42222
54159,1371,1399,1484,1542,1369,1500,1434,10099
54160,303,303,251,216,198,188,253,1712
54161,2929,2916,2888,2844,2842,2935,2696,20050
54162,8930,8591,8628,8715,8944,9141,9065,62014
54165,7610,7459,7572,7697,7503,7845,7539,53225
54166,16556,16723,16848,17044,16979,17134,17002,118286
54169,2728,2681,2653,2624,2580,2490,2600,18356
54170,3514,3489,3559,3442,3586,3517,3730,24837
54171,3718,3656,3489,3465,3268,3212,3362,24170
54173,4045,4044,3768,3980,4311,4173,4095,28416
54174,2857,2831,2844,2853,2791,2806,3013,19995
54175,834,898,984,987,971,978,1018,6670
54177,2943,2870,2847,2876,2827,2872,2898,20133
54180,3279,3214,3135,2993,2908,2843,2861,21233
54201,5293,5372,5469,5352,5448,5346,5345,37625
54202,1283,1400,1543,1623,1654,1633,1240,10376
54204,1713,1714,1688,1680,1671,1623,1819,11908
54205,2127,2175,2042,2203,2070,2060,2177,14854
54207,180,182,178,190,174,176,176,1256
54208,6232,6297,6296,6299,6375,6090,6061,43650
54209,1301,1260,1241,1208,1188,1157,1195,8550
54210,991,931,915,818,764,786,897,6102
54211,259,253,200,201,228,219,277,1637
54212,1110,1044,1063,1095,1127,1124,997,7560
54213,1283,1263,1162,1376,1596,1341,1276,9297
54214,236,210,221,216,248,229,334,1694
54216,6411,6155,6221,6214,6035,6136,6276,43448
54217,7064,7247,7391,7380,7567,7660,7405,51714
54220,39447,39330,39426,39854,39927,40083,40220,278287
54227,1606,1630,1615,1578,1575,1556,1568,11128
54228,2685,2762,2679,2588,2632,2563,2682,18591
54229,4454,4254,4046,4123,4230,4096,4306,29509
54230,4551,4765,4673,4594,4641,4580,4782,32586
54232,792,638,732,893,816,832,779,5482
54234,1455,1517,1495,1483,1488,1547,1614,10599
54235,16805,16884,17029,16980,16964,17257,17203,119122
54241,14602,14743,14802,14883,14789,14847,14884,103550
54245,2270,2381,2408,2340,2443,2420,2259,16521
54246,871,843,806,782,716,731,708,5457
54247,2204,2198,2249,2189,2249,2259,2339,15687
54301,22202,21971,22146,22552,22572,22828,22742,157013
54302,31219,31162,29699,29224,29765,29738,30611,211418
54303,27769,27882,28096,28548,28393,27155,27041,194884
54304,27656,27980,28330,27784,27707,28823,28153,196433
54307,1060,1237,1240,1265,1260,1221,1092,8375
54311,35101,34459,35121,34526,33620,33473,33580,239880
54313,37874,37466,37274,36884,36151,36016,35897,257562
54401,30890,31158,30896,30650,30333,30637,30702,215266
54403,25115,24806,24750,24611,24792,24229,24272,172575
54405,3006,2943,2884,2830,2730,2674,3032,20099
54406,3321,3378,3347,3367,3507,3482,3469,23871
54407,1606,1533,1535,1526,1448,1451,1515,10614
54408,990,1026,1059,1075,1086,1094,1068,7398
54409,12907,12974,13006,13056,13046,13175,13238,91402
54410,2469,2382,2400,2454,2250,2189,2392,16536
54411,5471,5618,5580,5722,5766,5669,5406,39232
54412,2027,1964,2042,2020,1962,1987,2181,14183
54413,110,97,132,109,138,158,191,935
54414,3476,3341,3395,3285,3358,3239,3404,23498
54416,1935,1883,1973,1914,1810,1784,1684,12983
54417,23,40,29,82,90,77,46,387
54418,991,959,1020,1069,1010,1075,1080,7204
54420,1385,1263,1415,1439,1269,1302,1307,9380
54421,3419,3270,3237,3134,3090,3122,3455,22727
54422,1338,1300,1339,1221,1272,1218,1209,8897
54423,2376,2296,2228,2278,2274,2210,2343,16005
54424,1734,1717,1800,1781,1776,1734,1651,12193
54425,2050,2142,2138,2163,2067,2139,2036,14735
54426,4570,4484,4526,4405,4344,4138,4479,30946
54427,1158,1027,1124,1223,1249,1238,1099,8118
54428,1017,1094,1080,1119,1139,1078,1127,7654
54430,131,118,128,134,127,120,135,893
54433,1792,1712,1682,1669,1660,1686,1845,12046
54435,2126,2090,2173,2111,2090,2154,2010,14754
54436,2270,2376,2407,2272,2332,2284,2203,16144
54437,3212,3267,3104,3154,3347,3155,3077,22316
54440,2992,3021,3056,3032,3068,3022,2964,21155
54441,792,840,805,765,949,889,828,5868
54442,1205,1148,1176,1149,1166,1215,1177,8236
54443,2226,2242,2376,2295,2203,2148,2137,15627
54446,3194,3169,3112,3044,3130,3183,3123,21955
54447,476,499,516,549,543,611,498,3692
54448,4076,4115,4307,4455,4541,4668,4249,30411
54449,26047,26148,26117,26061,25891,26013,26418,182695
54450,502,500,459,399,368,402,436,3066
54451,11614,11683,11859,11757,11712,11796,11755,82176
54452,18644,18941,19244,19304,19254,19590,19360,134337
54454,1427,1442,1349,1229,1304,1320,1279,9350
54455,17410,17449,17111,17063,17126,17138,17029,120326
54456,5870,5985,6026,6173,6387,6528,6085,43054
54457,8355,8274,8208,8490,8377,8310,8539,58553
54458,84,96,90,150,153,165,124,862
54459,1184,1222,1199,1256,1194,1294,1148,8497
54460,2712,2675,2604,2784,2716,2692,2746,18929
54462,297,292,270,356,413,418,348,2394
54463,650,748,719,772,836,763,684,5172
54465,585,602,670,675,734,718,536,4520
54466,2846,2923,3015,2942,2890,2810,2815,20241
54467,14009,13817,13808,13732,13722,13589,13635,96312
54469,1641,1665,1796,1854,1876,1832,1792,12456
54470,2118,2187,2109,2126,2136,2060,2068,14804
54471,1864,1854,1859,1825,1708,1657,1854,12621
54473,2494,2465,2447,2416,2461,2502,2700,17485
54474,3772,3781,3772,3733,3897,3790,4019,26764
54475,1593,1589,1644,1638,1660,1621,1482,11227
54476,18843,18843,18916,18963,18773,18806,18580,131724
54479,4150,4334,4165,4254,4198,4009,4119,29229
54480,1363,1289,1281,1304,1394,1461,1332,9424
54481,29389,29547,29435,29149,29014,28978,29340,204852
54482,9154,8999,8965,9206,9279,9317,8955,63875
54484,5014,5134,5179,5140,5028,5019,4984,35498
54485,379,330,313,309,281,315,322,2249
54486,2292,2396,2393,2383,2271,2195,2290,16220
54487,9673,9773,9459,9437,9436,9360,9594,66732
54488,1193,1073,1145,1265,1287,1299,1262,8524
54489,1627,1544,1558,1526,1533,1501,1550,10839
54490,835,853,894,807,866,806,893,5954
54491,1482,1591,1509,1495,1541,1533,1652,10803
54493,596,603,600,610,684,701,668,4462
54494,26163,26207,26354,26400,26769,26986,27126,186005
54495,7875,7997,8030,7936,7790,7846,7637,55111
54498,2475,2411,2426,2279,2190,2238,2421,16440
54499,3000,3079,2958,2992,2995,3115,3223,21362
54501,20010,19726,19931,19965,19801,19858,20019,139310
54511,1313,1282,1297,1272,1329,1254,1216,8963
54512,750,765,837,933,990,1102,833,6210
54513,426,414,429,407,384,382,478,2920
54514,1849,1873,1891,2037,1909,1921,1717,13197
54515,464,464,440,450,465,525,472,3280
54517,103,103,141,155,146,137,112,897
54519,1198,1165,1205,1132,1196,1196,1231,8323
54520,4223,4269,4264,4281,4298,4388,4141,29864
54521,7817,7783,7533,7189,7177,7201,7509,52209
54524,768,781,744,743,628,536,670,4870
54525,188,232,268,261,240,274,279,1742
54526,809,886,888,856,823,832,919,6013
54527,1067,1013,1002,937,1096,1055,1081,7251
54529,1081,1119,1085,1158,1170,1186,1133,7932
54530,859,876,860,822,791,799,868,5875
54531,1407,1507,1415,1459,1446,1471,1454,10159
54534,2209,2333,2360,2344,2244,2258,2459,16207
54536,205,207,220,218,243,197,184,1474
54537,561,537,610,547,504,463,561,3783
54538,3077,3076,3096,3162,3164,3238,3137,21950
54539,1241,1181,1239,1199,1334,1416,1383,8993
54540,923,933,917,1112,1136,1143,947,7111
54541,1273,1268,1299,1416,1466,1453,1552,9727
54542,419,400,425,522,466,433,470,3135
54545,893,807,810,910,853,882,736,5891
54546,1309,1293,1347,1321,1296,1297,1266,9129
54547,1491,1407,1283,1219,1356,1372,1392,9520
54548,4742,4657,4738,4743,4702,4657,4626,32865
54550,734,665,633,639,626,643,685,4625
54552,4056,4105,4225,4259,4431,4613,4416,30105
54554,1108,1131,1205,1256,1281,1266,1120,8367
54555,4758,4788,4765,4854,4958,5046,4872,34041
54556,1237,1231,1277,1225,1341,1240,1298,8849
54557,924,1036,1001,965,887,900,925,6638
54558,1937,2214,2386,2414,2434,2503,2177,16065
54559,772,783,833,734,727,757,795,5401
54560,548,433,439,498,537,545,589,3589
54561,37,15,17,17,9,13,35,143
54562,1884,1701,1752,1834,1863,1869,1948,12851
54563,713,703,699,726,616,679,720,4856
54564,433,459,506,445,455,391,387,3076
54565,63,73,106,101,97,102,60,602
54566,1376,1395,1400,1377,1432,1447,1496,9923
54568,4947,5053,5022,5016,5085,5095,5198,35416
54601,50874,50111,50298,49744,49395,49094,49282,348798
54603,13992,14509,14153,14335,14469,14608,14305,100371
54610,1564,1500,1538,1667,1653,1633,1624,11179
54611,1284,1202,1253,1223,1240,1267,1307,8776
54612,5126,5084,5213,5125,5109,4925,5152,35734
54613,1774,1813,1952,2055,2045,2079,1826,13544
54614,2860,3014,2940,2861,2919,2941,2947,20482
54615,10973,10921,10820,10665,10708,10544,10742,75373
54616,2680,2750,2659,2695,2696,2703,2601,18784
54618,2249,2280,2195,2381,2286,2189,2262,15842
54619,3858,3873,3705,3693,3785,3798,3923,26635
54621,1253,1167,1030,1054,1048,1015,1147,7714
54622,2074,2119,2167,2125,2083,2127,2121,14816
54623,1938,1939,2001,1952,1977,2129,1930,13866
54624,1465,1428,1383,1293,1290,1375,1383,9617
54625,274,258,259,260,262,278,240,1831
54626,1349,1326,1295,1291,1327,1325,1215,9128
54627,1807,1847,1900,1840,1852,1816,1819,12881
54628,968,1003,1092,1118,984,983,1092,7240
54629,2549,2559,2588,2484,2511,2552,2576,17819
54630,3949,4129,3983,3963,3864,3728,3770,27386
54631,1755,1743,1775,1884,1917,1950,1844,12868
54632,1048,1141,1119,1156,1188,1193,1247,8092
54634,4536,4381,4173,4252,4342,4447,4258,30389
54635,1736,1702,1761,1762,1718,1779,1799,12257
54636,14581,14414,14538,14312,13930,13374,13737,98886
54637,181,171,177,228,223,191,187,1358
54638,1453,1368,1503,1498,1514,1466,1487,10289
54639,2808,2481,2473,2607,2561,2417,2397,17744
54641,2,3,0,0,0,0,2,7
54642,2003,2063,2025,2050,2065,2057,2125,14388
54643,3,8,9,8,7,6,12,53
54644,1564,1489,1414,1313,1125,1111,1434,9450
54645,66,58,70,71,72,72,81,490
54646,3633,3977,4055,3911,4086,4102,3899,27663
54648,1648,1619,1551,1561,1702,1730,1737,11548
54650,23895,23766,23452,23231,23286,23015,23377,164022
54651,1443,1346,1355,1381,1395,1316,1382,9618
54652,946,964,994,965,980,928,953,6730
54653,948,983,904,883,1048,975,894,6635
54654,95,99,114,163,164,213,153,1001
54655,1912,1891,1796,1682,1688,1615,1778,12362
54656,17638,17443,17438,17268,17201,17254,17377,121619
54657,396,422,397,426,391,419,411,2862
54658,2453,2353,2361,2101,2204,2186,2501,16159
54659,1376,1394,1412,1628,1462,1494,1409,10175
54660,16151,16457,16513,16384,16014,15922,15688,113129
54661,3623,3467,3398,3423,3283,3372,3415,23981
54664,1589,1731,1596,1566,1425,1328,1516,10751
54665,8184,8125,8420,8635,8505,8423,8427,58719
54666,2620,2609,2537,2571,2414,2408,2593,17752
54667,4799,4895,4854,4748,4705,4697,4599,33297
54669,7798,7810,7708,7760,7583,7564,7619,53842
54670,2016,2077,2124,1935,1937,1829,1878,13796
54701,40704,41204,41161,40455,40259,39271,38803,281857
54703,42910,42296,41715,42197,41550,41991,42272,294931
54720,7362,7181,7077,6947,7005,6979,7039,49590
54721,1344,1309,1354,1459,1392,1386,1373,9617
54722,4072,4141,4228,4220,4265,4010,4016,28952
54723,1166,1197,1218,1209,1186,1212,1191,8379
54724,7321,7196,7170,7237,7286,7219,7174,50603
54725,2780,2834,2863,2861,2903,2862,2897,20000
54726,1714,1775,1818,1713,1735,1750,1690,12195
54727,5122,5080,5118,5063,5108,5061,4915,35467
54728,6071,6229,6416,6235,6326,6302,6139,43718
54729,32295,32163,31938,31691,31369,31104,31469,222029
54730,4908,4976,5033,4768,4937,4989,4903,34514
54731,697,731,819,816,776,773,802,5414
54732,2889,2924,2969,2943,2855,2793,2924,20297
54733,1262,1200,1298,1305,1372,1411,1340,9188
54734,849,839,803,779,814,906,856,5846
54736,4076,4012,3901,3865,3960,3820,4127,27761
54737,567,538,524,520,493,464,487,3593
54738,3208,3084,3057,3056,3003,3043,3149,21600
54739,5088,5076,4841,4752,4549,4634,4950,33890
54740,2007,1984,2070,2221,2138,2092,2056,14568
54741,1808,1767,1666,1544,1565,1612,1577,11539
54742,4457,4221,4000,3905,4009,3973,4459,29024
54745,1979,2039,2076,2098,2110,2164,2261,14727
54746,761,761,715,722,673,674,746,5052
54747,2868,2765,2616,2583,2686,2622,2534,18674
54748,1378,1431,1365,1151,1042,1046,1217,8630
54749,1273,1229,1188,1179,1132,1140,1231,8372
54750,956,975,975,925,1021,1027,1062,6941
54751,25904,25848,25881,25904,25957,25674,25642,180810
54754,1551,1645,1778,1719,1729,1687,1552,11661
54755,7251,7332,7449,7555,7563,7751,7502,52403
54756,881,918,845,857,875,920,916,6212
54757,3467,3413,3439,3524,3380,3308,3314,23845
54758,4349,4578,4711,4776,4675,4777,4626,32492
54759,1502,1488,1502,1547,1565,1520,1533,10657
54760,244,219,211,180,209,188,255,1506
54761,1179,1234,1308,1335,1195,1192,1216,8659
54762,1273,1296,1230,1165,1167,1126,1246,8503
54763,1191,1183,1168,1255,1129,1140,1134,8200
54765,50,50,48,37,13,0,24,222
54766,1659,1505,1503,1632,1641,1673,1707,11320
54767,3537,3462,3394,3245,3208,3166,3221,23233
54768,6197,6104,6113,6138,6029,6034,5990,42605
54769,562,544,469,389,427,506,502,3399
54770,2168,2112,2155,2122,2126,2196,2101,14980
54771,4209,4158,4272,4360,4289,4182,4286,29756
54772,1045,1003,1083,1058,1098,1059,1103,7449
54773,3447,3396,3393,3330,3338,3349,3336,23589
54801,6536,6574,6643,6509,6426,6312,6493,45493
54805,1358,1430,1380,1551,1482,1567,1471,10239
54806,11586,11621,11521,11496,11631,11594,11810,81259
54810,2298,2210,2197,2261,2402,2366,2512,16246
54812,5387,5374,5424,5531,5520,5627,5728,38591
54813,616,595,559,555,577,623,601,4126
54814,2550,2580,2558,2632,2598,2485,2478,17881
54817,2143,2089,2123,2142,2139,2087,2188,14911
54819,2450,2588,2613,2551,2633,2678,2544,18057
54820,788,769,724,694,687,646,864,5172
54821,1320,1322,1338,1344,1395,1356,1276,9351
54822,4709,4682,4595,4585,4695,4435,4516,32217
54824,2276,2407,2390,2247,2047,2267,2271,15905
54826,784,725,760,832,801,855,807,5564
54827,201,186,177,162,151,139,221,1237
54828,673,731,699,879,887,907,678,5454
54829,5270,5230,5189,5151,5155,5235,5236,36466
54830,2932,2922,3060,3068,2986,2976,2752,20696
54832,403,422,420,457,450,451,412,3015
54835,878,945,965,892,939,919,1018,6556
54836,998,970,997,1105,1170,1148,1080,7468
54837,3620,3580,3508,3551,3752,3764,3778,25553
54838,1194,1261,1351,1366,1329,1314,1103,8918
54839,280,306,306,306,288,275,302,2063
54840,4290,4379,4384,4415,4376,4419,4643,30906
54841,338,344,306,307,251,304,259,2109
54842,141,132,88,70,54,88,185,758
54843,11694,11458,11404,11288,11234,11212,11487,79777
54844,255,260,234,236,229,239,267,1720
54845,140,156,156,144,168,140,147,1051
54846,580,535,525,591,594,572,547,3944
54847,2236,2275,2333,2322,2368,2283,2222,16039
54848,5872,5843,5890,5999,6156,6218,6141,42119
54849,2041,2102,2170,2100,2044,2027,1967,14451
54850,175,185,227,180,251,283,261,1562
54853,4182,4191,4164,4172,4275,4211,4009,29204
54854,932,993,1021,1037,1062,1116,990,7151
54855,872,934,969,951,800,788,774,6088
54856,1610,1518,1560,1530,1422,1451,1616,10707
54857,47,45,29,19,26,25,62,253
54858,1765,1713,1711,1655,1609,1608,1518,11579
54859,1617,1618,1529,1638,1727,1843,1896,11868
54861,175,192,130,190,204,193,150,1234
54862,262,253,252,268,245,259,261,1800
54864,1396,1353,1416,1447,1581,1492,1322,10007
54865,439,440,416,426,443,457,440,3061
54867,331,283,291,247,298,360,435,2245
54868,15380,15469,15571,15648,15472,15598,15512,108650
54870,1556,1599,1552,1666,1692,1734,1486,11285
54871,3231,3161,3199,3218,3288,3265,3105,22467
54872,2539,2635,2599,2575,2684,2707,2581,18320
54873,2654,2754,2671,2636,2653,2888,2799,19055
54874,3768,3807,3738,3688,3522,3436,3646,25605
54875,1075,1094,1065,998,1039,1056,1055,7382
54876,1474,1560,1781,1674,1637,1661,1551,11338
54880,30343,30329,30399,30396,30384,30470,30772,213093
54888,1274,1236,1266,1389,1339,1391,1345,9240
54889,2557,2701,2677,2739,3059,2820,2742,19295
54891,3239,3288,3311,3360,3422,3558,3389,23567
54893,3765,3645,3584,3636,3619,3671,3767,25687
54895,967,982,952,1022,1099,1069,910,7001
54896,1406,1420,1463,1514,1544,1563,1478,10388
54901,39378,38856,39490,38967,38361,38566,37710,271328
54902,22244,22523,22337,22553,22504,22226,22375,156762
54904,21130,20669,20626,20380,20723,20346,20623,144497
54909,2234,2357,2386,2418,2340,2278,2181,16194
54911,26392,26154,26451,25851,25841,25852,26674,183215
54913,19336,19081,18177,17940,17412,17032,17629,126607
54914,30511,30496,30563,30938,30958,31213,30475,215154
54915,42627,42465,42774,42554,41715,41564,41855,295554
54921,1125,1253,1304,1314,1262,1321,1326,8905
54922,1460,1418,1460,1481,1527,1534,1514,10394
54923,8778,8817,8840,8973,8892,8862,8733,61895
54927,571,495,428,439,531,482,538,3484
54928,476,468,483,442,407,392,450,3118
54929,8736,8887,9011,8830,8984,8922,8746,62116
54930,1638,1649,1756,1750,1700,1814,1786,12093
54931,291,208,284,230,235,233,260,1741
54932,1499,1407,1364,1306,1115,984,1185,8860
54933,257,283,264,307,207,187,231,1736
54934,359,296,208,121,84,102,148,1318
54935,42153,42270,42260,42245,42279,41901,41651,294759
54937,19203,19122,19080,19138,18825,18745,19112,133225
54940,3879,4012,3884,3772,3742,3870,4020,27179
54941,2380,2374,2412,2292,2557,2596,2613,17224
54942,9180,9227,9089,8977,8867,8489,8580,62409
54943,1863,1972,1833,1873,1903,1960,1923,13327
54944,8864,8656,8421,8322,8297,8114,8257,58931
54945,3505,3619,3527,3586,3422,3487,3545,24691
54946,102,104,56,56,57,59,108,542
54947,2398,2539,2444,2425,2450,2442,2601,17299
54948,226,234,226,216,262,277,320,1761
54949,3334,3370,3316,3325,3258,3292,3430,23325
54950,3041,3009,3040,3056,3066,3079,3083,21374
54952,26161,26122,25757,25714,25646,25583,25729,180712
54956,43727,43437,43251,43355,43223,42828,42696,302517
54960,2694,2517,2587,2596,2706,2727,2800,18627
54961,13904,13990,13904,14107,14096,14058,14266,98325
54962,1189,1145,1168,1109,1133,1133,1110,7987
54963,6979,7187,7065,7196,7172,7039,6917,49555
54964,1012,1099,1068,1052,1001,985,1022,7239
54965,1479,1400,1391,1410,1402,1343,1344,9769
54966,2246,2120,2018,1995,2011,1929,2008,14327
54967,364,321,446,492,522,595,434,3174
54968,2802,2836,2959,2948,2920,2841,2779,20085
54970,3849,3852,3833,4050,3876,3903,3902,27265
54971,10676,10755,10773,10893,10738,11085,10827,75747
54974,1429,1429,1356,1406,1452,1424,1581,10077
54977,1430,1335,1322,1381,1425,1495,1337,9725
54979,1310,1315,1409,1400,1499,1530,1472,9935
54980,103,144,142,120,132,141,149,931
54981,15248,15310,15398,15532,15655,15674,15426,108243
54982,6895,7189,7189,7132,7188,7099,7117,49809
54983,4563,4456,4480,4569,4664,4596,4642,31970
54984,3061,3119,3194,3156,3192,3326,2989,22037
54985,425,410,82,313,461,457,836,2984
54986,4642,4829,4745,4583,4310,4350,4770,32229
55001,2979,2959,2925,2918,2908,2916,2916,20521
55003,3604,3648,3674,3862,3514,3465,3471,25238
55005,4634,4326,4425,4450,4571,4314,4422,31142
55006,3995,4115,3969,3948,4024,3678,4069,27798
55007,2328,2329,2351,2500,2585,2547,2498,17138
55008,15268,15128,15081,14920,14754,14901,14685,104737
55009,7732,7874,7805,7984,7996,8176,8030,55597
55011,10352,10255,9991,10000,9696,9981,10170,70445
55012,1946,2021,2160,2204,2172,2113,2078,14694
55013,6650,7029,6845,6317,6623,6452,6541,46457
55014,27628,27671,27654,27703,27693,27355,27274,192978
55016,35237,35040,34764,34601,34369,34069,34204,242284
55017,839,820,754,768,851,809,714,5555
55018,1086,1053,1056,966,840,793,997,6791
55019,2026,2043,2035,1921,1866,1762,1817,13470
55020,3658,3576,3299,3554,3473,3373,3717,24650
55021,29697,29923,29952,29791,29787,29561,29732,208443
55024,33702,33866,33316,32547,32031,31001,32406,228869
55025,23992,24058,23639,23594,23283,23301,23244,165111
55026,380,383,417,467,440,413,455,2955
55027,3034,2988,2973,2832,2886,2800,3031,20544
55029,52,45,17,17,4,0,38,173
55030,1323,1392,1330,1357,1294,1413,1289,9398
55031,2206,2206,2160,2085,2118,2006,2035,14816
55032,3401,3313,3338,3340,3284,3386,3616,23678
55033,29796,29595,29612,29512,29372,29352,29488,206727
55036,82,68,50,53,34,38,71,396
55037,4853,5024,4971,4946,4862,4915,4940,34511
55038,21632,21477,21393,21029,20625,20031,20816,147003
55040,12668,12780,12775,12769,12710,12732,12568,89002
55041,7648,7730,7586,7653,7899,8149,7601,54266
55042,9132,8971,8830,8790,8821,8831,8840,62215
55043,3622,3526,3567,3537,3463,3505,3540,24760
55044,51190,49637,48915,48198,47414,46574,47218,339146
55045,7501,7373,7413,7562,7636,7700,7577,52762
55046,5456,5308,5369,5349,5339,5116,5211,37148
55047,2407,2753,2749,2910,2730,2689,2528,18766
55049,2566,2658,2703,2652,2688,2619,2476,18362
55051,9393,9478,9534,9623,9706,9885,9719,67338
55052,1845,1883,1780,1846,1834,2042,2090,13320
55053,1115,1010,1126,1010,982,1068,1009,7320
55054,2561,2666,2739,2481,2355,2214,2171,17187
55055,3459,3470,3455,3455,3459,3487,3418,24203
55056,13796,13871,13752,13717,13763,13725,13546,96170
55057,25131,24956,24933,24968,24524,24368,24602,173482
55060,28996,28944,28947,28884,28899,28924,28911,202505
55063,9452,9274,9502,9171,9147,9012,9348,64906
55065,1141,1138,1074,1135,1101,1103,1201,7893
55066,18447,18479,18423,18417,18344,18323,18564,128997
55068,28777,28640,28475,27832,27374,26844,27490,195432
55069,5503,5480,5566,5450,5500,5470,5540,38509
55070,7659,7578,7575,7502,7447,7262,7541,52564
55071,5618,5601,5562,5553,5689,5619,5569,39211
55072,4606,4616,4666,4570,4582,4547,4737,32324
55073,3674,3322,3202,3033,3116,2936,3237,22520
55074,2245,2180,2002,2000,2022,1992,2222,14663
55075,20303,20413,20368,20326,20308,20295,20152,142165
55076,21555,21214,21794,21740,21037,20700,21323,149363
55077,13124,13242,12500,12311,12842,12958,12572,89549
55079,8246,7993,8075,7937,7674,7490,8329,55744
55080,2428,2286,2333,2350,2392,2431,2607,16827
55082,36239,35630,35273,34673,34954,34578,35024,246371
55084,1710,1681,1745,1778,1776,1810,1628,12128
55085,454,471,483,478,439,411,417,3153
55087,414,413,395,428,382,375,268,2675
55088,1868,1834,1767,1697,1554,1486,1704,11910
55089,1899,1940,2043,2005,2018,1868,1814,13587
55090,363,358,366,520,424,494,401,2926
55092,11083,11139,11374,11462,11042,11153,10840,78093
55101,6984,6786,5999,5980,5621,5666,5592,42628
55102,17771,17584,17510,17220,16986,16669,18207,121947
55103,13666,13764,13288,13060,13526,12938,12991,93233
55104,45667,45411,45495,44348,43700,42521,43248,310390
55105,27119,27257,27560,27952,27055,27107,28455,192505
55106,56462,56578,56467,54648,54382,54265,52730,385532
55107,15310,15122,15543,15182,15664,15657,14776,107254
55108,15796,15450,15405,15382,15368,15430,14688,107519
55109,33498,32668,32153,31351,31356,30900,31444,223370
55110,39035,38815,38611,37810,37399,37419,37759,266848
55111,4,0,0,0,0,0,0,4
55112,45154,44533,44095,43711,43423,43181,43250,307347
55113,40807,40289,39628,39138,38991,38766,38994,276613
55114,3383,3363,3153,3217,2847,2538,3100,21601
55115,8989,9138,9075,9053,8811,8692,8607,62365
55116,24641,24723,24393,24311,24622,25030,23851,171571
55117,43878,43640,42928,43226,42476,42427,41649,300224
55118,28425,28141,27899,27718,27915,27994,27548,195640
55119,41552,41447,40500,40716,39120,38086,38966,280387
55120,4347,4205,4322,4321,4261,4276,4352,30084
55121,8124,8032,8112,8183,8012,7777,7861,56101
55122,31877,31291,30760,30443,30430,31023,30346,216170
55123,25972,26101,26181,26065,26096,25735,26030,182180
55124,50602,50309,49911,49632,49336,49020,49084,347894
55125,43288,43277,43051,42693,42918,42475,43281,300983
55126,26347,26069,25780,25559,25266,25085,25140,179246
55127,18094,17871,17224,17118,16893,16396,16782,120378
55128,28793,28642,28548,28477,28365,28330,28113,199268
55129,23411,22390,21493,20659,19240,18262,18697,144152
55130,16450,16474,16148,16223,16763,17273,17575,116906
55150,252,230,221,202,153,160,198,1416
55155,0,0,0,0,0,0,0,0
55301,11359,10982,10859,10645,10412,9956,10535,74748
55302,7028,7034,7006,7025,7098,7109,7107,49407
55303,48076,47167,46812,46557,46429,46163,46352,327556
55304,47935,47360,46901,46526,46030,45579,45967,326298
55305,19050,18819,18619,18535,18350,18627,19368,131368
55306,16422,16678,16389,16505,16069,15941,15935,113939
55307,3193,3300,3293,3399,3433,3614,3227,23459
55308,9512,9275,9000,8799,8834,8736,9064,63220
55309,18712,18634,18758,18718,18465,18066,18208,129561
55310,1292,1314,1407,1455,1454,1450,1519,9891
55311,36620,35614,34441,33912,32426,31565,32788,237366
55312,1535,1577,1488,1597,1566,1563,1595,10921
55313,23737,23413,23214,23493,23526,23475,23255,164113
55314,1272,1247,1414,1468,1416,1450,1337,9604
55315,5349,5140,5064,5005,4836,4672,4762,34828
55316,23929,23731,23591,23403,23198,22937,23089,163878
55317,21219,20637,20057,19506,19310,19132,19218,139079
55318,26508,26107,25954,25741,25449,25017,25493,180269
55319,5601,5388,5338,5193,5180,4999,5038,36737
55320,5038,5156,5063,4717,4641,4881,4973,34469
55321,5464,5464,5464,5338,5402,5412,5341,37885
55322,3308,3175,3162,3178,3181,3185,3163,22352
55324,1231,1269,1350,1315,1278,1279,1234,8956
55325,4509,4423,4421,4527,4525,4468,4610,31483
55327,3438,3598,3517,3386,3271,3264,3478,23952
55328,9166,9036,8852,8686,8623,8482,8541,61386
55329,1980,2000,1930,1906,1937,1877,2118,13748
55330,37886,37364,36989,36438,35709,35281,36440,256107
55331,17852,17622,17056,17387,17892,17366,17524,122699
55332,1603,1553,1554,1633,1754,1681,1922,11700
55333,864,938,960,957,903,993,856,6471
55334,2773,2766,2816,2916,2888,2894,2939,19992
55335,1800,1688,1678,1530,1591,1564,1629,11480
55336,7951,8003,8145,8016,8062,8158,8054,56389
55337,44736,44561,44656,44314,44607,44758,44356,311988
55338,1024,1054,1019,1034,990,967,1123,7211
55339,1008,992,965,1044,983,1091,988,7071
55340,7299,7179,6955,6453,6364,6504,6327,47081
55341,3019,2965,2888,2606,2717,2671,2850,19716
55342,1978,1990,1949,2065,2105,1986,2015,14088
55343,25561,25375,25259,25113,24724,24313,23933,174278
55344,16294,16009,15561,14985,15130,14864,13952,106795
55345,22109,22094,21957,21832,21736,21400,21147,152275
55346,16602,16632,16443,16405,16180,16058,16776,115096
55347,30310,30038,30143,30126,29533,29102,30069,209321
55349,4004,4046,4163,4006,3818,3648,3887,27572
55350,17682,17857,18013,18102,18228,18271,18280,126433
55352,9069,9196,8884,8828,8714,8507,8751,61949
55353,3204,3260,3259,3218,3377,3234,3162,22714
55354,2807,2641,2596,2769,2722,2725,2741,19001
55355,9656,9713,9681,9749,9789,9738,9656,67982
55356,5082,5400,5508,5966,6220,5909,5311,39396
55357,3356,3338,3294,3410,3436,3509,3246,23589
55358,5124,5102,4949,4933,5096,5059,4982,35245
55359,6503,6438,6141,6070,5678,5554,5954,42338
55360,2921,2754,2892,2783,2593,2336,2672,18951
55362,19035,19473,19010,18951,18764,18905,18089,132227
55363,4595,4567,4518,4615,4569,4529,4496,31889
55364,14675,14740,14728,14296,14544,14231,14353,101567
55366,439,492,518,537,598,567,443,3594
55367,959,950,967,980,1053,1014,913,6836
55368,2210,2303,2104,2031,2111,2306,2218,15283
55369,34514,33956,33811,33164,33481,32790,32524,234240
55370,804,843,869,863,846,835,802,5862
55371,16228,16612,16410,16356,16761,16144,16442,114953
55372,32541,31358,31003,30650,30281,30130,29811,215774
55373,5686,5644,5672,5457,5330,5178,5600,38567
55374,14391,14091,13932,13336,12327,12745,13576,94398
55375,5163,4998,4603,4548,4368,4056,4518,32254
55376,17159,17040,16864,16630,16325,15951,16242,116211
55378,29196,28734,28035,27357,26703,26563,26958,193546
55379,43533,42827,42276,41427,40784,39473,40416,290736
55381,2029,2049,1981,1933,2171,2062,2063,14288
55382,3794,3673,3412,3455,3187,3274,3563,24358
55384,1842,1731,1762,1862,1726,1538,1672,12133
55385,1268,1322,1391,1310,1341,1367,1291,9290
55386,7353,7175,7157,6784,6447,6188,6330,47434
55387,12989,13291,13073,12773,12439,12419,12249,89233
55388,5747,5727,5661,5617,5568,5566,5619,39505
55389,2550,2472,2567,2561,2600,2727,2643,18120
55390,2565,2651,2506,2503,2253,2203,2473,17154
55391,16172,15417,15304,14875,14389,14458,14486,105101
55395,2920,2857,2812,2774,2679,2867,2892,19801
55396,2094,2137,2159,2231,2274,2167,2252,15314
55397,2774,2672,2913,2892,2875,2690,2693,19509
55398,16109,15865,16022,16038,15782,15814,15540,111170
55401,7909,7573,7583,7543,7157,6943,6590,51298
55402,309,348,375,426,381,429,368,2636
55403,16245,15610,14992,14804,14489,14316,14985,105441
55404,27028,27714,29005,28309,27265,26775,27121,193217
55405,16440,16349,15920,15449,15105,14212,15411,108886
55406,32904,33846,32976,32493,32084,32462,32112,228877
55407,39903,39210,38596,37616,37364,37577,37881,268147
55408,31579,31202,30883,31130,31401,31373,29981,217549
55409,11701,11753,12096,11993,12698,12334,11615,84190
55410,19862,19864,19793,19395,19712,19883,19340,137849
55411,30703,30208,29284,27640,27739,26308,27428,199310
55412,22203,21732,21295,21680,21306,20694,22148,151058
55413,13187,13149,12852,12618,13073,13078,12934,90891
55414,32488,30389,28717,27702,27104,26793,28495,201688
55415,4210,3942,3567,3264,2905,2930,2604,23422
55416,30967,30707,30452,29820,29587,29046,29027,209606
55417,26008,25725,25794,26256,24963,24988,24875,178609
55418,30676,30750,30550,30096,29981,29994,29472,211519
55419,27390,26988,26405,26808,26733,26599,26406,187329
55420,22193,22430,22777,22223,21343,21597,21767,154330
55421,27767,27652,27156,27146,26914,26691,27035,190361
55422,28889,28777,28585,28074,28261,28291,27820,198697
55423,36166,36185,36101,35868,35525,35212,35375,250432
55424,9860,10032,9996,10031,10015,10097,9685,69716
55425,10075,9958,9368,9256,9452,9224,8952,66285
55426,25971,25798,25504,25495,25093,24722,24945,177528
55427,22733,22808,22915,22835,22282,22511,22919,159003
55428,31354,30104,29623,29491,29911,29281,29357,209121
55429,27535,27478,27137,27803,27224,26531,26751,190459
55430,23338,23545,22882,22993,22277,22404,21508,158947
55431,18308,18464,18470,18138,18175,17704,18435,127694
55432,30043,30254,30566,30423,30321,30461,30027,212095
55433,34428,33966,33945,34024,33953,34193,33613,238122
55434,29015,29060,28531,28398,28227,28466,28823,200520
55435,13449,13095,12638,12286,11954,11458,11592,86472
55436,12527,12143,12283,12555,12761,12964,13138,88371
55437,18309,18368,17785,17792,18034,17847,17484,125619
55438,16195,16606,16736,17042,16654,16590,16249,116072
55439,8875,8928,9002,8819,8772,8800,8750,61946
55441,18294,18176,17968,17753,17807,17647,17848,125493
55442,13075,13169,12892,12724,12970,12767,13217,90814
55443,32532,31775,32771,33116,33054,32266,32462,227976
55444,15696,16080,15565,14681,14079,14065,15667,105833
55445,11067,11217,10529,9862,9808,9786,9879,72148
55446,22811,21751,21210,20375,19467,18580,18695,142889
55447,21240,21145,21123,21435,21183,21466,21187,148779
55448,27731,27980,27864,27758,27786,27683,27863,194665
55449,27560,26449,25784,24826,23918,22631,23277,174445
55450,0,0,0,53,59,34,10,156
55454,8621,8294,7550,7331,7359,8128,8125,55408
55455,1029,1020,2037,1983,1960,2107,1050,11186
55601,70,81,114,91,122,112,105,695
55602,176,165,158,147,156,201,177,1180
55603,595,512,483,533,510,537,508,3678
55604,3106,3148,3199,3445,3436,3478,3360,23172
55605,621,609,549,525,505,464,565,3838
55606,252,213,200,162,192,252,272,1543
55607,141,150,100,103,136,126,134,890
55609,257,263,244,243,222,251,303,1783
55612,819,766,751,623,610,563,518,4650
55613,194,227,240,223,235,219,205,1543
55614,2355,2544,2492,2636,2586,2813,2627,18053
55615,223,231,258,217,228,237,256,1650
55616,7028,6966,7087,6936,6998,6745,6994,48754
55702,542,509,503,474,448,491,500,3467
55703,710,724,786,786,734,685,701,5126
55704,1107,1166,1126,1206,1280,1361,1128,8374
55705,3291,3276,3260,3276,3323,3260,3299,22985
55706,1751,1692,1650,1627,1657,1650,1825,11852
55707,3374,3507,3589,3568,3561,3580,3440,24619
55708,865,913,1079,1054,1148,1142,959,7160
55709,3922,4108,4122,4191,4130,4187,4075,28735
55710,1107,1132,1069,1142,1214,1154,1292,8110
55711,584,645,625,584,570,571,607,4186
55712,597,545,504,619,630,608,586,4089
55713,1135,1167,1127,1112,1076,857,1017,7491
55716,346,363,373,342,357,312,341,2434
55717,318,252,248,224,252,223,335,1852
55718,3378,3197,3400,3178,2974,2971,3281,22379
55719,5902,5850,5927,5931,5942,5929,5895,41376
55720,16774,16956,16754,17149,17040,17088,16999,118760
55721,3764,3594,3563,3333,3237,3156,3410,24057
55722,1087,1232,1129,1063,1105,1279,1200,8095
55723,2298,2426,2474,2500,2368,2545,2363,16974
55724,773,803,832,829,834,833,741,5645
55725,112,112,80,94,119,114,103,734
55726,1035,1017,917,841,926,789,1045,6570
55731,5873,5797,5936,5890,5987,5942,5820,41245
55732,1313,1318,1226,1259,1366,1504,1453,9439
55733,4776,4729,4677,4608,4633,4622,4616,32661
55734,6007,6210,6232,6188,6219,6294,6213,43363
55735,1737,1747,1735,1802,1892,1787,1809,12509
55736,1446,1473,1523,1481,1389,1407,1550,10269
55738,502,539,475,514,512,535,544,3621
55741,3428,3221,3185,3122,3087,3055,3164,22262
55742,405,356,355,311,303,324,344,2398
55744,20100,20433,20242,20589,20590,20643,20164,142761
55746,17039,17069,17145,17148,17149,17129,17228,119907
55748,1356,1311,1395,1459,1517,1564,1476,10078
55749,440,459,527,561,551,506,449,3493
55750,2085,2006,2025,2087,1967,2039,2025,14234
55751,1578,1508,1438,1469,1511,1591,1553,10648
55752,356,333,374,404,394,372,395,2628
55753,964,940,933,1064,1044,1042,989,6976
55756,451,440,396,413,359,353,431,2843
55757,818,932,903,932,953,979,866,6383
55758,125,146,152,142,161,143,145,1014
55760,3136,3187,3029,3097,2981,2933,3108,21471
55763,593,574,652,582,590,547,554,4092
55764,493,534,531,550,555,637,569,3869
55765,780,828,752,742,790,786,802,5480
55766,31,35,34,47,43,39,43,272
55767,4643,4626,4692,4615,4630,4576,4532,32314
55768,3032,2910,2878,2913,2874,2840,2843,20290
55769,2430,2430,2462,2534,2459,2311,2313,16939
55771,1798,1810,1840,1833,1828,1781,1680,12570
55772,89,156,113,75,74,72,76,655
55775,1407,1202,1197,1121,1177,1085,1205,8394
55779,3912,3849,3990,3943,3846,3827,3755,27122
55780,244,208,228,235,223,172,212,1522
55781,672,689,611,536,565,578,734,4385
55782,439,462,491,467,469,456,480,3264
55783,2138,2190,2339,2360,2494,2459,2437,16417
55784,105,108,88,79,74,94,89,637
55785,223,189,177,219,181,255,263,1507
55786,348,328,325,308,343,309,305,2266
55787,462,446,429,410,454,486,525,3212
55790,2168,2094,1870,1794,1908,1980,1866,13680
55792,9845,10024,10052,10000,10053,10181,10107,70262
55793,536,516,545,509,513,593,615,3827
55795,1663,1611,1543,1584,1655,1756,1629,11441
55797,1510,1417,1446,1574,1591,1588,1441,10567
55798,604,574,548,546,525,566,581,3944
55802,2245,2271,2178,2212,2243,2242,2442,15833
55803,17346,17143,16947,17151,17510,17307,17431,120835
55804,14525,14744,14709,14467,14108,14498,14592,101643
55805,9750,10218,9932,10149,10398,10127,10194,70768
55806,9070,9445,9495,9680,9848,9573,9576,66687
55807,10049,10029,10247,10265,9686,9896,9963,70135
55808,5797,5696,5806,5689,5861,6077,5846,40772
55810,8741,8859,8790,8980,8673,8688,8702,61433
55811,26662,26346,26739,26669,26499,26262,26246,185423
55812,12012,11544,11481,10999,10975,10712,10924,78647
55814,749,782,671,725,714,702,772,5115
55901,54293,53451,53242,52796,51007,50924,51917,367630
55902,23411,23026,22792,22656,22853,22537,21968,159243
55904,26934,26489,26244,26074,26193,25397,26332,183663
55905,0,0,0,0,0,0,0,0
55906,18181,18771,18353,17866,18023,18066,17598,126858
55909,1378,1337,1436,1361,1445,1500,1428,9885
55910,1479,1377,1465,1451,1517,1480,1423,10192
55912,28754,28775,28875,28806,28617,28599,28483,200909
55917,3585,3608,3602,3753,3686,3685,3696,25615
55918,974,1117,1081,1078,1035,958,982,7225
55919,1071,991,960,1026,1033,1155,985,7221
55920,7551,7321,7188,7104,7027,6819,7026,50036
55921,4793,4703,4816,4830,5009,4916,4964,34031
55922,833,785,857,757,859,893,1021,6005
55923,4558,4608,4588,4506,4328,4481,4469,31538
55924,1428,1325,1303,1341,1391,1406,1303,9497
55925,1213,1045,1099,1098,1178,1217,1113,7963
55926,813,716,677,739,739,742,853,5279
55927,4226,4202,4090,4029,3984,4089,4071,28691
55929,1274,1264,1215,1260,1160,1151,1209,8533
55931,337,332,330,335,304,299,330,2267
55932,2054,2143,2104,2285,2243,2376,2042,15247
55933,268,262,282,286,279,220,273,1870
55934,3310,3304,3357,3443,3542,3524,3338,23818
55935,873,977,956,921,879,835,939,6380
55936,1870,1865,1820,1820,1833,1748,1861,12817
55939,2073,2028,1979,2146,2086,2073,1963,14348
55940,2647,2691,2610,2632,2647,2699,2666,18592
55941,903,924,967,891,784,756,969,6194
55943,3092,3134,3097,3022,2976,2992,3059,21372
55944,7247,7235,7208,7145,6998,6832,7151,49816
55945,1188,1200,1217,1293,1329,1490,1458,9175
55946,3258,3167,3219,3217,3310,3330,3178,22679
55947,7481,7565,7489,7586,7673,7700,7513,53007
55949,1752,1786,1744,1699,1692,1679,1808,12160
55950,170,176,159,130,83,141,169,1028
55951,1359,1349,1331,1509,1485,1488,1567,10088
55952,2435,2477,2397,2429,2563,2645,2529,17475
55953,837,874,833,802,879,903,894,6022
55954,1419,1334,1421,1379,1396,1456,1442,9847
55955,2708,2697,2758,2694,2770,2717,2746,19090
55956,2008,1971,1935,1852,1800,1686,1962,13214
55957,664,644,700,705,741,655,756,4865
55959,2544,2598,2380,2287,2137,2205,2321,16472
55960,3262,3195,3017,3102,3104,2939,3134,21753
55961,377,346,402,441,497,469,447,2979
55962,741,742,757,804,781,769,763,5357
55963,5010,5112,5155,5137,5126,5042,4988,35570
55964,4456,4343,4399,4343,4356,4344,4389,30630
55965,2503,2478,2314,2203,2340,2249,2376,16463
55967,992,959,968,948,883,934,938,6622
55968,116,117,119,132,164,139,121,908
55969,1091,1128,1191,1198,1230,1316,1117,8271
55970,1070,992,1083,1087,1098,1128,1016,7474
55971,3256,3270,3421,3328,3287,3208,2993,22763
55972,5146,5097,5104,5036,4902,4892,4995,35172
55973,284,293,326,298,275,319,285,2080
55974,1926,2086,2126,2129,2186,2230,2132,14815
55975,4341,4390,4315,4435,4202,4369,4335,30387
55976,7815,7670,7607,7480,7477,7344,7582,52975
55977,204,233,213,181,211,187,203,1432
55979,1128,1154,1057,1049,1043,1081,1143,7655
55981,4059,4135,4202,4131,3975,4053,3961,28516
55982,426,460,441,431,459,409,436,3062
55983,1635,1590,1526,1499,1445,1450,1588,10733
55985,1893,1966,2084,2086,2051,2023,1858,13961
55987,35076,35221,35462,35624,35855,35512,35629,248379
55990,816,810,824,830,983,949,925,6137
55991,1284,1256,1220,1254,1214,1082,1490,8800
55992,4961,4907,5013,5069,4923,4892,4693,34458
56001,47620,47211,47040,46689,46348,45684,46327,326919
56003,14390,14302,14305,14236,14207,14206,14335,99981
56007,21038,21019,21084,21131,21217,21345,21228,148062
56009,1450,1479,1516,1602,1637,1594,1613,10891
56010,1253,1136,1138,1204,1268,1250,1129,8378
56011,8960,9023,8951,8835,8788,8733,8925,62215
56013,4387,4389,4399,4406,4420,4465,4531,30997
56014,697,711,689,714,688,715,797,5011
56016,962,983,967,929,1009,1066,1096,7012
56017,1622,1662,1666,1627,1521,1514,1620,11232
56019,875,882,957,1012,1030,1042,914,6712
56020,116,109,105,122,91,113,115,771
56021,999,1059,1041,1059,1110,1038,1038,7344
56022,74,74,89,85,57,44,70,493
56023,533,554,553,563,556,540,485,3784
56024,3083,2938,2898,2841,2829,2780,2759,20128
56025,460,507,474,507,494,513,507,3462
56026,2026,1930,1861,1863,1842,1852,2012,13386
56027,872,903,947,1013,997,983,969,6684
56028,1349,1307,1192,1160,1138,1080,1372,8598
56029,751,712,731,716,742,664,744,5060
56031,11975,11952,12141,12289,12344,12446,12401,85548
56032,342,335,302,305,255,261,313,2113
56033,342,351,324,361,352,354,345,2429
56034,640,658,637,645,584,499,496,4159
56035,369,411,453,506,503,560,546,3348
56036,1930,2008,1979,2028,2060,2032,1959,13996
56037,1585,1539,1470,1509,1571,1575,1635,10884
56039,1056,1047,990,928,876,926,957,6780
56041,1035,1027,1046,1025,1035,1077,1066,7311
56042,606,653,665,669,667,681,720,4661
56043,568,526,501,455,440,351,486,3327
56044,2161,1978,2016,2154,2001,1986,2082,14378
56045,919,920,948,843,799,843,813,6085
56046,89,62,50,53,73,72,94,493
56047,154,181,192,153,130,116,117,1043
56048,4158,4108,4170,3758,3628,3542,3898,27262
56050,1524,1654,1654,1567,1631,1605,1464,11099
56051,674,634,719,747,742,738,703,4957
56052,814,937,832,909,1042,948,699,6181
56054,801,866,879,989,981,997,923,6436
56055,3848,3944,3918,3917,3892,3855,3902,27276
56056,65,59,83,71,81,86,96,541
56057,3847,3737,3690,3801,3783,3983,3867,26708
56058,5798,5910,5899,5837,5975,6025,5985,41429
56060,390,409,431,453,419,396,452,2950
56062,3397,3275,3276,3180,3277,3573,3208,23186
56063,2757,2747,2782,2766,2718,2755,2724,19249
56065,2753,2805,2735,2874,2900,2978,2844,19889
56068,1011,980,1014,1001,996,1026,1087,7115
56069,4535,4582,4410,4428,4352,4291,4467,31065
56071,12199,12071,12123,11958,12025,11916,11817,84109
56072,2240,2268,2316,2112,2142,2073,2389,15540
56073,16699,16654,16616,16637,16693,16828,16759,116886
56074,1914,1976,1995,2006,2043,1995,2004,13933
56075,148,221,280,262,236,241,171,1559
56078,447,477,527,510,474,470,476,3381
56080,784,798,697,608,518,563,770,4738
56081,5871,5921,5929,6004,5957,5863,6098,41643
56082,14216,13920,13875,13806,13620,13468,13597,96502
56083,915,1003,950,913,842,821,874,6318
56085,5253,5331,5323,5340,5458,5464,5451,37620
56087,3062,3078,3115,3144,3124,3123,3179,21825
56088,1797,1942,1912,1880,1958,2004,1946,13439
56089,168,176,198,229,202,194,155,1322
56090,659,711,714,724,741,690,694,4933
56091,345,336,287,263,255,295,367,2148
56093,12575,12704,12728,13316,13404,13617,12831,91175
56096,3131,2952,3143,3090,2993,2997,3021,21327
56097,3716,3671,3775,3732,3892,3820,3715,26321
56098,2011,2131,2108,2061,2165,2324,2124,14924
56101,5917,5855,5818,5782,5836,5859,5867,40934
56110,1945,2011,1998,1980,1913,1893,1843,13583
56111,431,508,487,467,440,441,420,3194
56113,271,291,250,255,219,216,238,1740
56114,292,289,317,386,417,401,361,2463
56115,1339,1199,1216,1165,1224,1272,1366,8781
56116,690,651,654,615,600,574,628,4412
56117,387,340,363,398,389,363,399,2639
56118,391,382,420,452,448,455,421,2969
56119,968,1028,1060,1128,1129,1189,1017,7519
56120,1092,1132,1118,1097,1027,959,1121,7546
56121,617,593,633,623,670,649,659,4444
56122,603,586,582,507,557,548,586,3969
56123,493,475,448,436,460,456,514,3282
56125,64,69,76,64,63,62,65,463
56127,409,388,426,434,439,415,398,2909
56128,2062,2097,2079,2075,2045,2066,1984,14408
56129,836,741,759,745,797,744,741,5363
56131,2401,2412,2287,2373,2390,2376,2293,16532
56132,487,501,497,527,508,525,540,3585
56134,489,492,463,420,499,483,462,3308
56136,1090,1059,1050,1039,1012,1049,1118,7417
56137,1148,1068,1097,1058,1079,1030,1149,7629
56138,941,967,972,900,876,864,899,6419
56139,389,387,407,425,484,514,430,3036
56140,43,44,43,41,49,51,59,330
56141,315,324,313,332,327,320,323,2254
56142,969,912,933,949,995,987,981,6726
56143,4350,4442,4477,4509,4531,4529,4478,31316
56144,1119,1168,1107,1011,998,968,1143,7514
56145,615,647,658,614,624,652,622,4432
56146,49,45,42,50,44,94,40,364
56147,170,164,144,151,131,150,192,1102
56149,1160,1255,1229,1322,1328,1362,1268,8924
56150,2750,2631,2653,2720,2684,2639,2742,18819
56151,802,838,845,842,806,834,823,5790
56152,1488,1544,1501,1579,1686,1591,1507,10896
56153,184,212,180,140,143,145,224,1228
56155,386,443,446,487,468,452,419,3101
56156,5881,5871,5936,6052,6078,6017,6066,41901
56157,840,915,907,789,777,744,788,5760
56158,421,418,404,487,417,429,434,3010
56159,2751,2830,2891,3022,2976,3021,2928,20419
56160,184,185,178,192,183,168,214,1304
56161,332,326,340,326,345,381,400,2450
56162,217,260,281,309,365,361,285,2078
56164,5522,5625,5744,5911,6016,6033,5969,40820
56165,467,458,382,376,368,294,349,2694
56166,221,231,237,272,267,232,253,1713
56167,732,685,697,678,697,734,661,4884
56168,820,855,830,812,894,905,932,6048
56169,696,730,748,753,735,711,681,5054
56170,589,549,563,566,540,530,587,3924
56171,1833,1758,1690,1770,1592,1643,1821,12107
56172,3051,3071,3199,3157,3107,3123,3164,21872
56173,395,435,418,430,477,481,424,3060
56174,341,336,352,339,348,404,357,2477
56175,2980,2921,3035,3088,2996,3022,3085,21127
56176,1100,1089,1109,1072,1063,1048,1137,7618
56177,58,39,43,37,31,35,45,288
56178,1832,1777,1795,1721,1703,1683,1746,12257
56180,1397,1391,1527,1407,1393,1363,1408,9886
56181,1065,1134,1088,1148,1251,1173,1147,8006
56183,1342,1280,1237,1258,1287,1175,1263,8842
56185,600,578,561,526,502,511,560,3838
56186,337,372,398,363,345,372,388,2575
56187,14366,14338,14363,14186,14068,13966,14170,99457
56201,23227,23092,22990,23064,23060,22942,23173,161548
56207,251,245,210,233,223,249,251,1662
56208,2094,2133,2103,2123,2352,2601,2066,15472
56209,2267,2282,2241,2245,2261,2279,2339,15914
56210,5,9,11,17,16,9,13,80
56211,389,419,446,433,448,545,529,3209
56212,491,478,490,545,567,548,531,3650
56214,742,749,710,679,669,677,725,4951
56215,4336,4307,4388,4375,4399,4454,4693,30952
56216,726,686,698,634,583,602,670,4599
56218,570,576,533,565,588,652,628,4112
56219,931,817,882,890,981,1118,1082,6701
56220,2945,2986,3149,3033,3110,3191,3070,21484
56221,756,703,790,823,850,787,773,5482
56222,1964,1956,1926,1937,1917,1842,1984,13526
56223,1374,1338,1291,1262,1277,1239,1408,9189
56224,365,404,377,366,297,273,333,2415
56225,740,650,705,672,719,761,834,5081
56226,213,227,255,274,262,259,254,1744
56227,201,190,176,208,214,197,223,1409
56228,929,871,939,948,969,973,882,6511
56229,1901,1926,1775,1770,1859,1744,1871,12846
56230,848,874,805,867,777,800,854,5825
56231,418,455,427,422,404,408,390,2924
56232,2462,2446,2466,2425,2368,2268,2415,16850
56235,544,544,562,510,423,500,579,3662
56236,386,359,331,344,323,340,359,2442
56237,528,571,627,663,645,595,600,4229
56239,583,564,534,552,574,610,596,4013
56240,1030,1004,964,916,920,938,1042,6814
56241,3821,3840,3824,3986,3976,4139,4166,27752
56243,1718,1758,1760,1661,1618,1686,1725,11926
56244,1338,1379,1429,1414,1532,1454,1496,10042
56245,619,613,515,538,515,475,535,3810
56248,747,741,801,763,883,882,807,5624
56249,279,273,308,325,294,273,296,2048
56251,980,1073,1103,1086,1180,1097,987,7506
56252,1216,1264,1238,1249,1248,1147,1238,8600
56253,1110,1082,1041,1010,943,941,1015,7142
56255,342,363,338,314,334,330,394,2415
56256,2446,2536,2532,2526,2535,2616,2581,17772
56257,456,409,497,517,545,578,508,3510
56258,15367,15358,15523,15629,15662,15712,15617,108868
56260,876,815,908,892,860,991,929,6271
56262,712,745,768,790,772,721,724,5232
56263,504,489,499,456,461,459,541,3409
56264,2150,2208,2174,2181,2146,2181,2204,15244
56265,7548,7659,7637,7621,7815,7785,7757,53822
56266,1630,1612,1595,1718,1728,1787,1628,11698
56267,7007,7082,6955,6965,6894,6907,6807,48617
56270,911,950,959,924,963,1261,1061,7029
56271,1186,1188,1209,1250,1167,1114,1196,8310
56273,4832,4966,4825,4959,4916,4502,4797,33797
56274,110,124,136,148,200,217,177,1112
56276,354,345,344,318,347,270,298,2276
56277,3033,3018,3111,2965,3114,3168,3191,21600
56278,2624,2780,2784,2876,2810,2822,2601,19297
56279,1296,1402,1388,1419,1379,1351,1271,9506
56280,503,520,528,576,577,547,480,3731
56281,680,632,633,602,590,529,619,4285
56282,1449,1438,1428,1523,1581,1613,1510,10542
56283,6377,6406,6436,6500,6546,6611,6636,45512
56284,2263,2336,2265,2198,2224,2331,2111,15728
56285,1124,1184,1144,1149,1154,1115,1096,7966
56287,63,86,80,91,87,83,81,571
56288,4756,4704,4841,4612,4535,4966,4696,33110
56289,670,612,638,671,647,647,634,4519
56291,454,563,560,529,521,579,501,3707
56292,632,577,573,612,623,613,636,4266
56293,1129,1151,1156,1147,1116,1140,1223,8062
56294,66,59,69,62,69,72,84,481
56295,320,300,338,352,340,355,310,2315
56296,2067,2073,2077,2045,2032,2109,2029,14432
56297,912,866,872,842,822,804,867,5985
56301,33488,32943,32895,32766,32362,32702,32434,229590
56303,25535,25775,25838,25909,25975,25308,25984,180324
56304,16164,15962,16024,16045,16012,16272,16020,112499
56307,5212,5260,5152,5094,4994,5097,5157,35966
56308,24644,24606,24208,24063,24161,24198,23961,169841
56309,1346,1240,1208,1216,1193,1157,1185,8545
56310,5345,5347,5305,5273,5276,5253,5120,36919
56311,697,683,712,686,706,724,757,4965
56312,2371,2246,2255,2335,2253,2369,2365,16194
56313,78,89,94,79,78,82,106,606
56314,1195,1330,1323,1395,1285,1238,1258,9024
56315,1615,1651,1720,1750,1696,1646,1591,11669
56316,1493,1432,1427,1456,1439,1566,1580,10393
56318,1153,1174,1143,1116,1171,1148,1238,8143
56319,1423,1458,1507,1522,1522,1418,1321,10171
56320,8111,8069,8021,7949,7959,7944,8080,56133
56321,1598,1635,1592,1622,1627,1685,1536,11295
56323,556,552,556,588,543,579,496,3870
56324,1146,1215,1250,1220,1296,1347,1115,8589
56325,179,174,170,152,168,144,211,1198
56326,1570,1518,1600,1484,1517,1461,1526,10676
56327,801,770,762,696,691,604,803,5127
56328,151,134,116,86,103,102,128,820
56329,7399,7357,7276,7352,7336,7216,7367,51303
56330,1843,1860,1808,1759,1882,1898,1691,12741
56331,2021,1832,1793,1868,1827,1844,2019,13204
56332,1428,1243,1255,1190,1141,1184,1407,8848
56334,5582,5641,5476,5382,5447,5386,5497,38411
56335,226,221,195,185,191,161,199,1378
56336,1464,1510,1562,1582,1633,1706,1514,10971
56338,1634,1667,1731,1723,1707,1749,1691,11902
56339,1170,1254,1151,1143,1105,1000,1129,7952
56340,2255,2203,2272,2336,2387,2415,2288,16156
56342,2686,2651,2687,2729,2722,2723,2739,18937
56343,931,894,885,930,983,1001,926,6550
56345,14558,14596,14938,14947,14893,14854,14786,103572
56347,6918,6856,6903,7092,7123,7148,7062,49102
56349,832,814,789,768,806,828,733,5570
56350,559,578,531,573,556,578,570,3945
56352,5978,6001,6006,5976,6120,6093,5868,42042
56353,8979,8952,8836,8606,8601,8748,8996,61718
56354,1382,1404,1331,1354,1349,1433,1367,9620
56355,461,469,483,527,509,577,579,3605
56356,323,339,304,311,285,278,300,2140
56357,904,954,1014,1082,1036,1057,1029,7076
56358,3200,3221,3284,3353,3331,3418,3256,23063
56359,3746,3791,3864,4090,3899,3931,3878,27199
56360,4028,4022,4121,4309,4015,3925,3917,28337
56361,2294,2259,2378,2358,2327,2369,2403,16388
56362,5887,5630,5635,5602,5635,5722,5844,39955
56363,237,203,151,124,107,62,155,1039
56364,5396,5385,5239,5224,5299,5308,5416,37267
56367,6591,6658,6557,6443,6296,6170,6263,44978
56368,4724,4551,4560,4534,4532,4317,4239,31457
56369,639,653,609,575,522,452,528,3978
56371,102,131,92,132,117,107,99,780
56373,3077,3038,3011,2913,2897,2968,3051,20955
56374,10205,10089,10099,9908,9858,9682,9868,69709
56375,903,966,898,811,794,841,852,6065
56376,379,420,378,353,345,350,358,2583
56377,18156,17953,17801,17816,17459,16973,17648,123806
56378,7783,7931,7935,7789,7964,7862,7778,55042
56379,17008,16639,16440,16187,16125,16160,16163,114722
56381,2389,2288,2309,2336,2394,2338,2458,16512
56382,1453,1502,1545,1631,1497,1490,1540,10658
56384,421,348,354,367,412,401,328,2631
56385,824,857,1009,1089,1061,1045,928,6813
56386,613,622,702,758,903,959,652,5209
56387,6929,6750,6671,6659,6674,6712,6734,47129
56389,130,144,99,107,99,96,111,786
56401,29712,29342,29469,29231,29349,29639,29439,206181
56425,7869,7789,7646,7600,7581,7447,7655,53587
56431,8795,9042,9329,9132,9334,9228,8931,63791
56433,1790,1758,1697,1618,1608,1740,1840,12051
56434,295,309,346,303,182,187,235,1857
56435,2472,2570,2634,2767,2683,2715,2372,18213
56436,70,64,57,69,39,60,67,426
56437,1499,1458,1454,1380,1440,1388,1380,9999
56438,2905,2926,3015,2876,2934,2863,2949,20468
56440,1427,1490,1414,1453,1358,1466,1409,10017
56441,3631,3504,3542,3492,3351,3231,3596,24347
56442,2093,2273,2220,2366,2199,2246,2381,15778
56443,1354,1385,1454,1439,1567,1549,1417,10165
56444,3148,3031,2945,2970,3031,3169,3087,21381
56446,1493,1493,1470,1483,1485,1467,1597,10488
56447,998,1051,1139,1147,1090,1066,1150,7641
56448,265,289,259,341,330,353,332,2169
56449,1802,1975,1996,2034,2149,2198,1769,13923
56450,873,933,1004,1032,985,1073,1017,6917
56452,1891,1912,1853,1908,1937,1869,1755,13125
56453,915,853,822,855,838,768,871,5922
56455,1742,1745,1741,1640,1889,1819,1488,12064
56456,42,40,30,43,50,61,50,316
56458,290,262,293,338,311,282,357,2133
56461,3346,3431,3397,3315,3227,3341,3241,23298
56464,4474,4509,4386,4336,4184,4253,4336,30478
56465,1925,1986,1910,2045,2015,1905,2062,13848
56466,3180,3124,3118,3109,3032,3182,3116,21861
56467,2474,2371,2383,2383,2362,2337,2412,16722
56468,4650,4733,5055,5214,5283,5278,4589,34802
56469,1027,969,941,893,880,911,998,6619
56470,10610,10602,10522,10390,10412,10110,10334,72980
56472,7923,7613,7500,7393,7075,6731,7459,51694
56473,3450,3441,3393,3422,3559,3308,3380,23953
56474,3859,3663,3534,3378,3453,3511,4244,25642
56475,1721,1742,1638,1647,1693,1621,1655,11717
56477,2473,2472,2402,2550,2572,2649,2758,17876
56479,5186,5079,4806,4865,5255,5562,5384,36137
56481,2029,2203,2214,2260,2130,1973,2031,14840
56482,6672,6610,6794,6623,6734,6644,6666,46743
56484,3494,3501,3409,3315,3283,3152,3205,23359
56501,17202,16745,16639,16260,16367,16356,16290,115859
56510,2274,2231,2297,2240,2318,2285,2333,15978
56511,1876,1954,1808,1899,1827,1804,1878,13046
56514,3757,3774,3706,3621,3541,3488,3696,25583
56515,3152,3176,3111,3207,3179,3053,2892,21770
56516,257,290,247,279,299,298,294,1964
56517,242,291,277,295,244,240,279,1868
56518,382,367,345,356,378,317,388,2533
56519,325,276,295,335,305,290,300,2126
56520,4022,4079,4073,4021,4029,3983,3983,28190
56521,761,793,841,916,789,772,757,5629
56522,471,519,624,677,713,720,538,4262
56523,503,531,501,549,556,558,539,3737
56524,663,693,751,751,775,753,661,5047
56525,128,141,134,177,153,157,106,996
56527,757,759,774,813,729,714,840,5386
56528,1639,1708,1604,1554,1454,1562,1673,11194
56529,4237,4166,4104,4047,3996,3915,4026,28491
56531,1965,1927,1966,2035,1981,2030,1994,13898
56533,264,287,283,297,313,286,291,2021
56534,1215,1241,1215,1130,1075,1090,1164,8130
56535,1257,1285,1390,1425,1453,1413,1363,9586
56536,459,401,392,468,454,458,482,3114
56537,18726,18650,18677,18597,18541,18749,18548,130488
56540,2010,1993,1905,1961,1887,1870,1962,13588
56541,16,30,44,36,38,36,24,224
56542,2819,2943,2965,2964,2946,2901,2829,20367
56543,242,270,273,266,239,221,276,1787
56544,5288,5479,5276,5196,5444,5084,5294,37061
56545,714,706,658,655,574,562,682,4551
56546,277,271,315,410,434,492,346,2545
56547,2682,2850,2908,2866,2828,2812,2700,19646
56548,746,760,750,753,793,854,771,5427
56549,4471,4412,4310,4410,4338,4308,4508,30757
56550,445,463,394,364,375,348,414,2803
56551,2066,2187,2243,2123,2234,2166,2237,15256
56552,465,384,395,434,467,459,429,3033
56553,260,271,274,273,293,292,293,1956
56554,2631,2643,2595,2525,2438,2515,2709,18056
56556,1105,994,918,889,920,970,1160,6956
56557,2772,2712,2770,2839,2786,2740,2811,19430
56560,42755,42361,41737,41120,40604,39916,40766,289259
56565,51,66,132,145,155,170,107,826
56566,533,604,533,567,525,465,668,3895
56567,3546,3436,3483,3625,3565,3536,3169,24360
56568,185,146,167,191,177,215,142,1223
56569,1303,1384,1325,1282,1316,1313,1357,9280
56570,1183,1170,1242,1260,1310,1397,1238,8800
56571,1680,1642,1684,1570,1687,1684,1800,11747
56572,5385,5312,5149,5392,5377,5338,5454,37407
56573,6225,6344,6338,6252,6023,5991,5993,43166
56574,219,254,279,275,282,291,266,1866
56575,784,702,801,694,753,857,763,5354
56576,695,712,692,839,811,786,799,5334
56577,4,12,22,17,15,15,21,106
56578,735,733,774,848,804,759,747,5400
56579,1145,1038,1005,957,1011,1103,1136,7395
56580,1354,1271,1274,1290,1334,1278,1171,8972
56581,278,301,312,366,360,415,287,2319
56583,110,116,118,134,147,143,168,936
56584,1428,1511,1590,1626,1649,1625,1553,10982
56585,1133,1109,1207,1051,1032,1032,1049,7613
56586,1928,1832,1864,1798,1747,1827,1839,12835
56587,1417,1297,1397,1498,1518,1606,1404,10137
56588,579,574,582,561,593,553,568,4010
56589,2154,2203,2359,2337,2278,2345,1975,15651
56590,288,344,341,345,336,390,373,2417
56591,201,162,165,188,169,113,170,1168
56592,509,512,530,610,574,595,516,3846
56593,0,27,37,35,42,43,14,198
56594,450,424,372,355,325,381,440,2747
56601,33552,33548,33463,33418,33164,32729,32225,232099
56621,4804,4670,4680,4691,4575,4514,4639,32573
56623,2676,2684,2454,2491,2495,2721,2749,18270
56626,289,361,315,282,328,486,356,2417
56627,289,265,285,251,292,271,309,1962
56628,1613,1534,1567,1479,1542,1545,1681,10961
56629,193,177,233,266,268,332,197,1666
56630,2037,1998,1876,1895,1983,2149,2117,14055
56633,4481,4229,4318,4465,4283,4224,4541,30541
56634,1611,1641,1683,1772,1729,1586,1639,11661
56636,5036,4872,5034,4974,5119,5091,5137,35263
56637,247,254,235,226,182,178,227,1549
56639,409,442,447,420,454,420,459,3051
56641,258,286,331,329,349,380,324,2257
56644,807,850,864,837,849,997,787,5991
56646,447,389,390,346,345,343,355,2615
56647,787,803,839,762,721,754,839,5505
56649,9619,9861,9785,9931,9860,9539,9932,68527
56650,728,689,684,683,755,775,722,5036
56651,580,530,517,474,596,611,538,3846
56652,531,491,494,439,500,491,539,3485
56653,1244,1272,1391,1433,1468,1578,1336,9722
56654,137,124,123,126,116,152,153,931
56655,1460,1557,1539,1361,1333,1403,1303,9956
56657,315,266,218,195,180,179,304,1657
56658,0,0,0,0,0,9,6,15
56659,65,59,60,53,66,64,54,421
56660,319,255,291,291,319,367,240,2082
56661,1005,989,971,939,888,917,942,6651
56662,525,535,510,500,466,428,511,3475
56663,175,184,202,196,168,163,220,1308
56666,1034,999,871,855,1077,863,1066,6765
56667,607,705,779,724,663,647,662,4787
56668,156,149,121,138,160,168,136,1028
56669,356,309,328,320,372,400,375,2460
56670,1683,1757,1744,1720,1800,1970,1440,12114
56671,3212,3159,3279,3279,2938,2927,3371,22165
56672,2049,1997,2019,2114,2124,2054,2097,14454
56673,597,674,639,759,1060,898,795,5422
56676,1582,1631,1555,1475,1451,1515,1663,10872
56678,1205,1208,1165,1137,1193,1173,1321,8402
56680,147,141,117,112,85,78,117,797
56681,302,283,354,310,259,300,318,2126
56683,772,733,711,720,741,672,772,5121
56684,302,329,323,266,257,325,282,2084
56685,97,98,117,157,156,184,117,926
56686,1083,1071,1327,1231,1005,925,984,7626
56687,59,71,70,62,45,54,73,434
56688,127,127,144,142,153,129,157,979
56701,13072,12837,12691,12675,12520,12460,12690,88945
56710,655,619,623,568,509,500,490,3964
56711,20,22,25,39,56,62,96,320
56713,961,895,893,886,883,819,1022,6359
56714,1181,1124,1120,1179,1190,1168,1157,8119
56715,350,331,276,247,280,325,350,2159
56716,9367,9389,9464,9306,9297,9283,9416,65522
56720,18,24,55,46,72,70,57,342
56721,10094,10071,10060,9997,10054,9948,10096,70320
56722,387,379,421,412,381,386,386,2752
56723,982,983,924,819,871,905,970,6454
56724,138,151,150,140,119,140,159,997
56725,921,997,1032,1021,1136,1134,978,7219
56726,1730,1765,1752,1582,1536,1595,1631,11591
56727,666,719,738,815,799,923,769,5429
56728,1439,1411,1320,1402,1429,1463,1364,9828
56729,130,120,117,132,138,114,140,891
56731,71,78,67,69,75,73,93,526
56732,1080,1099,1090,1055,1075,1123,1136,7658
56733,427,451,473,432,405,370,390,2948
56734,503,483,485,451,469,461,467,3319
56735,783,774,839,839,764,756,816,5571
56736,1037,1034,1021,1007,933,904,903,6839
56737,824,820,831,872,853,844,871,5915
56738,1455,1428,1425,1454,1402,1379,1368,9911
56741,0,19,13,17,13,17,23,102
56742,817,887,908,898,973,1024,918,6425
56744,507,506,483,555,627,611,621,3910
56748,822,804,787,795,743,661,600,5212
56750,2365,2371,2476,2631,2590,2554,2539,17526
56751,5593,5563,5552,5501,5666,5609,5575,39059
56754,458,536,530,503,506,535,546,3614
56755,74,78,88,121,131,173,102,767
56756,655,643,684,743,759,807,799,5090
56757,983,1038,978,991,908,891,932,6721
56758,406,422,437,392,382,417,418,2874
56759,292,296,307,377,386,367,364,2389
56760,374,392,381,405,402,369,358,2681
56761,483,433,432,470,453,458,488,3217
56762,2430,2488,2532,2508,2697,2811,2494,17960
56763,5283,5403,5341,5333,5238,5384,5180,37162
57001,1823,1725,1746,1730,1537,1752,1672,11985
57002,1050,978,942,933,959,1026,863,6751
57003,2204,2127,1911,1936,1766,1724,1879,13547
57004,3549,3406,3585,3563,3473,3325,3356,24257
57005,11534,11285,11060,10610,10615,10130,10473,75707
57006,25712,25259,24959,24816,24372,24012,24530,173660
57010,388,398,343,505,531,516,493,3174
57012,1201,1098,967,971,973,1036,1160,7406
57013,4876,4863,4633,4434,4229,4262,4440,31737
57014,1302,1337,1424,1537,1583,1651,1471,10305
57015,809,793,802,687,856,809,787,5543
57016,662,691,713,647,729,678,693,4813
57017,1576,1515,1615,1567,1591,1492,1340,10696
57018,1357,1357,1389,1498,1462,1321,1372,9756
57020,1635,1608,1855,1894,1474,1487,1502,11455
57021,317,340,370,395,372,236,276,2306
57022,4663,4712,4727,4664,4682,4735,4996,33179
57024,462,486,478,547,484,557,428,3442
57025,2939,3008,2934,2849,2826,2738,2795,20089
57026,1340,1334,1297,1401,1377,1435,1458,9642
57027,142,92,85,128,158,191,109,905
57028,3480,3319,3171,3150,3235,3213,3448,23016
57029,1897,2037,2000,1849,1887,1911,2023,13604
57030,3030,3026,3293,3432,3514,3424,2959,22678
57031,820,733,624,692,740,741,741,5091
57032,7368,7157,6721,6864,6607,5957,5906,46580
57033,5373,5418,5353,5216,5168,4999,4713,36240
57034,743,909,800,740,765,760,712,5429
57035,1296,1171,1187,1176,1197,1167,1200,8394
57036,668,638,659,637,635,646,811,4694
57037,944,952,1034,1044,1137,1120,819,7050
57038,1511,1581,1523,1592,1813,1669,1667,11356
57039,3319,3470,3286,3162,3049,3260,3265,22811
57040,331,294,351,383,342,358,389,2448
57041,163,141,78,48,42,30,97,599
57042,9432,9342,9140,9062,8609,8342,8415,62342
57043,1419,1362,1335,1362,1391,1391,1378,9638
57045,1102,956,959,1061,1012,1127,996,7213
57046,897,714,651,651,567,554,626,4660
57047,287,234,231,308,276,240,256,1832
57048,1166,1139,1214,1204,1134,1254,1170,8281
57049,6121,6058,5974,5853,5751,5611,5789,41157
57050,210,188,236,224,254,190,191,1493
57051,255,262,246,257,269,275,263,1827
57052,486,416,415,373,401,394,452,2937
57053,1924,1932,1904,1965,1771,1888,1893,13277
57054,506,486,518,558,573,559,502,3702
57055,1046,986,900,1029,1034,971,1090,7056
57057,114,128,112,122,152,148,152,928
57058,1998,2090,2025,2040,2078,1971,1973,14175
57059,1296,1416,1426,1325,1448,1469,1522,9902
57061,89,114,162,127,122,179,102,895
57062,2370,2342,2343,2325,2287,2206,2410,16283
57063,800,864,922,977,994,1047,1006,6610
57064,5782,5579,5600,5291,5108,4901,5072,37333
57065,383,434,394,418,375,338,397,2739
57066,1576,1538,1628,1606,1649,1562,1508,11067
57067,415,471,456,439,483,457,537,3258
57068,1362,1408,1355,1343,1354,1540,1512,9874
57069,12114,12013,12091,11884,11905,11977,11988,83972
57070,1411,1398,1492,1466,1521,1517,1387,10192
57071,2918,3160,3067,2922,2821,2778,2758,20424
57072,480,565,656,710,762,662,584,4419
57073,754,802,786,841,777,763,711,5434
57075,1198,1046,873,791,855,936,893,6592
57076,242,271,316,300,383,493,521,2526
57077,1654,1624,1476,1252,1188,1343,1324,9861
57078,19004,19220,19048,18894,18699,18758,19121,132744
57103,35833,35689,35856,34784,34824,34225,34480,245691
57104,26487,25860,25489,26246,26806,27672,25901,184461
57105,21948,22710,23011,21984,21220,21616,22268,154757
57106,44575,43122,41763,41258,39873,38926,39852,289369
57107,9203,8915,8643,8174,8129,7507,8044,58615
57108,20596,19471,18729,17846,17090,15771,17267,126770
57110,15555,14662,13531,13395,12736,12237,12309,94425
57117,45,51,57,55,43,38,61,350
57197,923,921,859,713,665,631,959,5671
57201,25266,25197,25172,24982,24701,24693,24983,174994
57212,1868,1908,1915,1816,1837,1838,2062,13244
57213,595,490,513,431,397,457,485,3368
57214,55,57,50,55,67,65,75,424
57216,1033,1056,1130,1018,982,933,1044,7196
57217,351,283,310,288,269,158,244,1903
57218,401,386,331,327,305,253,327,2330
57219,475,522,537,727,777,828,567,4433
57220,741,722,781,764,948,887,767,5610
57221,750,793,712,829,855,790,808,5537
57223,1198,1280,1330,1311,1221,1180,1356,8876
57224,186,227,214,202,202,201,195,1427
57225,1768,1749,1650,1645,1801,1816,1873,12302
57226,2010,2057,2135,2233,2316,2310,2072,15133
57227,397,440,368,315,308,271,434,2533
57231,1761,1712,1749,1744,1631,1725,1695,12017
57232,336,295,291,266,292,268,299,2047
57233,157,188,161,126,175,146,118,1071
57234,1461,1430,1430,1271,1310,1307,1274,9483
57235,871,902,845,1064,1027,943,844,6496
57236,45,49,68,65,106,127,118,578
57237,551,554,548,475,480,393,665,3666
57238,572,607,562,416,371,473,483,3484
57239,282,266,291,257,325,273,223,1917
57241,1117,959,1015,1003,982,1036,1048,7160
57242,462,353,282,263,289,289,432,2370
57243,806,752,725,696,685,671,604,4939
57245,107,97,119,109,132,124,126,814
57246,199,153,154,164,134,149,161,1114
57247,337,258,281,229,207,209,320,1841
57248,1094,1144,1165,1374,1388,1301,1057,8523
57249,864,886,995,923,997,1059,994,6718
57251,163,143,206,181,161,199,127,1180
57252,4736,4592,4526,4580,4919,5074,4800,33227
57255,369,379,371,440,506,538,538,3141
57256,109,86,74,91,101,67,127,655
57257,750,845,884,928,1067,935,810,6219
57258,224,284,345,370,353,414,385,2375
57259,397,485,467,485,440,452,505,3231
57260,1068,1073,1220,1205,1144,1155,1093,7958
57261,360,312,253,231,247,321,321,2045
57262,5383,5463,5452,5430,5208,4998,4963,36897
57263,460,482,394,368,479,455,450,3088
57264,231,229,194,262,231,196,219,1562
57265,158,198,239,211,245,216,225,1492
57266,639,691,633,682,628,603,607,4483
57268,469,494,458,496,542,594,443,3496
57269,442,440,559,527,383,332,413,3096
57270,982,940,847,771,645,554,904,5643
57271,218,305,277,311,304,382,247,2044
57272,192,192,188,144,116,119,173,1124
57273,1226,1242,1320,1192,1152,1267,1316,8715
57274,2677,2692,2735,2759,2683,2570,2813,18929
57276,1260,1227,1246,1243,1254,1206,1178,8614
57278,822,917,954,933,795,908,748,6077
57279,1046,978,1017,1034,1029,1153,1058,7315
57301,18483,18470,18431,18239,18109,18000,18375,128107
57311,1534,1682,1627,1530,1502,1521,1616,11012
57312,553,496,495,441,441,457,516,3399
57313,1285,1263,1256,1196,1134,1058,1128,8320
57314,823,845,815,849,742,740,734,5548
57315,1131,1148,1032,1141,1006,1039,987,7484
57317,604,581,584,615,602,580,526,4092
57319,984,1118,1218,1202,1153,1082,1003,7760
57321,407,428,359,357,414,350,388,2703
57322,418,420,365,320,275,261,296,2355
57323,172,193,240,201,218,213,215,1452
57324,273,358,367,407,370,273,383,2431
57325,3180,3322,3350,3534,3488,3494,3054,23422
57328,1058,1061,1108,1130,1094,1158,1134,7743
57329,281,288,299,453,492,486,258,2557
57330,622,625,658,740,864,930,625,5064
57331,421,435,502,627,621,557,459,3622
57332,799,774,773,772,824,851,730,5523
57334,907,829,870,789,879,944,895,6113
57335,263,303,258,297,278,293,244,1936
57337,146,123,135,85,71,75,140,775
57339,1621,1550,1556,1430,1410,1466,1525,10558
57340,319,309,318,333,351,397,355,2382
57341,130,142,157,168,183,150,151,1081
57342,552,483,442,509,511,520,558,3575
57344,173,199,172,136,153,113,155,1101
57345,1289,1271,1351,1268,1332,1313,1238,9062
57346,46,32,21,18,20,11,68,216
57348,502,498,510,523,513,582,527,3655
57349,1596,1561,1559,1631,1558,1637,1493,11035
57350,15247,15366,15046,14899,14889,14635,14534,104616
57353,813,742,696,807,827,722,829,5436
57355,1120,1050,988,1030,1115,1043,1352,7698
57356,1977,1871,1905,1915,1885,1668,1993,13214
57358,50,49,58,50,78,42,34,361
57359,707,661,649,625,719,700,649,4710
57361,197,180,203,118,115,144,198,1155
57362,2215,2219,2131,2258,2062,2121,2149,15155
57363,1100,1130,1123,1122,1007,998,1003,7483
57364,31,38,34,73,86,90,56,408
57365,635,687,563,580,585,577,522,4149
57366,2638,2372,2416,2425,2406,2478,2228,16963
57367,171,202,187,191,178,171,210,1310
57368,1201,1196,1246,1224,1208,1137,1226,8438
57369,2596,2823,2653,2344,2200,2316,2495,17427
57370,802,791,803,859,844,780,814,5693
57371,145,132,123,117,162,163,234,1076
57373,390,421,510,492,532,422,437,3204
57374,239,237,259,243,242,241,343,1804
57375,750,758,729,659,633,595,647,4771
57376,1031,1002,942,919,951,944,1010,6799
57379,79,46,58,54,38,65,84,424
57380,3758,3629,3699,3555,3510,3618,3470,25239
57381,716,671,652,574,516,460,490,4079
57382,1403,1455,1530,1492,1483,1565,1591,10519
57383,697,708,690,770,796,871,732,5264
57384,897,857,919,886,850,761,839,6009
57385,1095,1071,1099,1166,1184,1204,1221,8040
57386,261,246,210,154,103,166,209,1349
57401,31991,31563,31027,30402,30103,29946,30061,215093
57420,59,57,61,121,115,111,75,599
57421,82,69,71,57,47,51,88,465
57422,306,315,267,261,167,122,235,1673
57424,314,310,327,324,329,296,291,2191
57426,45,55,70,63,75,75,63,446
57427,791,900,689,629,687,691,620,5007
57428,656,736,708,753,774,814,710,5151
57429,83,98,94,109,142,162,94,782
57430,2225,2270,2226,2303,2376,2347,2243,15990
57432,461,579,573,579,490,416,465,3563
57433,299,292,419,457,521,457,383,2828
57434,420,501,537,549,497,459,566,3529
57435,285,291,257,262,222,235,247,1799
57436,442,431,397,447,481,450,384,3032
57437,1181,1115,1218,1220,1373,1424,1286,8817
57438,1489,1490,1389,1346,1442,1438,1580,10174
57439,42,30,28,60,65,65,52,342
57440,558,611,526,492,468,526,612,3793
57441,692,701,763,755,762,709,607,4989
57442,1704,1715,1761,1702,1671,1770,1664,11987
57445,2322,2219,2227,2185,2080,2120,2068,15221
57446,296,293,302,344,382,409,472,2498
57448,424,397,388,410,453,438,348,2858
57449,181,186,79,100,155,152,146,999
57450,718,695,669,684,654,574,672,4666
57451,2154,2148,2187,2265,2136,2183,2293,15366
57452,257,284,296,261,249,358,278,1983
57454,606,585,547,590,622,770,558,4278
57455,54,59,63,64,95,110,96,541
57456,826,904,919,876,826,741,862,5954
57457,91,80,52,74,93,85,90,565
57460,393,412,409,364,297,305,365,2545
57461,305,360,395,435,407,415,392,2709
57465,354,365,375,412,386,394,371,2657
57466,246,169,164,112,117,87,124,1019
57467,244,314,277,280,283,300,293,1991
57468,221,210,236,202,278,316,247,1710
57469,3584,3384,3479,3345,3291,3299,3305,23687
57470,127,179,148,208,191,189,143,1185
57471,628,662,713,670,770,734,674,4851
57472,1138,1180,1144,1055,975,953,953,7398
57473,149,135,288,295,303,316,161,1647
57474,167,152,141,176,140,153,197,1126
57475,107,103,99,91,92,104,160,756
57476,456,461,441,436,468,434,463,3159
57477,114,114,109,132,165,145,117,896
57479,647,646,711,685,598,488,666,4441
57481,547,530,571,621,532,510,598,3909
57501,16701,16745,16574,16302,16205,16255,16309,115091
57520,160,188,184,201,131,130,153,1147
57521,184,231,219,201,205,186,167,1393
57522,519,387,488,480,442,435,463,3214
57523,1024,1083,1145,1222,1189,1171,1094,7928
57528,851,774,722,893,977,962,748,5927
57529,329,366,451,490,535,517,395,3083
57531,180,204,220,291,224,254,228,1601
57532,2849,2805,2858,2802,2791,2723,2835,19663
57533,1927,1912,1923,1802,1864,1806,1900,13134
57534,199,177,127,111,132,111,183,1040
57536,486,536,560,677,607,422,469,3757
57537,88,128,107,146,118,143,83,813
57538,281,251,256,239,202,213,322,1764
57540,102,108,88,101,85,98,106,688
57541,244,178,144,65,51,22,167,871
57543,942,957,992,1030,940,937,870,6668
57544,469,520,524,514,591,636,419,3673
57547,176,173,178,231,229,209,139,1335
57548,1449,1395,1441,1428,1406,1402,1380,9901
57551,2116,2018,2043,2009,1981,2216,2279,14662
57552,431,495,545,489,572,553,554,3639
57553,329,374,306,338,239,190,153,1929
57555,4343,4099,3711,3467,3205,2824,3834,25483
57559,477,540,531,615,727,771,638,4299
57560,407,381,399,339,387,386,436,2735
57562,82,19,23,52,106,159,98,539
57563,358,356,359,219,267,175,240,1974
57564,1064,1048,996,982,1052,1062,995,7199
57566,1395,1390,1405,1462,1423,1594,1060,9729
57567,1427,1298,1346,1191,1140,1079,1406,8887
57568,661,594,653,647,622,671,689,4537
57569,452,442,387,368,328,285,445,2707
57570,2051,2047,2157,2230,2144,2052,2064,14745
57571,20,20,22,25,19,20,14,140
57572,1520,1711,1881,2104,2224,2478,1847,13765
57574,129,121,92,76,78,116,104,716
57576,146,111,145,123,93,73,204,895
57577,1403,1298,1053,966,1137,1227,1211,8295
57579,1441,1459,1407,1409,1337,1331,1330,9714
57580,4025,4213,4344,4203,4356,4623,4449,30213
57584,59,62,42,50,44,37,125,419
57585,212,223,265,296,271,228,226,1721
57601,3916,3824,3864,3933,3928,3878,4003,27346
57620,486,458,460,473,432,449,515,3273
57621,365,302,384,452,464,445,378,2790
57622,359,283,244,246,267,346,318,2063
57623,1050,1114,1115,1139,1126,1177,1042,7763
57625,4500,4461,4465,4368,4287,4101,4230,30412
57626,1092,1081,968,914,966,985,971,6977
57630,42,50,46,46,34,32,32,282
57631,355,354,300,320,350,362,361,2402
57632,724,710,681,636,657,545,634,4587
57633,435,458,447,537,558,615,414,3464
57634,103,79,121,76,101,95,115,690
57636,121,117,58,50,35,15,164,560
57638,1993,2036,2041,1929,1834,1805,1921,13559
57639,414,413,351,377,351,301,371,2578
57640,131,131,140,200,220,172,176,1170
57641,328,340,293,322,343,425,295,2346
57642,2110,2155,2126,2016,1894,1906,1917,14124
57644,257,225,235,187,164,218,335,1621
57645,183,190,202,206,264,293,217,1555
57646,292,297,266,238,188,174,199,1654
57648,325,275,283,267,257,274,335,2016
57649,258,261,272,271,306,291,217,1876
57650,54,16,36,77,81,85,29,378
57651,144,155,141,151,120,67,115,893
57652,345,467,460,386,368,533,402,2961
57656,794,695,684,673,688,617,723,4874
57657,204,202,221,202,287,292,203,1611
57658,339,328,288,329,328,336,446,2394
57660,118,108,77,70,65,46,99,583
57661,92,93,120,118,129,139,88,779
57701,45122,44678,44046,43679,43530,43548,43462,308065
57702,34709,34693,34752,33336,32509,32102,32980,235081
57703,15023,14663,14412,14417,14333,13922,14205,100975
57706,2783,2711,2746,2640,2836,2973,2903,19592
57714,1012,1127,1054,1077,1174,947,872,7263
57716,512,473,460,445,401,297,486,3074
57717,7779,7871,7781,7574,7453,7658,8007,54123
57718,7300,7046,7075,7069,6357,5911,6307,47065
57719,7936,7692,7030,7134,6546,6070,6217,48625
57720,600,634,573,593,586,601,651,4238
57722,479,395,464,491,333,368,283,2813
57724,216,240,277,261,287,334,210,1825
57725,209,199,173,110,116,89,162,1058
57730,5443,5669,5609,5707,5981,5938,5315,39662
57732,2338,2368,2297,2260,2155,1933,1979,15330
57735,1396,1363,1467,1483,1627,1553,1327,10216
57738,94,60,63,91,113,121,170,712
57741,68,68,76,75,82,69,63,501
57744,2246,2004,1945,1847,1552,1467,2238,13299
57745,2559,2529,2152,2188,2051,1686,2109,15274
57747,5621,5647,5574,5426,5336,5376,5870,38850
57748,474,358,319,325,282,229,318,2305
57750,303,427,514,556,393,436,295,2924
57751,676,677,697,767,893,877,844,5431
57752,1846,1920,1894,1840,2044,2010,2245,13799
57754,3694,3566,3408,3543,3563,3684,3793,25251
57755,104,118,89,101,113,104,116,745
57756,1222,1116,1349,1387,888,911,1126,7999
57758,109,86,157,215,280,246,200,1293
57759,555,520,763,780,791,744,546,4699
57760,1479,1399,1386,1585,1849,1666,1353,10717
57761,1085,1073,1081,1061,1158,1343,1210,8011
57762,760,743,760,591,438,377,531,4200
57763,294,293,293,331,408,381,282,2282
57764,1911,1671,1610,1706,1838,2258,1923,12917
57766,245,310,317,222,184,293,237,1808
57767,122,114,102,143,178,209,149,1017
57769,3820,3812,3489,3501,3353,3219,3515,24709
57770,5765,5825,5596,5634,5838,5023,5271,38952
57772,2203,2201,2220,1833,1751,2237,2048,14493
57773,325,330,382,377,315,117,133,1979
57775,257,280,399,352,356,406,230,2280
57776,0,0,0,0,11,11,15,37
57779,146,158,213,300,327,517,333,1994
57780,92,89,83,120,161,177,102,824
57782,72,56,57,60,42,23,61,371
57783,14846,14748,14515,14349,14052,13905,14290,100705
57785,9380,9348,9491,9276,9420,9515,9377,65807
57787,400,412,421,364,374,358,365,2694
57788,375,445,514,635,662,670,485,3786
57790,1099,1002,1247,1234,1160,1190,1111,8043
57791,259,222,204,177,186,298,190,1536
57792,74,73,61,58,31,31,129,457
57793,2183,2278,2251,2122,2335,2103,1913,15185
57794,911,955,964,1095,908,764,644,6241
57799,684,623,534,559,559,576,660,4195
58001,48,50,78,92,90,111,55,524
58002,52,48,21,18,0,44,23,206
58004,184,206,219,256,275,312,266,1718
58005,770,715,611,640,652,681,854,4923
58006,445,514,452,466,422,395,427,3121
58007,57,87,81,58,66,103,119,571
58008,216,234,264,285,277,364,229,1869
58009,22,11,10,14,38,77,102,274
58011,424,376,389,354,385,379,391,2698
58012,2699,2603,2625,2565,2337,2456,2474,17759
58013,103,113,99,113,114,134,101,777
58015,262,245,258,310,267,286,291,1919
58016,90,129,92,151,222,240,192,1116
58017,282,259,313,376,377,398,313,2318
58018,319,308,282,296,244,240,324,2013
58021,362,459,408,438,377,376,447,2867
58027,1444,1424,1240,1135,1152,1262,1391,9048
58029,142,214,226,201,192,226,129,1330
58030,695,643,608,575,548,575,649,4293
58031,518,449,439,374,352,424,414,2970
58032,819,778,739,760,726,702,722,5246
58033,447,475,469,478,448,483,374,3174
58035,236,221,207,155,153,128,262,1362
58036,329,309,343,288,284,268,274,2095
58038,341,335,350,326,282,263,332,2229
58040,980,982,965,873,840,829,920,6389
58041,1595,1653,1577,1662,1632,1640,1545,11304
58042,1640,1744,1558,1506,1384,1416,1386,10634
58043,138,153,148,160,146,164,167,1076
58045,2357,2438,2441,2453,2545,2432,2230,16896
58046,666,689,647,590,553,527,583,4255
58047,3838,3802,3858,3755,3996,3625,3560,26434
58048,540,530,591,602,494,469,418,3644
58049,413,415,345,278,232,327,289,2299
58051,1691,1550,1355,1313,1248,1140,1458,9755
58052,569,627,734,668,646,717,581,4542
58053,1278,1367,1410,1361,1484,1331,1171,9402
58054,3045,2996,2987,3134,3105,3124,3128,21519
58056,229,212,219,189,135,141,191,1316
58057,59,98,123,134,193,200,147,954
58058,109,120,126,125,129,153,123,885
58059,1247,1085,1111,1117,1218,1248,1168,8194
58060,1161,1219,1270,1315,1345,1392,1329,9031
58061,397,378,390,380,429,478,413,2865
58062,158,142,170,178,228,183,174,1233
58063,353,331,273,339,372,372,340,2380
58064,533,539,533,476,457,426,450,3414
58065,45,57,38,40,47,26,22,275
58067,235,245,245,235,235,249,243,1687
58068,417,380,461,401,374,336,321,2690
58069,121,132,135,116,118,115,176,913
58071,455,452,380,426,427,402,409,2951
58072,7856,8051,8032,7924,7934,7867,7997,55661
58075,9088,9020,9050,9028,8926,8916,9276,63304
58076,355,370,344,325,324,329,236,2283
58077,648,643,632,674,699,750,787,4833
58078,32032,30461,28728,27479,26302,25335,26321,196658
58079,565,525,565,450,423,341,530,3399
58081,973,928,958,871,970,945,845,6490
58102,30197,30824,31233,31210,30781,30513,29850,214608
58103,50441,49178,48506,47859,47442,47146,47302,337874
58104,34981,33044,31429,29892,28513,27168,28322,213349
58105,2544,2472,1977,1895,1809,1771,2483,14951
58201,38191,37433,36448,35843,35515,35279,34880,253589
58202,1930,1952,1894,1845,1795,1826,1839,13081
58203,17854,17898,18098,17798,17720,17430,18229,125027
58204,2401,2245,1941,2045,2270,2275,2107,15284
58205,455,418,446,387,300,311,260,2577
58210,330,354,325,306,297,340,322,2274
58212,573,550,502,525,495,532,474,3651
58214,351,330,267,282,313,377,367,2287
58216,108,127,139,85,93,103,153,808
58218,889,804,694,656,594,667,700,5004
58219,40,39,27,29,28,10,47,220
58220,2338,2379,2337,2381,2235,2464,2360,16494
58222,355,325,368,384,411,365,295,2503
58223,286,297,255,231,219,183,212,1683
58224,75,101,92,24,19,19,41,371
58225,946,897,998,985,920,927,1125,6798
58227,441,459,483,433,481,508,504,3309
58228,873,824,847,856,840,844,880,5964
58229,134,130,134,205,172,144,114,1033
58230,594,615,637,625,675,663,663,4472
58231,357,429,483,616,631,666,490,3672
58233,240,222,217,213,280,304,283,1759
58235,376,424,439,416,459,502,418,3034
58237,5465,5396,5356,5485,5402,5434,5499,38037
58238,159,157,144,162,191,247,167,1227
58239,23,26,28,23,50,75,71,296
58240,1058,1016,1210,1306,1384,1340,1276,8590
58241,106,128,128,89,102,94,126,773
58243,577,680,718,693,696,664,539,4567
58244,149,159,128,196,213,238,194,1277
58249,2465,2475,2537,2611,2581,2532,2574,17775
58250,272,267,269,254,298,294,241,1895
58251,2053,2189,2302,2328,2110,2239,2049,15270
58254,443,523,491,478,472,494,513,3414
58256,883,923,964,849,868,863,872,6222
58257,2107,2085,2049,1969,1831,2037,2239,14317
58258,232,284,258,243,240,267,290,1814
58259,379,344,355,384,384,346,454,2646
58260,177,167,139,172,170,197,173,1195
58261,1237,1056,1202,1119,1092,1053,1112,7871
58262,91,114,118,115,143,150,134,865
58265,481,517,464,484,457,370,519,3292
58266,158,197,173,268,220,191,203,1410
58267,1352,1225,1336,1345,1265,1420,1520,9463
58269,164,133,148,160,158,207,207,1177
58270,1853,1883,1901,1987,2018,2013,1950,13605
58271,645,702,735,720,751,750,708,5011
58272,301,270,277,375,400,447,312,2382
58273,239,282,206,167,199,212,264,1569
58274,992,957,1014,1118,1186,1168,953,7388
58275,717,723,792,810,819,783,733,5377
58276,564,540,489,520,538,586,503,3740
58277,231,270,250,249,233,200,225,1658
58278,1867,1800,1903,1829,1861,1741,1988,12989
58281,123,137,148,99,128,140,124,899
58282,1430,1448,1412,1472,1573,1403,1441,10179
58301,10218,10005,9831,9772,9744,9804,9864,69238
58311,61,63,67,76,79,52,60,458
58316,7063,6956,6754,6726,6549,6479,6486,47013
58317,240,257,213,240,231,240,226,1647
58318,3823,3871,3754,3673,3518,3567,3684,25890
58321,178,245,247,227,212,190,161,1460
58323,17,17,29,31,37,44,47,222
58324,1379,1408,1372,1360,1341,1289,1345,9494
58325,73,71,70,83,52,84,92,525
58327,315,386,393,407,355,294,390,2540
58329,3210,3201,3119,3231,3163,3096,3313,22333
58330,312,315,353,363,369,370,341,2423
58331,93,118,116,116,120,95,122,780
58332,303,278,293,302,317,332,320,2145
58335,1784,1697,1688,1580,1456,1635,1694,11534
58338,131,137,118,101,97,92,105,781
58339,29,35,35,32,25,18,47,221
58341,2628,2683,2552,2582,2531,2628,2597,18201
58343,66,62,61,63,81,65,81,479
58344,881,846,865,836,898,821,958,6105
58345,101,138,137,150,153,137,158,974
58346,703,696,623,635,656,624,650,4587
58348,708,729,732,723,744,710,727,5073
58351,468,459,494,439,505,549,478,3392
58352,515,506,525,480,474,464,435,3399
58353,73,92,52,49,48,51,140,505
58355,114,102,90,65,57,51,84,563
58356,1827,1805,1753,1738,1682,1689,1751,12245
58357,344,385,386,389,390,401,364,2659
58361,241,239,264,309,263,325,190,1831
58362,27,35,36,32,33,37,82,282
58363,90,53,81,115,145,161,83,728
58365,296,287,349,291,291,320,304,2138
58366,1276,1265,1345,1233,1178,1101,1080,8478
58367,1682,1646,1570,1581,1643,1704,1707,11533
58368,3877,3901,3912,3907,3827,3781,3801,27006
58369,1260,1279,1447,1306,1414,1469,1231,9406
58370,1345,1340,1383,1489,1479,1406,1280,9722
58372,142,120,106,110,111,108,106,803
58374,541,627,621,624,665,598,640,4316
58377,279,324,404,416,457,438,334,2652
58379,459,422,369,353,365,303,360,2631
58380,463,447,382,351,345,327,442,2757
58381,288,287,322,316,326,299,317,2155
58382,182,201,183,171,176,173,163,1249
58384,521,511,564,578,529,494,549,3746
58385,209,214,270,285,325,375,225,1903
58386,133,158,170,198,194,185,134,1172
58401,17185,17350,17287,17220,17089,17148,17142,120421
58402,236,232,378,388,401,208,260,2103
58405,411,390,321,342,347,370,427,2608
58413,1039,1124,1160,1151,1098,1095,1150,7817
58415,176,146,123,117,138,174,145,1019
58416,404,434,411,434,428,427,440,2978
58418,335,297,376,356,372,355,353,2444
58420,327,348,296,295,317,321,314,2218
58421,2808,2776,2830,2894,2914,2883,2850,19955
58422,191,202,237,267,304,326,195,1722
58423,57,82,89,75,75,66,78,522
58424,274,293,266,211,252,251,301,1848
58425,1440,1404,1510,1467,1478,1521,1379,10199
58426,283,162,201,201,217,238,200,1502
58428,245,329,375,311,309,335,271,2175
58429,395,389,405,330,291,225,357,2392
58430,101,89,109,112,132,140,112,795
58431,82,91,118,111,120,131,132,785
58433,1049,1042,1027,1076,1008,986,1092,7280
58436,1906,1956,2028,2100,2053,1985,1965,13993
58438,648,604,684,618,669,599,625,4447
58439,97,140,146,180,169,254,310,1296
58440,154,176,194,193,192,195,181,1285
58441,302,305,305,252,327,337,389,2217
58442,463,500,546,533,532,548,478,3600
58443,177,212,215,175,204,240,200,1423
58444,271,264,251,238,224,194,192,1634
58445,134,110,98,129,121,152,160,904
58448,246,246,229,280,268,257,347,1873
58451,171,189,168,187,204,215,185,1319
58452,16,35,30,34,41,30,27,213
58454,424,473,499,491,429,402,360,3078
58455,389,408,372,356,316,353,303,2497
58456,533,456,449,440,521,476,523,3398
58458,1250,1289,1261,1286,1327,1430,1397,9240
58460,199,164,216,228,263,252,230,1552
58461,442,388,454,497,483,527,413,3204
58463,597,538,515,596,562,624,651,4083
58464,231,274,329,282,277,295,242,1930
58466,358,367,389,509,482,446,355,2906
58467,543,533,646,737,599,654,606,4318
58472,522,400,391,374,427,432,419,2965
58474,2830,2787,2700,2657,2700,2752,2681,19107
58475,170,157,160,153,166,191,150,1147
58476,266,315,290,250,260,306,271,1958
58477,186,221,223,193,176,189,148,1336
58478,131,132,126,155,153,172,135,1004
58479,177,190,235,246,265,272,192,1577
58480,336,262,284,264,339,294,340,2119
58481,201,233,289,266,253,319,272,1833
58482,1078,1040,948,944,914,877,1003,6804
58483,227,222,211,199,267,308,340,1774
58484,24,47,57,48,75,92,65,408
58486,238,183,140,134,115,142,262,1214
58487,446,411,427,473,517,499,444,3217
58488,244,236,271,283,254,282,258,1828
58490,216,285,234,284,305,259,240,1823
58492,437,440,441,539,501,538,481,3377
58494,275,293,323,357,362,350,350,2310
58495,1399,1300,1287,1277,1276,1313,1332,9184
58496,211,198,134,167,250,242,182,1384
58497,283,326,326,328,258,278,326,2125
58501,29643,29523,28730,28410,28215,28327,28055,200903
58503,30696,29274,28439,27196,25798,24264,25734,191401
58504,26762,25990,25540,25064,24821,24630,24342,177149
58505,0,0,0,0,0,0,2,2
58520,304,339,406,313,300,324,264,2250
58521,623,639,699,670,658,685,658,4632
58523,3711,3701,3678,3706,3611,3588,3619,25614
58524,71,72,66,55,56,62,100,482
58528,850,789,852,807,900,954,798,5950
58529,580,610,625,622,621,647,660,4365
58530,1025,1142,1133,1144,1081,1011,1193,7729
58531,403,349,337,343,369,346,307,2454
58532,279,258,196,279,285,292,297,1886
58533,944,923,885,941,930,921,945,6489
58535,709,637,634,514,577,580,571,4222
58538,2706,2669,2665,2735,2605,2585,2489,18454
58540,2480,2429,2399,2310,2286,2235,2449,16588
58541,433,444,348,423,346,340,364,2698
58542,294,294,307,278,273,250,324,2020
58544,607,618,579,604,618,549,551,4126
58545,3616,3546,3657,3484,3526,3612,3461,24902
58549,180,183,192,148,154,170,214,1241
58552,1661,1685,1739,1705,1646,1768,1797,12001
58554,24972,24467,23664,23277,22888,22636,22884,164788
58558,1063,1009,982,914,758,688,812,6226
58559,257,234,192,190,148,179,218,1418
58560,177,210,191,180,177,141,161,1237
58561,1061,1073,1044,1062,1080,1106,1085,7511
58562,442,405,409,370,360,386,415,2787
58563,2057,1876,1948,1988,2094,1999,1977,13939
58564,109,102,125,174,155,172,92,929
58565,234,223,214,184,184,244,209,1492
58566,98,114,121,153,106,115,180,887
58568,605,606,540,435,405,331,535,3457
58569,88,89,55,53,53,49,77,464
58570,391,455,430,426,373,378,397,2850
58571,585,595,662,635,724,629,603,4433
58572,300,312,340,320,373,387,319,2351
58573,689,729,734,809,849,818,674,5302
58575,789,831,865,856,835,859,920,5955
58576,991,925,871,882,917,888,953,6427
58577,1928,1954,1807,1784,1768,1797,1671,12709
58579,1474,1378,1392,1122,1062,931,1190,8549
58580,308,338,312,318,315,364,455,2410
58581,257,261,235,235,224,248,258,1718
58601,26123,24839,23643,22432,21650,20939,21078,160704
58620,123,139,175,186,221,207,132,1183
58621,1269,1241,1206,1122,1131,1053,1231,8253
58622,1796,1778,1664,1625,1523,1523,1489,11398
58623,2356,2413,2403,2397,2308,2314,2370,16561
58625,333,328,288,193,192,162,185,1681
58626,343,361,291,270,265,238,262,2030
58627,161,190,187,210,214,243,154,1359
58630,508,509,484,484,422,585,502,3494
58631,1077,992,986,999,991,1064,1150,7259
58632,229,223,244,219,165,197,149,1426
58634,174,175,163,107,176,126,251,1172
58636,943,982,936,823,741,790,706,5921
58638,1048,1106,1171,1157,1163,1044,992,7681
58639,1786,1755,1823,1767,1821,1830,1816,12598
58640,1559,1604,1591,1595,1576,1429,1344,10698
58641,105,102,60,117,106,59,79,628
58642,346,323,321,350,334,337,334,2345
58643,183,184,172,216,217,191,191,1354
58645,287,312,275,231,247,228,238,1818
58646,1192,1198,1150,1173,1197,1199,1138,8247
58647,1228,1182,1154,1156,1080,1091,1142,8033
58649,347,393,393,408,376,407,321,2645
58650,415,432,432,420,419,377,393,2888
58651,545,470,500,406,529,530,475,3455
58652,1257,1295,1103,994,938,937,987,7511
58653,641,647,592,595,573,532,601,4181
58654,407,365,366,334,331,310,289,2402
58655,517,517,468,465,430,391,484,3272
58656,556,446,365,382,367,367,366,2849
58701,33446,32993,31844,30193,28946,27435,28368,213225
58702,0,0,0,0,0,0,0,0
58703,21602,20528,19879,19644,19206,19137,19396,139392
58704,5092,5051,5008,4970,4923,4990,4770,34804
58705,763,717,445,454,383,492,751,4005
58707,551,568,507,462,425,414,509,3436
58710,585,535,539,502,484,470,469,3584
58711,171,178,158,148,183,196,211,1245
58712,107,153,157,172,141,173,155,1058
58713,25,28,17,23,28,22,35,178
58716,152,123,143,118,131,142,147,956
58718,882,886,989,1153,1153,1062,1040,7165
58721,547,545,558,537,560,558,529,3834
58722,1573,1637,1773,1575,1354,1572,1516,11000
58723,220,210,217,286,306,327,236,1802
58725,323,335,272,270,270,269,341,2080
58727,338,340,275,314,277,231,279,2054
58730,1294,1317,1298,1286,1250,1151,1295,8891
58731,266,309,323,297,300,264,300,2059
58733,315,335,368,418,383,390,402,2611
58734,342,321,327,271,273,288,241,2063
58735,300,302,300,424,447,440,314,2527
58736,616,579,517,492,425,474,452,3555
58737,166,176,181,130,129,173,140,1095
58740,967,967,865,832,764,697,755,5847
58741,449,557,543,629,648,652,554,4032
58744,106,114,121,119,139,129,143,871
58746,1303,1366,1470,1450,1557,1560,1620,10326
58748,96,105,121,113,98,100,148,781
58750,693,651,564,619,677,603,528,4335
58752,158,155,170,193,187,202,223,1288
58755,58,104,91,106,117,114,129,719
58756,151,204,250,289,277,295,250,1716
58757,1001,1133,1084,982,987,937,909,7033
58758,265,321,300,279,266,233,222,1886
58759,921,856,970,994,912,801,821,6275
58760,252,289,215,222,275,266,254,1773
58761,1029,1035,1224,1221,1092,1110,1104,7815
58762,278,225,251,221,219,191,246,1631
58763,4334,4213,3816,3558,3120,3113,3502,25656
58765,527,394,364,306,314,319,248,2472
58768,235,248,258,170,193,178,282,1564
58769,324,287,353,350,256,277,229,2076
58770,1462,1415,1379,1396,1428,1394,1240,9714
58771,602,675,616,569,562,511,453,3988
58772,174,132,126,121,128,109,137,927
58773,919,911,877,837,766,681,687,5678
58775,238,308,315,401,384,390,290,2326
58776,184,214,219,253,258,254,298,1680
58778,185,182,187,136,140,128,133,1091
58779,573,712,604,587,498,504,367,3845
58781,631,636,606,722,787,766,695,4843
58782,361,365,363,371,373,409,436,2678
58783,409,383,430,404,406,421,346,2799
58784,3058,2862,2652,2453,2464,2172,2330,17991
58785,1219,1222,1159,1073,1121,1097,1091,7982
58787,178,146,115,129,150,139,136,993
58788,1337,1214,1167,1079,1021,959,1124,7901
58789,342,360,388,369,318,365,321,2463
58790,1791,1660,1648,1705,1738,1679,1585,11806
58792,304,349,310,260,252,218,227,1920
58793,538,555,617,660,648,624,609,4251
58794,190,179,102,113,94,87,159,924
58795,165,170,164,175,176,207,198,1255
58801,27885,25758,23009,20786,19271,18063,18371,153143
58830,331,282,271,296,306,188,213,1887
58831,654,586,548,562,622,585,472,4029
58833,56,67,63,55,57,40,80,418
58835,266,397,569,397,364,371,313,2677
58838,182,179,231,272,218,233,199,1514
58843,379,454,399,472,446,501,466,3117
58844,194,216,237,249,167,173,142,1378
58845,385,372,327,294,292,305,371,2346
58847,428,505,485,564,317,265,283,2847
58849,843,979,1113,1154,1165,1041,883,7178
58852,1620,1572,1623,1626,1454,1665,1750,11310
58853,245,298,384,354,339,327,292,2239
58854,6716,5257,4031,3331,3084,2946,2804,28169
58856,184,179,192,166,154,151,131,1157
59001,1499,1473,1455,1572,1525,1499,1643,10666
59002,218,250,260,264,280,283,165,1720
59003,1295,1271,1145,1016,1107,1016,1160,8010
59006,840,739,748,737,633,538,926,5161
59007,198,176,136,140,114,137,113,1014
59008,410,361,391,363,438,408,410,2781
59010,103,130,116,87,72,58,102,668
59011,3048,3064,3034,3025,3104,3034,3027,21336
59012,230,209,239,283,238,314,249,1762
59013,192,136,192,179,127,152,127,1105
59014,1888,1850,1852,1846,1645,1554,1446,12081
59015,439,529,525,602,603,533,576,3807
59016,1000,1007,1010,819,732,800,1089,6457
59018,428,586,562,590,664,613,602,4045
59019,4272,4161,4089,3984,3945,3801,3972,28224
59020,37,39,22,28,28,22,77,253
59022,2451,2363,2287,2246,2087,1988,1945,15367
59024,449,526,488,508,502,501,390,3364
59025,29,34,46,87,104,113,56,469
59026,161,236,230,291,327,303,194,1742
59027,697,764,930,659,664,757,836,5307
59028,577,519,503,434,407,443,434,3317
59029,781,668,677,728,867,853,733,5307
59030,1360,1447,1627,1537,1464,1374,1263,10072
59031,218,296,419,391,400,438,339,2501
59032,421,374,362,394,329,377,408,2665
59033,351,349,321,328,301,306,334,2290
59034,5796,5577,5596,5614,5377,5146,5189,38295
59035,53,123,123,123,117,234,227,1000
59036,1313,1278,1364,1291,1273,1280,1505,9304
59037,1757,1815,1698,1661,1881,1556,1672,12040
59038,749,672,650,597,604,698,656,4626
59039,45,26,36,34,34,14,28,217
59041,1829,1859,1920,1786,1786,1794,1950,12924
59043,2927,2968,2964,3193,3206,3252,2950,21460
59044,11180,10602,10538,11079,10911,10801,10971,76082
59046,417,413,398,362,458,513,390,2951
59047,12134,11779,11652,12035,11964,12070,11880,83514
59050,1400,1499,1427,1475,1521,1611,1715,10648
59052,175,153,164,163,150,217,139,1161
59053,540,557,527,553,530,574,354,3635
59054,250,274,214,280,280,358,315,1971
59055,74,71,82,74,53,54,59,467
59057,554,649,703,611,617,606,692,4432
59058,90,86,101,96,85,27,50,535
59059,145,137,152,154,163,146,146,1043
59061,189,208,174,204,236,273,272,1556
59062,24,48,62,61,58,63,35,351
59063,1993,2024,2062,2015,2136,2163,2058,14451
59064,230,149,101,171,226,296,284,1457
59065,116,125,48,48,82,100,197,716
59066,686,655,680,651,811,805,701,4989
59067,290,311,316,335,311,220,221,2004
59068,3370,3396,3339,3301,3295,3464,3580,23745
59069,434,472,477,490,473,536,461,3343
59070,961,1052,947,927,849,810,1047,6593
59071,140,130,105,96,74,78,104,727
59072,4442,4414,4442,4276,4112,3936,4140,29762
59074,295,339,353,359,321,369,490,2526
59075,237,181,218,119,152,267,289,1463
59076,91,119,94,74,64,99,33,574
59077,84,72,89,104,91,118,79,637
59078,146,115,105,104,116,140,145,871
59079,3404,3467,3685,3583,3492,3311,3481,24423
59081,8,10,9,11,15,14,9,76
59082,52,43,82,31,49,50,39,346
59085,90,134,143,132,127,90,88,804
59086,896,857,763,758,805,733,727,5539
59087,359,370,438,506,503,485,436,3097
59088,1382,1250,1050,1093,1058,1254,1373,8460
59089,373,360,371,360,470,435,467,2836
59101,41284,39940,40234,39757,39453,39615,39562,279845
59102,48387,48820,47787,47930,47155,46542,46564,333185
59105,30786,30940,30829,30032,29760,29697,29624,211668
59106,15184,14877,14084,13050,12581,11454,12375,93605
59201,5578,5405,5232,5193,4981,4698,5100,36187
59211,264,253,202,214,247,156,125,1461
59212,479,520,492,427,485,392,373,3168
59213,708,648,693,778,848,954,772,5401
59214,104,89,115,137,126,177,120,868
59215,980,1048,1050,1097,1210,1186,1135,7706
59217,394,280,296,305,133,29,100,1537
59218,1009,987,930,969,994,1143,927,6959
59219,185,159,186,189,188,198,199,1304
59221,1721,1632,1702,1581,1573,1655,1658,11522
59222,113,149,174,168,209,286,221,1320
59223,283,325,321,330,308,313,364,2244
59225,490,487,535,497,434,475,560,3478
59226,415,485,483,426,427,465,410,3111
59230,4493,4513,4590,4626,4704,4661,4490,32077
59231,598,619,454,389,303,314,264,2941
59240,26,28,11,12,13,15,21,126
59241,464,453,461,411,419,427,413,3048
59242,96,68,74,112,103,111,79,643
59243,287,305,364,392,290,408,345,2391
59244,23,26,44,62,66,57,65,343
59247,321,375,366,352,379,357,314,2464
59248,701,632,625,688,692,686,762,4786
59250,176,163,203,186,219,192,198,1337
59252,99,124,128,115,133,112,115,826
59253,99,103,138,110,105,110,112,777
59254,2177,2194,2059,2001,1894,1967,2026,14318
59255,3666,3674,3666,3489,3370,3253,3429,24547
59256,59,52,95,68,68,59,59,460
59257,47,33,23,28,18,17,61,227
59258,104,111,111,120,128,119,110,803
59259,368,344,379,338,321,344,348,2442
59260,144,165,109,115,128,127,110,898
59261,567,526,514,513,492,478,520,3610
59262,769,792,714,816,771,693,655,5210
59263,1526,1474,1461,1457,1364,1266,1349,9897
59270,8689,8537,8052,7623,7467,7065,7339,54772
59274,257,274,285,283,243,225,206,1773
59275,333,289,291,315,336,377,376,2317
59276,37,18,18,21,25,30,40,189
59301,11688,11654,11560,11491,11433,11320,11404,80550
59311,173,177,172,202,197,177,159,1257
59312,20,21,24,33,24,22,31,175
59313,2411,2566,2555,2600,2605,2443,2498,17678
59314,92,73,83,101,90,85,112,636
59315,103,114,114,114,127,124,150,846
59317,1135,1175,1198,1205,1128,1137,1164,8142
59318,161,122,82,86,82,84,136,753
59322,67,43,44,59,50,55,85,403
59323,2376,2375,2315,2413,2512,2407,2294,16692
59324,907,838,853,860,880,881,821,6040
59326,343,294,319,323,325,251,265,2120
59327,3033,2909,3014,2968,2852,2784,2945,20505
59330,8690,8715,8535,8453,8332,8287,8307,59319
59332,199,178,144,157,157,162,146,1143
59333,15,19,16,21,22,13,21,127
59336,217,191,204,223,187,200,192,1414
59337,623,693,740,754,757,844,812,5223
59338,117,138,135,128,124,102,142,886
59339,169,140,160,161,190,202,149,1171
59343,134,148,122,35,45,51,82,617
59344,403,376,346,331,315,315,300,2386
59347,224,340,307,294,302,288,321,2076
59349,1147,1107,978,873,864,798,913,6680
59351,157,158,165,134,141,181,200,1136
59353,1143,986,987,928,899,964,1017,6924
59354,22,53,69,100,85,67,41,437
59401,14518,14309,14332,14093,13858,13854,13774,98738
59404,27347,27523,27373,27043,26930,26458,26867,189541
59405,31093,30775,30518,30784,30504,31025,31438,216137
59410,614,645,686,702,747,782,666,4842
59411,603,482,444,346,172,122,460,2629
59412,1556,1641,1539,1732,2019,1724,1747,11958
59414,1022,1151,1233,1087,1063,1080,904,7540
59416,493,509,473,526,449,478,337,3265
59417,7742,7898,8087,7950,7896,8220,7719,55512
59418,159,184,178,123,121,106,95,966
59419,132,106,147,217,174,185,96,1057
59420,289,309,300,226,211,155,243,1733
59421,1838,1883,1841,1795,1736,1697,1831,12621
59422,2388,2497,2462,2483,2682,2572,2643,17727
59424,49,74,79,59,59,90,87,497
59425,3626,3648,3731,3554,3455,3401,3751,25166
59427,4789,4748,4506,4590,4585,4237,4757,32212
59430,367,428,394,448,490,578,454,3159
59432,106,103,94,126,154,169,104,856
59433,572,580,618,648,635,624,594,4271
59434,561,544,604,642,769,750,463,4333
59436,2061,1946,1901,1712,1630,1710,1827,12787
59440,125,132,113,132,130,89,175,896
59441,85,74,60,74,67,38,82,480
59442,1568,1572,1586,1642,1708,1743,1789,11608
59443,469,565,818,882,889,1036,612,5271
59444,348,327,340,321,261,257,355,2209
59446,596,574,525,578,571,563,564,3971
59447,237,210,175,193,155,143,250,1363
59448,801,755,698,658,681,763,743,5099
59450,556,570,526,495,514,566,467,3694
59451,189,209,233,219,196,301,241,1588
59452,527,523,545,559,556,556,525,3791
59453,344,377,297,337,368,345,362,2430
59454,216,207,193,210,185,153,201,1365
59456,490,463,333,194,129,137,233,1979
59457,9147,9200,9280,9233,9319,9073,9105,64357
59460,199,164,170,146,165,194,233,1271
59461,39,32,28,11,11,9,33,163
59462,139,137,147,119,166,151,168,1027
59463,92,90,113,117,92,136,169,809
59464,516,416,443,452,414,434,500,3175
59465,26,36,53,69,67,63,52,366
59466,64,77,86,97,98,102,97,621
59467,163,160,181,222,277,292,259,1554
59468,715,723,699,756,686,615,571,4765
59469,166,161,156,166,144,162,157,1112
59471,273,308,267,313,315,376,295,2147
59472,734,805,825,836,841,771,657,5469
59474,3639,3705,3779,3698,3858,3818,3820,26317
59477,597,579,494,482,455,352,521,3480
59479,754,794,841,893,912,927,826,5947
59480,406,421,497,486,529,534,383,3256
59482,547,587,629,758,754,811,802,4888
59483,520,384,418,374,374,448,530,3048
59484,144,115,156,162,110,73,111,871
59485,537,539,521,500,575,505,705,3882
59486,1084,1163,1228,1397,1508,1461,1328,9169
59487,1390,1494,1514,1429,1435,1459,1240,9961
59489,350,321,306,275,258,244,396,2150
59501,12798,12685,12525,12529,12630,12674,12638,88479
59520,1210,1245,1266,1231,1223,1174,1030,8379
59521,3878,4060,4063,3945,3630,3330,3475,26381
59522,1718,1713,1629,1784,1779,1740,1755,12118
59523,2231,2297,2258,2216,2214,2233,2287,15736
59524,751,724,834,849,677,688,663,5186
59525,265,230,259,237,208,287,384,1870
59526,2504,2413,2396,2496,2682,2670,2435,17596
59527,1098,1153,1037,962,812,775,974,6811
59528,261,210,163,192,183,206,208,1423
59529,189,156,161,143,129,149,163,1090
59530,129,134,142,129,81,108,99,822
59531,308,388,344,327,326,360,241,2294
59532,199,146,168,187,208,234,180,1322
59535,74,59,73,68,48,81,74,477
59537,38,44,74,160,188,209,96,809
59538,2880,2958,2969,2841,2947,2966,3037,20598
59540,255,308,373,373,433,450,371,2563
59542,153,166,205,262,239,223,192,1440
59544,206,206,200,163,153,133,175,1236
59545,28,33,35,35,39,34,39,243
59546,61,66,48,80,115,95,129,594
59547,47,28,30,29,40,42,38,254
59601,30366,29942,29453,29420,29619,29241,29283,207324
59602,26246,25872,25380,25076,24193,24039,24285,175091
59631,238,238,233,199,244,186,237,1575
59632,2013,2100,2179,2105,2207,2053,1939,14596
59633,304,255,270,213,210,177,206,1635
59634,4912,4794,4730,4785,4810,4924,4819,33774
59635,7152,7201,7550,7467,7208,7073,7282,50933
59636,14,12,10,10,10,7,12,75
59638,783,803,780,829,615,604,617,5031
59639,1032,1106,1139,1005,993,879,1286,7440
59640,92,95,114,90,71,71,89,622
59642,43,32,20,24,45,51,62,277
59643,631,624,637,590,612,482,437,4013
59644,3893,4263,4226,3971,3996,3851,4036,28236
59645,1655,1588,1745,1648,1661,1632,1635,11564
59647,347,190,183,417,410,518,334,2399
59648,482,513,477,443,510,481,635,3541
59701,33430,33360,33406,33286,33145,32978,33147,232752
59703,35,22,73,69,125,128,43,495
59710,234,256,258,265,237,223,286,1759
59711,8962,9018,8919,9011,8922,9097,8933,62862
59713,176,220,175,216,202,204,213,1406
59714,19212,19370,19259,19101,18973,18282,18182,132379
59715,34742,33887,32666,31684,31027,31622,31567,227195
59716,2115,2300,2233,1990,1880,1707,1798,14023
59718,30833,29105,28037,27839,27837,27432,27367,198450
59720,260,246,282,260,262,198,191,1699
59721,416,461,563,549,427,494,433,3343
59722,5790,5752,5696,5711,5655,5602,5781,39987
59724,92,104,123,136,143,159,128,885
59725,8103,8010,7914,7833,7773,7709,7963,55305
59727,261,293,252,219,202,171,221,1619
59728,383,421,484,403,398,338,343,2770
59729,2157,2127,2014,2153,2080,2017,2141,14689
59730,2130,2012,2032,1873,1776,1655,1790,13268
59731,112,116,124,130,204,221,209,1116
59732,202,129,96,68,65,58,128,746
59733,319,263,237,217,169,163,198,1566
59735,340,421,381,493,458,447,331,2871
59736,98,131,144,143,133,149,127,925
59739,266,299,346,385,359,354,340,2349
59740,238,268,326,211,286,315,495,2139
59741,4506,4262,4207,4365,4383,4311,4352,30386
59743,125,122,123,159,138,112,134,913
59745,152,137,137,126,131,115,134,932
59746,80,79,73,67,76,89,92,556
59747,182,191,176,215,203,172,159,1298
59748,185,255,214,211,245,235,254,1599
59749,1544,1507,1476,1522,1468,1546,1513,10576
59750,397,367,313,304,276,263,309,2229
59751,261,206,278,236,249,149,208,1587
59752,3744,3388,3337,3236,3047,2999,3431,23182
59754,973,1009,884,832,922,867,964,6451
59755,231,262,238,225,224,225,210,1615
59756,389,414,389,343,325,338,463,2661
59758,1684,1800,2041,2084,2005,2010,1769,13393
59759,3665,3460,3420,3308,3370,3454,3643,24320
59760,252,218,315,348,373,310,260,2076
59761,240,266,273,308,350,302,265,2004
59762,204,201,297,334,323,370,258,1987
59801,31789,31272,31218,30890,30658,30550,30940,217317
59802,19488,19519,19733,19292,18876,17960,18407,133275
59803,16996,17279,16668,16856,16907,16927,16203,117836
59804,8361,8142,7894,7978,7747,8265,7533,55920
59808,19448,19365,18611,18594,18357,17780,17904,130059
59820,1710,1510,1293,1241,1203,1121,1361,9439
59821,2546,2375,2352,2294,2087,1996,2377,16027
59823,1822,1609,1551,1323,1309,1323,1561,10498
59824,1351,1485,1635,1718,1758,1960,1792,11699
59825,2493,2550,2478,2335,2464,2210,2412,16942
59826,562,633,601,574,474,461,521,3826
59827,281,230,365,400,402,315,300,2293
59828,5206,4902,5011,5425,5631,5725,5543,37443
59829,2252,2315,2275,2319,2368,2224,2679,16432
59830,65,81,58,74,119,162,146,705
59831,465,508,531,611,587,588,454,3744
59832,976,1014,980,955,950,796,765,6436
59833,5346,5233,5269,5345,5494,5967,5448,38102
59834,2082,1756,2054,2005,2146,1992,2240,14275
59837,390,348,407,339,358,424,407,2673
59840,14036,13860,13446,12979,12683,12568,13052,92624
59841,954,985,999,817,754,685,917,6111
59842,24,52,108,114,86,106,90,580
59843,240,250,317,359,369,384,260,2179
59844,673,640,752,888,904,685,736,5278
59845,1062,1160,1178,1217,1232,1271,1186,8306
59846,983,1026,1112,1148,1337,1460,1617,8683
59847,5479,5455,5394,5366,4976,5217,5658,37545
59848,163,147,158,157,175,134,106,1040
59851,164,96,215,254,324,329,173,1555
59853,909,791,759,956,910,859,699,5883
59854,198,206,233,243,298,305,239,1722
59855,1023,1348,1284,957,751,960,957,7280
59856,365,393,387,385,412,398,347,2687
59858,1234,1223,1291,1347,1336,1360,1538,9329
59859,3022,3014,2990,3082,3031,3228,3270,21637
59860,9930,10324,10271,10082,9756,9322,9913,69598
59863,40,61,77,66,66,78,76,464
59864,7246,6783,6567,6839,7092,6673,6752,47952
59865,3221,3026,3286,3170,3590,3431,3185,22909
59866,772,804,1012,1085,1037,1048,943,6701
59867,28,12,11,9,16,27,28,131
59868,1456,1571,1609,1675,1746,1783,2054,11894
59870,10232,10222,10321,10463,10508,10442,9617,71805
59871,227,222,222,185,180,195,218,1449
59872,2201,2266,2245,2205,2356,2322,2309,15904
59873,3562,3507,3667,3172,3186,3223,3085,23402
59874,1176,1187,959,974,1023,1084,1568,7971
59875,3684,3821,3708,3679,3599,3563,3537,25591
59901,52596,51243,49792,49962,49374,49503,49693,352163
59910,572,572,505,584,579,566,356,3734
59911,8611,7906,7677,7892,7832,8262,7678,55858
59912,13687,13826,14110,13738,13357,13661,13499,95878
59913,550,607,576,513,467,426,675,3814
59914,197,179,168,200,156,133,234,1267
59915,551,508,567,509,434,332,403,3304
59916,124,87,76,56,59,59,130,591
59917,4425,4184,4313,4268,3922,3971,4225,29308
59918,584,725,752,720,735,791,592,4899
59919,661,757,898,916,1225,1152,839,6448
59920,1858,1817,1936,1784,1742,1449,1680,12266
59922,2676,2642,2541,2292,2156,1471,2408,16186
59923,9565,9604,9608,9713,10030,9922,9856,68298
59925,1413,1392,1393,1282,1334,1128,1435,9377
59926,259,380,468,452,466,630,513,3168
59927,366,329,318,318,382,327,368,2408
59928,165,145,132,82,59,19,88,690
59929,267,261,294,265,288,235,237,1847
59930,556,767,703,736,907,755,867,5291
59931,287,362,257,264,271,391,328,2160
59932,1180,1444,1606,1665,1586,1894,1648,11023
59933,73,77,75,66,62,65,43,461
59934,562,584,616,596,599,510,528,3995
59935,3503,3396,3388,3482,3339,3560,3576,24244
59936,426,487,507,519,512,486,367,3304
59937,12847,12753,12752,12567,12911,12823,12588,89241
60002,24368,24340,24305,24250,23925,23740,24299,169227
60004,50974,50639,50222,49957,49650,49787,50582,351811
60005,29936,29942,30462,30931,30490,30147,29308,211216
60007,33733,33952,33830,33973,33837,33868,33820,237013
60008,22023,22043,22402,22302,22379,22138,22717,156004
60010,44930,44331,44416,44031,44209,44464,44095,310476
60012,10696,10960,11313,11081,11142,10731,11120,77043
60013,25968,26242,26241,26811,26975,26836,26872,185945
60014,48822,48868,48379,48234,48834,48964,48550,340651
60015,27388,27356,27373,27218,27218,26905,26800,190258
60016,59726,61096,61369,60794,60437,60346,59690,423458
60018,30519,29351,29027,28749,28957,28630,30099,205332
60020,9616,9875,10246,10391,10533,10128,9825,70614
60021,5709,5455,5724,5560,5680,5489,5545,39162
60022,8503,8486,8383,8327,8213,8021,8153,58086
60025,39928,39525,39263,38667,38689,38257,39105,273434
60026,14427,14376,13775,13869,13382,13316,13335,96480
60029,531,469,478,435,567,528,482,3490
60030,36876,36649,36563,35685,35419,35672,36056,252920
60031,37443,37800,37920,38205,37993,37983,37947,265291
60033,13569,13630,13686,13763,13824,13837,13922,96231
60034,1948,1872,1795,1826,1830,1864,2040,13175
60035,29824,29806,29837,29814,29856,30017,29763,208917
60040,5377,5391,5400,5439,5471,5464,5431,37973
60041,9276,9192,8655,8877,8942,8792,9250,62984
60042,8365,8603,8556,8630,8745,8777,8547,60223
60043,2613,2653,2648,2786,2669,2565,2513,18447
60044,9680,9715,9683,9867,9995,10384,9792,69116
60045,20622,20514,20516,20732,20777,20936,20925,145022
60046,35132,35013,34859,34534,34916,34463,35111,244028
60047,42317,42330,42221,42206,41695,41657,41669,294095
60048,29050,28966,29284,29480,29246,29221,29095,204342
60050,32387,31809,32253,32369,32294,31848,31620,224580
60051,24154,24769,24787,24664,24212,25208,25192,172986
60053,23413,23472,23424,23341,23194,23070,23260,163174
60056,55366,55803,55617,55611,55153,55052,55219,387821
60060,37763,38138,37947,37586,38159,37197,37189,263979
60061,26720,26352,26144,26029,25674,25331,25748,181998
60062,40631,40344,40211,40095,40092,39723,39936,281032
60064,15848,15954,15898,16297,16341,16518,15407,112263
60067,37998,37899,38303,38450,38120,37892,38585,267247
60068,37567,37608,37511,37421,37266,37272,37475,262120
60069,8207,8572,8301,8132,8129,8282,8384,58007
60070,16195,16147,16033,15937,15915,15939,16001,112167
60071,3576,3520,3482,3488,3507,3617,3598,24788
60072,955,910,881,976,980,934,928,6564
60073,60828,61118,60970,60237,59142,58230,60002,420527
60074,39541,39757,39010,39053,38843,38477,38985,273666
60076,32497,32523,32764,32922,33412,33337,33415,230870
60077,28281,28053,27822,27189,26400,26316,26825,190886
60081,9840,9874,9963,9939,10070,9904,10079,69669
60083,10581,10676,10382,9909,9833,10051,9838,71270
60084,16357,15695,15867,16304,15848,15828,16771,112670
60085,71611,71051,71112,70997,71038,70767,71714,498290
60087,25748,26545,26374,26679,27717,27885,26978,187926
60088,12739,12556,13417,13274,13743,14674,15761,96164
60089,41642,41594,41584,41645,41672,41705,41533,291375
60090,38045,38014,37912,37744,37543,37257,37633,264148
60091,27304,27350,27345,27268,27202,27008,27020,190497
60093,19204,19447,19385,19010,19064,19228,19570,134908
60096,6854,6871,6910,7001,6941,6935,6897,48409
60097,10352,10623,10883,10758,11082,10889,11250,75837
60098,32508,32354,32329,32549,32047,32641,32228,226656
60099,31242,31147,31717,31593,31308,31442,31104,219553
60101,39645,39918,39709,39657,39705,39259,39119,277012
60102,32618,32813,32670,32166,31689,31686,32193,225835
60103,42437,42429,42426,42209,41872,41252,41928,294553
60104,19010,19025,19081,19061,19105,19096,19038,133416
60106,20215,20083,20150,20276,20351,20030,20309,141414
60107,40916,41320,41155,40677,40313,40007,39927,284315
60108,22981,23213,23105,22975,22591,22639,22735,160239
60109,553,585,560,567,496,579,560,3900
60110,39513,39334,39204,38998,38414,38375,38557,272395
60111,199,296,263,376,414,404,258,2210
60112,4536,4598,4652,4674,4532,4235,4560,31787
60113,350,334,363,309,287,210,337,2190
60115,45923,45982,46492,46267,46410,46456,46272,323802
60118,15705,15681,15442,15587,15685,15700,15851,109651
60119,10169,9812,10380,10357,10088,9569,10371,70746
60120,50809,50564,50154,51216,51046,50682,50955,355426
60123,48895,48890,49054,48053,48523,47265,47405,338085
60124,20761,20912,20447,19618,19216,19571,18935,139460
60126,47818,47403,46823,46450,46123,45842,46371,326830
60129,186,163,164,184,183,203,242,1325
60130,14137,14194,14202,14202,14194,14245,14167,99341
60131,18072,18125,18103,18068,18037,17941,18097,126443
60133,38518,38488,38377,38369,38156,38022,38103,268033
60134,29127,29769,29290,29339,29634,29445,28565,205169
60135,6553,6807,7102,7174,7101,7302,7248,49287
60136,7479,7338,7276,7093,6829,6377,7013,49405
60137,37798,38103,38418,38384,38572,39102,37805,268182
60139,34614,34925,35000,34867,34755,34349,34381,242891
60140,15985,15224,14509,14050,14198,13832,14341,102139
60141,192,151,157,190,236,257,224,1407
60142,27337,27080,27077,26708,25586,24553,26447,184788
60143,10372,10435,10198,10128,10245,10113,10360,71851
60144,64,72,79,64,38,28,58,403
60145,2986,2654,2506,2408,2513,2361,2627,18055
60146,2566,2587,2814,2585,2717,2700,2713,18682
60148,52486,52510,52833,52390,51365,50807,51468,363859
60150,1583,1557,1509,1589,1542,1396,1794,10970
60151,4184,4263,4333,4235,4281,4488,4061,29845
60152,12656,12943,12825,12899,13008,13053,12533,89917
60153,24029,24148,24157,24152,24187,24302,24106,169081
60154,16778,16833,16839,16804,16684,16637,16773,117348
60155,7915,7947,7947,7931,7928,7928,7927,55523
60156,28812,28900,28842,28886,28894,28784,28987,202105
60157,2293,2097,2020,2116,2153,2177,2380,15236
60160,25534,25656,25590,25459,25266,25025,25432,177962
60162,8182,8140,8139,8110,8136,8106,8111,56924
60163,5192,5217,5219,5218,5189,5186,5209,36430
60164,21700,22035,22287,22116,22194,22162,22048,154542
60165,4936,4947,4959,4947,4942,4934,4946,34611
60169,34058,34164,34154,34103,33934,33807,33847,238067
60171,10248,10299,10305,10300,10245,10414,10246,72057
60172,25045,24793,24695,24588,24287,24192,24537,172137
60173,12246,12361,12108,12143,12243,11990,12217,85308
60174,31047,31747,31437,31340,30853,31021,30752,218197
60175,26334,26268,26068,25836,25961,25505,25564,181536
60176,11813,11834,11842,11790,11782,11736,11795,82592
60177,23068,22869,22810,22705,22230,21911,22659,158252
60178,22207,22174,22054,22299,21907,21707,21840,154188
60180,2030,1582,1520,1293,1428,1228,1694,10775
60181,28667,28756,28898,28933,29288,29683,28836,203061
60184,2490,2296,2424,2536,2753,2964,2448,17911
60185,36164,36012,36259,35974,36063,35497,36527,252496
60187,28662,28809,28544,28660,28778,28968,29016,201437
60188,43118,43198,42614,42399,42243,42196,42656,298424
60189,31559,31454,31631,31344,31078,30876,30472,218414
60190,11020,10819,10614,10561,10521,10438,10663,74636
60191,14429,14469,14389,14358,14036,13973,14310,99964
60192,16235,16695,16637,16522,16445,16119,16343,114996
60193,40192,39839,40210,39883,39495,39973,39188,278780
60194,19044,19164,19596,20322,20136,19600,19777,137639
60195,4783,4915,4294,3810,4239,4154,4769,30964
60201,43056,43247,42722,42682,42197,42648,43125,299677
60202,32416,32356,32560,32255,32422,31501,31361,224871
60203,4089,4480,4460,4749,4760,4552,4523,31613
60301,2329,2155,2174,2229,2298,2357,2539,16081
60302,32258,32259,32137,32218,32224,31907,32108,225111
60304,17402,17666,17677,17455,17259,17368,17231,122058
60305,11217,11233,11211,11183,11174,11164,11172,78354
60401,7655,7697,7788,8012,7720,7573,7797,54242
60402,63938,64174,64256,64039,63734,63217,63448,446806
60403,18267,18415,19039,19634,19646,19425,17529,131955
60404,18198,18025,17872,17984,17722,17178,17395,124374
60406,24629,25294,25679,26021,25876,25899,25460,178858
60407,1860,1940,1826,1945,1902,2051,1684,13208
60408,5528,5564,5467,5501,5590,5341,5696,38687
60409,37250,37480,37463,37202,37164,37073,37186,260818
60410,12656,13045,12726,12530,12573,12639,12687,88856
60411,58630,58786,58923,58818,58499,58184,58136,409976
60415,14351,14392,14358,14294,14203,14057,14139,99794
60416,9140,8997,9165,9152,9209,9117,9397,64177
60417,15532,16022,15662,15572,15823,16174,15547,110332
60419,22796,22809,22816,22978,22923,22981,22788,160091
60420,5841,6287,6513,6738,6516,6197,6102,44194
60421,3910,3954,4027,3960,4110,4100,3968,28029
60422,9377,9440,9132,9007,8866,9005,9403,64230
60423,30907,30688,30269,30261,30264,30182,30423,212994
60424,2303,2348,2322,2310,2306,2385,2440,16414
60425,9041,9053,9093,9000,9098,8941,9117,63343
60426,29826,29693,28801,28260,28230,28465,29594,202869
60428,12257,12308,12711,12463,12502,12556,12203,87000
60429,15504,15799,15746,16006,16186,16288,15630,111159
60430,19978,20181,20565,21217,21001,20888,20094,143924
60431,22926,23273,22337,21783,20756,20723,22577,154375
60432,20712,20851,21243,21448,21925,20844,21403,148426
60433,17034,17145,17117,17220,17656,18381,17160,121713
60435,50095,49789,48429,49002,49078,48162,48899,343454
60436,18714,18145,19155,18371,18840,19565,18315,131105
60437,138,159,164,157,221,248,187,1274
60438,28987,28845,28943,28815,28817,28865,28884,202156
60439,23373,23139,23209,23177,22869,22362,22919,161048
60440,53285,53587,53762,53836,53772,54044,52911,375197
60441,35556,35843,35762,35532,34787,34563,36869,248912
60442,10226,9983,9814,9684,9508,9280,9924,68419
60443,21297,21184,21283,20800,20565,20083,21145,146357
60444,1778,1837,1890,1842,1865,1687,1761,12660
60445,26201,26047,26122,26171,26012,25910,26057,182520
60446,40018,40135,39976,39871,39471,38778,39807,278056
60447,14334,13939,13928,14094,13645,13024,13709,96673
60448,25604,25332,24929,24678,24284,24029,24423,173279
60449,9187,9519,9327,9174,9186,8904,9217,64514
60450,20736,20609,20522,20689,20443,20611,20332,143942
60451,34921,34826,34611,34516,34064,34383,34063,241384
60452,28494,28237,28191,28096,27976,27953,27969,196916
60453,56791,56987,57012,56820,56614,56348,56855,397427
60455,16421,16397,16560,16343,16291,16180,16446,114638
60456,4343,4356,4358,4356,4346,4337,4349,30445
60457,13858,13933,14117,14367,14355,14002,14049,98681
60458,14887,14769,14437,14111,13997,13930,14428,100559
60459,29047,29119,29087,29107,28954,28757,28929,203000
60460,1246,1354,1372,1425,1511,1617,1522,10047
60461,4738,4815,4896,4706,4661,4615,4836,33267
60462,39714,39784,39041,38801,38562,38282,38723,272907
60463,14484,14440,14347,14337,14340,14437,14671,101056
60464,9595,9552,9512,9707,9627,9823,9620,67436
60465,17575,17626,17610,17567,17474,17431,17495,122778
60466,22204,22254,22702,22667,22552,22670,22115,157164
60467,27077,26824,27314,26880,26514,25896,26046,186551
60468,5934,5721,5829,5847,6158,6456,6116,42061
60469,5906,6298,5934,6017,5975,5872,5930,41932
60470,673,644,580,603,569,516,616,4201
60471,14076,14140,14019,13865,13757,13683,14101,97641
60472,5226,5162,5252,5182,5158,5251,5390,36621
60473,22517,22647,22507,22445,22376,22174,22439,157105
60474,903,899,827,685,730,708,760,5512
60475,9805,9620,9697,9797,9785,9732,9870,68306
60476,2633,2615,2826,2837,2773,2572,2391,18647
60477,38421,38296,38370,38144,38120,37857,38161,267369
60478,17178,17183,17106,16856,16712,16624,16833,118492
60479,739,757,728,696,904,964,760,5548
60480,5140,5171,5190,5006,5045,5003,5246,35801
60481,11649,11642,11986,11916,12072,12384,11851,83500
60482,11068,11115,11040,11152,10991,10899,11063,77328
60484,6866,6648,6735,6902,7012,6788,6829,47780
60487,26827,26974,26993,26795,26428,25672,26928,186617
60490,21035,20784,20346,19960,19609,19179,20463,141376
60491,22583,22479,22635,22573,22657,23055,22743,158725
60501,11990,12093,11971,11886,11790,11577,11626,82933
60502,23070,23749,23099,23552,22770,22369,21873,160482
60503,17166,17394,17192,16952,16550,15831,16717,117802
60504,38019,37196,37173,37956,37961,37209,37919,263433
60505,77190,76016,74553,71433,70324,68027,76573,514116
60506,53708,55089,56384,56982,57139,58917,53013,391232
60510,29502,29395,29115,28999,28849,28619,28897,203376
60511,1540,1584,1530,1575,1534,1713,1793,11269
60512,1879,2052,2000,1527,1025,995,1111,10589
60513,18966,18964,19039,18995,18843,18799,19047,132653
60514,10260,10136,10187,10414,10535,10264,9708,71504
60515,28424,28698,28811,28054,27902,27973,27503,197365
60516,28705,27944,27565,28005,28178,28674,29084,198155
60517,32377,32333,32533,32578,32317,31995,32038,226171
60518,3349,3726,3753,3714,3730,3592,3580,25444
60519,40,33,41,0,91,108,88,401
60520,2818,2848,2827,2869,2946,2927,2886,20121
60521,18103,17938,17678,17660,17530,17649,17597,124155
60523,10110,9912,9916,9818,9690,9541,9890,68877
60525,31395,31503,31675,31514,31192,31182,31168,219629
60526,13565,13647,13613,13609,13602,13543,13576,95155
60527,28048,28817,28372,28181,28031,27440,27486,196375
60530,449,464,556,605,777,818,649,4318
60531,1700,1875,1708,1818,1870,1691,1902,12564
60532,27778,27268,27235,27008,26695,26662,27066,189712
60534,10571,10668,10650,10626,10620,10599,10649,74383
60536,122,113,111,109,93,95,126,769
60537,629,643,663,690,766,854,665,4910
60538,27438,27606,26862,26202,26430,26130,26619,187287
60539,364,414,328,248,169,87,341,1951
60540,44662,44184,43514,43053,43361,42050,42910,303734
60541,3448,3409,3297,3033,3024,2908,3148,22267
60542,17794,17283,17107,16820,16416,16237,17099,118756
60543,39353,38987,37767,37053,36003,34419,36156,259738
60544,25682,25307,25210,25188,25335,25410,25959,178091
60545,13338,13273,13271,13141,13054,12757,12940,91774
60546,15837,15938,15959,15970,15824,15736,15668,110932
60548,11792,12027,12170,12281,12855,13054,12218,86397
60549,724,736,935,982,928,380,643,5328
60550,1712,1611,1544,1528,1397,1380,1440,10612
60551,5519,5324,4796,4779,4669,4792,5062,34941
60552,4696,4630,4465,4521,4013,4104,4448,30877
60553,751,795,864,843,882,837,782,5754
60554,11877,11635,11691,11597,11796,11653,11796,82045
60555,13663,13687,13533,13543,13465,13243,13538,94672
60556,1729,1764,1815,1871,1938,2018,2007,13142
60557,33,29,26,0,0,0,155,243
60558,13133,13125,13066,13008,12853,12747,12960,90892
60559,24772,24958,24752,24496,24567,24662,24852,173059
60560,23636,22528,22598,22907,22677,22105,22415,158866
60561,23042,23154,23155,23067,23197,23435,23115,162165
60563,36696,36621,36554,36512,36236,36634,35922,255175
60564,42423,41635,41832,41453,41217,40793,41312,290665
60565,40972,41110,40411,40864,40434,40414,40524,284729
60585,23604,23306,23290,22627,22081,21219,22311,158438
60586,47244,47190,47081,46395,46677,46229,46251,327067
60601,13695,11905,10894,9732,9791,8275,11110,75402
60602,1252,1294,1429,1463,1322,1151,1204,9115
60603,1029,1076,1002,882,623,480,493,5585
60604,619,545,419,415,428,393,570,3389
60605,26623,27238,25938,24972,22887,20522,24668,172848
60606,3011,3098,2840,2789,2399,2123,2308,18568
60607,28377,27557,25927,25134,24277,22964,23897,178133
60608,78072,79607,78952,78794,80313,81757,82739,560234
60609,62250,62010,62405,62773,63208,62671,64906,440223
60610,38438,39598,38482,38740,37898,37309,37726,268191
60611,31563,31165,30648,29722,29026,28071,28718,208913
60612,35559,36531,35598,36052,35584,34569,33472,247365
60613,49519,49389,49292,49536,49201,49370,48281,344588
60614,69817,69423,68573,68363,67203,66352,66617,476348
60615,40257,41210,41141,40745,41462,41392,40603,286810
60616,52580,52214,49914,49491,48994,48774,48433,350400
60617,80002,82213,82685,83435,84882,88799,84155,586171
60618,95632,97324,96230,97413,97389,94286,92084,670358
60619,62822,63411,64245,64922,66254,67701,63825,453180
60620,69299,69909,71907,73253,74245,77452,72216,508281
60621,31383,31881,32619,33608,34418,35837,35912,235658
60622,54467,55516,54607,54272,54676,52896,52548,378982
60623,88137,88635,87836,85158,85203,85764,92108,612841
60624,38134,38140,39706,39283,39398,39470,38105,272236
60625,79157,78731,78586,78966,78685,79784,78651,552560
60626,50090,49118,49237,51061,52007,51029,50139,352681
60628,68077,67914,69921,71710,74001,76929,72202,500754
60629,115104,114982,115013,113833,111893,112376,113916,797117
60630,57627,56653,56978,57886,56909,55571,54093,395717
60631,28238,28255,27995,28899,29126,29554,28641,200708
60632,91668,91310,91357,90845,90911,88723,91326,636140
60633,12817,12754,13065,13474,13757,13925,12927,92719
60634,73382,74093,73119,72718,73251,74795,74298,515656
60636,35779,37278,40164,39918,40068,41973,40916,276096
60637,49158,50326,48851,48270,47110,47636,49503,340854
60638,57746,57958,56812,56033,54733,55810,55026,394118
60639,90211,91379,92339,91934,90763,90858,90407,637891
60640,67088,66050,64599,64365,65198,64952,65790,458042
60641,70642,72588,72460,70730,71294,70874,71663,500251
60642,19508,19989,19404,18312,18743,18661,18480,133097
60643,50507,50992,50957,51836,49842,49641,49952,353727
60644,49645,49080,49615,47631,47133,47127,48648,338879
60645,47131,45873,46290,46913,45977,45511,45274,322969
60646,27454,28203,28367,28314,27745,27829,27177,195089
60647,88866,88269,87339,87146,87237,86345,87291,612493
60649,45218,45305,45201,45444,44516,44884,46650,317218
60651,61759,61287,60938,61150,63645,64182,64267,437228
60652,43228,42176,42337,42517,42616,42883,40959,296716
60653,31045,30683,31038,31086,31374,30641,29908,215775
60654,17328,15934,16244,15885,14607,14059,14875,108932
60655,28741,28479,28022,28173,28179,28049,28550,198193
60656,27926,28526,28895,27468,27455,26219,27613,194102
60657,70105,69147,69444,68088,68280,68809,65996,479869
60659,38995,38276,38788,39657,40153,39586,38104,273559
60660,41490,40719,41380,42060,41774,41840,42752,292015
60661,9343,8875,8838,7436,7238,6648,7792,56170
60706,23604,23452,23259,23284,23148,22958,23134,162839
60707,43451,43005,42958,42712,42400,42164,42920,299610
60712,12637,12666,12653,12611,12538,12483,12590,88178
60714,29730,30056,30091,30111,29903,29718,29931,209540
60803,22762,23133,22991,22945,22842,22583,22285,159541
60804,83972,84361,84481,84042,83924,83822,84573,589175
60805,19849,19934,19924,19903,19852,19832,19852,139146
60827,28864,28677,28772,28547,28355,27974,27946,199135
60901,36150,36277,36519,36908,37050,37363,37157,257424
60910,477,457,454,382,381,487,538,3176
60911,1562,1505,1569,1604,1604,1457,1372,10673
60912,449,610,649,735,794,790,599,4626
60913,1398,1220,1295,1371,1357,1334,1617,9592
60914,29186,29648,29196,28923,28727,28217,29107,203004
60915,10315,10067,10318,10601,10681,10753,10774,73509
60917,571,537,634,607,717,676,574,4316
60918,810,809,860,783,770,782,898,5712
60919,524,549,611,605,532,483,558,3862
60920,129,158,172,120,133,157,178,1047
60921,1252,1231,1325,1381,1549,1637,1519,9894
60922,2295,2349,2364,2332,2529,2476,2459,16804
60924,1535,1650,1583,1691,1791,1856,1635,11741
60926,9,18,20,29,46,62,67,251
60927,2149,2326,2413,2384,2402,2450,2404,16528
60928,799,839,808,736,667,686,709,5244
60929,961,937,923,818,731,624,730,5724
60930,930,889,803,819,817,827,918,6003
60931,506,515,546,590,560,625,615,3957
60932,80,81,52,0,0,20,78,311
60933,250,249,273,248,277,318,302,1917
60934,215,257,314,276,257,292,273,1884
60935,1107,1176,1260,1397,1154,1035,1064,8193
60936,4167,4179,4172,4125,4110,4098,4321,29172
60938,2037,1955,1991,2109,2212,2202,2131,14637
60940,3536,3605,3636,3524,3457,3523,3369,24650
60941,1819,1946,1962,1979,2121,2211,2039,14077
60942,5901,6000,6028,6094,6091,6164,6181,42459
60945,163,177,185,170,191,157,153,1196
60946,386,403,340,384,365,434,426,2738
60948,1654,1392,1468,1553,1713,1556,1533,10869
60949,541,550,678,656,591,625,636,4277
60950,11865,11961,12018,11883,11947,11890,12168,83732
60951,760,761,731,725,857,885,961,5680
60952,704,709,655,716,753,713,684,4934
60953,2455,2297,2447,2372,2492,2769,2469,17301
60954,6113,6240,6243,6260,6299,6287,6104,43546
60955,1764,1937,1845,1833,1736,1663,1901,12679
60957,5436,5421,5385,5515,5556,5641,5615,38569
60958,2208,2222,2069,2107,2153,2090,2135,14984
60959,1131,1126,1084,1073,978,947,1082,7421
60960,1119,1082,1103,1089,1048,1081,1064,7586
60961,818,861,829,772,779,937,700,5696
60962,536,529,634,595,670,695,524,4183
60963,2186,2107,1913,1818,1718,1654,1807,13203
60964,5209,5282,5379,5232,5166,5064,4968,36300
60966,1524,1519,1547,1558,1354,1308,1526,10336
60968,354,355,316,330,337,343,433,2468
60969,32,85,61,59,50,76,65,428
60970,7046,7082,7161,7173,7257,7343,7190,50252
60973,448,490,480,486,442,517,385,3248
60974,385,352,393,330,280,220,283,2243
61001,1035,1145,1228,1250,1275,1247,1179,8359
61006,1777,1764,1690,1794,2011,1907,1759,12702
61007,501,678,637,649,520,492,534,4011
61008,34552,34676,34786,34683,34364,33919,34311,241291
61010,7897,8324,8266,8278,8335,8255,8032,57387
61011,2357,2226,2023,2139,2272,2391,2945,16353
61012,2711,2699,2496,2461,2409,2108,2175,17059
61013,476,500,510,488,624,544,528,3670
61014,1377,1205,1169,1171,1215,1238,1173,8548
61015,780,699,677,670,707,735,946,5214
61016,4727,4405,4266,4681,5077,5331,4837,33324
61018,926,1006,1091,1221,1293,1215,1080,7832
61019,3429,3585,3465,3354,3448,3152,3550,23983
61020,3255,3205,3301,3301,3280,3205,3108,22655
61021,23138,23226,22928,23171,23706,23541,23745,163455
61024,2402,2302,2272,2456,2625,2754,2620,17431
61025,4788,4687,4749,4821,4823,4574,4867,33309
61027,8,7,8,0,0,0,52,75
61028,2151,2125,1982,2027,1990,2022,1989,14286
61030,2462,2453,2472,2420,2375,2388,2205,16775
61031,1629,1724,1640,1738,1635,1779,1656,11801
61032,30695,30751,31250,31576,31482,31800,31651,219205
61036,6607,6607,6732,6747,6626,6817,6821,46957
61037,134,285,281,324,249,192,140,1605
61038,975,1003,1036,1083,1361,1412,1354,8224
61039,960,904,898,1035,1043,979,802,6621
61041,997,1027,1069,1304,1376,1420,1327,8520
61042,468,471,461,483,466,482,527,3358
61043,100,94,87,86,61,85,131,644
61044,316,196,132,169,129,114,232,1288
61046,2626,2764,2853,2823,2648,2772,2831,19317
61047,2051,1735,1660,1537,1529,1717,1711,11940
61048,3949,4119,4132,4136,4237,4275,4360,29208
61049,568,557,536,522,591,586,585,3945
61050,475,482,410,288,308,346,376,2685
61051,1644,1576,1567,1548,1664,1526,1574,11099
61052,963,888,1014,1021,1018,1126,1148,7178
61053,2644,2889,2959,3140,3199,3098,2852,20781
61054,3868,3899,3993,4041,3967,3970,3973,27711
61057,170,171,150,146,99,114,168,1018
61059,239,190,167,168,149,77,141,1131
61060,1473,1503,1502,1510,1470,1526,1432,10416
61061,6347,6524,6649,6777,6721,6831,7009,46858
61062,1869,2021,2117,1964,1971,2169,1983,14094
61063,4466,4258,4248,4260,4095,3772,4132,29231
61064,3371,3475,3538,3659,3727,3887,3868,25525
61065,10276,10736,11011,10984,11086,11266,11156,76515
61067,646,681,658,645,821,875,811,5137
61068,14616,14816,14916,14998,15032,15246,14858,104482
61070,1438,1292,1327,1269,1080,1080,1130,8616
61071,14226,14298,14400,14476,14393,14332,14381,100506
61072,11665,11668,11431,11475,11534,11592,11797,81162
61073,19434,19108,19594,19704,19820,19523,20052,137235
61074,4314,4235,4289,4245,4202,4344,4431,30060
61075,1044,1084,1013,981,1046,1094,958,7220
61077,40,61,29,79,64,72,73,418
61078,1300,1292,1337,1294,1443,1562,1374,9602
61079,231,149,156,117,88,126,188,1055
61080,10347,10731,10919,11032,10805,10767,10599,75200
61081,21468,21435,21617,21711,21477,21758,21934,151400
61084,3073,2956,2915,2794,2792,2827,3175,20532
61085,3379,3512,3512,3365,3371,3379,3443,23961
61087,1793,1811,1691,1665,1652,1694,1670,11976
61088,5703,5950,5868,6045,6409,6539,6020,42534
61089,722,770,771,798,794,725,867,5447
61091,110,73,82,93,103,19,63,543
61101,20622,21097,22272,22680,22912,22848,21593,154024
61102,18804,19564,19214,19691,19712,20098,20538,137621
61103,23718,23705,24341,24378,24392,25189,24578,170301
61104,19622,18982,18694,18345,17936,17346,19269,130194
61107,31490,31192,30518,30695,31072,31344,30439,216750
61108,27369,28158,29125,29642,29485,29190,28550,201519
61109,27457,27432,27910,27845,28475,28141,28333,195593
61111,24352,24571,24483,24034,23771,23413,23492,168116
61112,95,108,100,106,82,72,86,649
61114,14963,14929,14596,14358,14510,15558,15776,104690
61115,22910,23007,23100,23178,23085,23056,23180,161516
61201,38744,39064,38986,39082,38943,39117,39116,273052
61230,1248,1313,1457,1336,1356,1303,1232,9245
61231,5057,5076,5144,5199,5328,5469,5627,36900
61232,1288,1564,1557,1528,1479,1251,1284,9951
61234,1405,1401,1371,1396,1283,1386,1258,9500
61235,1414,1445,1439,1432,1474,1431,1391,10026
61236,121,110,109,70,105,179,193,887
61238,3316,3135,3058,2927,3369,3350,3247,22402
61239,1250,1253,1195,1247,1242,1223,1219,8629
61240,6278,6199,6248,6160,6112,6259,5870,43126
61241,6775,6682,6768,6806,6714,6730,7124,47599
61242,1206,1154,1107,1047,1092,1201,1145,7952
61243,234,213,234,223,319,303,264,1790
61244,23609,23900,23772,24085,24251,24153,24053,167823
61250,2622,2664,2574,2635,2583,2518,2737,18333
61251,308,324,308,324,360,357,347,2328
61252,5367,5211,5282,5329,5363,5446,5436,37434
61254,11099,11219,11263,11374,11284,11279,11414,78932
61256,1975,1919,2005,2146,2099,2141,1822,14107
61257,1345,1152,1081,1154,1051,936,1210,7929
61258,316,337,293,371,307,285,204,2113
61259,1336,1261,1174,1109,879,806,1276,7841
61260,972,891,815,949,1001,956,856,6440
61261,856,989,1023,925,1010,1087,975,6865
61262,1266,1196,1277,1388,1411,1383,1188,9109
61263,639,703,695,698,570,525,530,4360
61264,10716,10549,10550,10450,10516,10517,10548,73846
61265,44360,44672,44731,44887,44921,45044,45099,313714
61270,7021,7177,6973,7159,7089,7353,7306,50078
61272,1385,1415,1454,1459,1400,1592,1504,10209
61273,3218,3271,3328,3347,3405,3416,3316,23301
61274,174,227,254,282,400,433,351,2121
61275,4437,4355,4503,4406,4506,4573,4347,31127
61276,90,72,87,84,106,90,138,667
61277,3064,3099,3095,3141,3074,3167,3355,21995
61278,419,383,291,297,309,282,412,2393
61279,895,925,1012,1074,1124,1163,1061,7254
61281,2647,2566,2673,2602,2627,2478,2597,18190
61282,7826,7812,7800,7694,7719,7634,7809,54294
61283,1494,1498,1490,1763,1980,1576,1640,11441
61284,2224,2437,2187,2338,2354,2325,2292,16157
61285,1462,1584,1566,1605,1698,1661,1631,11207
61301,10324,10421,10568,10565,10684,10916,10588,74066
61310,3826,3829,3891,3970,4111,4198,3970,27795
61311,182,155,146,134,132,63,232,1044
61312,504,448,510,548,524,525,474,3533
61313,185,190,151,130,200,233,282,1371
61314,828,866,852,952,854,932,807,6091
61315,219,242,237,301,301,281,322,1903
61316,333,321,300,264,249,196,282,1945
61317,484,473,455,423,348,358,513,3054
61318,759,798,850,655,633,608,700,5003
61319,1096,993,1004,1104,1131,1097,1293,7718
61320,707,715,719,714,727,744,710,5036
61321,229,227,194,285,281,465,282,1963
61322,1449,1658,1615,1744,1716,1734,1647,11563
61323,124,91,114,94,95,68,111,697
61324,84,63,57,60,52,66,109,491
61325,1099,983,925,1008,1029,954,1073,7071
61326,2360,2342,2333,2295,2296,2340,2452,16418
61327,1350,1277,1339,1265,1216,1188,1235,8870
61328,0,16,14,13,13,11,42,109
61329,1252,1279,1300,1428,1419,1449,1303,9430
61330,1421,1402,1390,1387,1463,1508,1483,10054
61331,23,22,0,0,0,0,55,100
61332,96,81,77,83,79,66,134,616
61333,259,301,264,256,299,317,381,2077
61334,716,656,563,637,638,623,741,4574
61335,493,569,571,453,500,552,532,3670
61336,535,576,703,862,847,804,628,4955
61337,430,475,534,590,600,574,478,3681
61338,313,347,330,298,267,345,284,2184
61340,205,292,334,355,371,392,292,2241
61341,7593,7621,7599,7645,7877,8213,8234,54782
61342,9067,9008,9119,9255,8873,8931,9216,63469
61344,344,322,288,322,321,468,374,2439
61345,854,846,806,753,811,861,846,5777
61346,59,67,73,72,73,67,75,486
61348,4529,4559,4576,4592,4654,4661,4696,32267
61349,823,848,873,862,932,979,977,6294
61350,23992,23836,24070,24105,24281,24454,24246,168984
61353,1251,1271,1322,1374,1385,1321,1333,9257
61354,10771,10780,10794,10878,10851,10892,10870,75836
61356,11022,10977,10837,10900,11121,11108,11281,77246
61358,335,412,432,386,484,538,478,3065
61359,332,311,329,290,279,282,312,2135
61360,3614,3637,3901,3749,3764,3629,3393,25687
61361,1072,1112,1295,1366,1776,1606,1409,9636
61362,5599,5655,5675,5604,5673,5669,5911,39786
61363,234,235,228,250,261,214,220,1642
61364,19546,19812,20266,20396,20494,20779,20133,141426
61367,706,676,761,770,791,972,864,5540
61368,1490,1344,1397,1432,1236,1390,1489,9778
61369,1671,1510,1555,1531,1649,1787,1711,11414
61370,1438,1421,1308,1422,1532,1388,1460,9969
61372,183,144,141,121,100,89,145,923
61373,1949,1940,1850,1872,1950,2084,2031,13676
61374,107,127,129,121,93,86,119,782
61375,1181,1109,1135,1065,1052,990,1156,7688
61376,2682,2683,2579,2575,2244,2068,2280,17111
61377,1621,1599,1681,1664,1529,1509,1457,11060
61378,432,572,540,562,499,467,512,3584
61379,1414,1512,1661,1307,1393,1401,1359,10047
61401,34242,34544,34802,34631,34806,34970,34788,242783
61410,3808,3774,3533,3647,3643,3949,3912,26266
61411,363,278,344,311,367,315,378,2356
61412,1498,1419,1279,1281,1650,1693,1321,10141
61413,978,945,941,868,804,766,1075,6377
61414,909,810,821,656,842,736,854,5628
61415,1693,1629,1655,1555,1569,1605,1747,11453
61416,244,238,227,222,219,231,235,1616
61417,210,235,287,210,166,138,259,1505
61418,639,613,637,638,632,611,673,4443
61419,147,136,137,127,128,91,128,894
61420,1182,1174,1121,1074,1108,1085,1067,7811
61421,1237,1395,1415,1456,1608,1478,1392,9981
61422,3180,3284,3268,3310,3250,3326,3416,23034
61423,574,673,765,691,644,747,682,4776
61424,94,113,101,94,105,140,100,747
61425,304,227,260,229,295,307,483,2105
61426,106,52,79,115,113,112,107,684
61427,2174,2329,2371,2479,2361,2427,2329,16470
61428,947,940,884,846,830,851,986,6284
61430,777,813,807,807,784,753,828,5569
61431,397,469,502,476,358,305,371,2878
61432,582,609,617,638,601,537,676,4260
61433,77,0,0,0,124,99,74,374
61434,3034,3125,3219,3226,3275,3366,3312,22557
61435,70,134,112,146,151,160,116,889
61436,808,864,979,1131,1022,909,951,6664
61437,865,1060,1044,900,963,962,818,6612
61438,909,838,881,840,828,933,760,5989
61439,220,232,223,282,330,411,269,1967
61440,828,766,658,752,598,670,766,5038
61441,1126,1069,1052,1014,995,1045,897,7198
61442,686,709,670,659,580,651,762,4717
61443,13876,13885,13867,14037,14065,14072,14214,98016
61447,999,989,952,895,930,960,924,6649
61448,3687,3706,3865,3925,3869,3926,3823,26801
61449,460,573,546,590,558,660,512,3899
61450,1886,1901,1852,1751,1761,1763,1742,12656
61451,465,543,515,534,425,543,393,3418
61452,307,330,349,392,400,400,293,2471
61453,659,678,581,606,650,658,781,4613
61454,571,562,516,490,542,573,725,3979
61455,21464,21578,22084,22084,22051,22102,22086,153449
61458,922,941,1001,991,976,808,822,6461
61459,384,476,443,428,475,460,433,3099
61460,238,237,230,272,215,260,291,1743
61462,11713,11678,11669,11757,11499,11422,11643,81381
61465,1234,1278,1243,1239,1117,1121,1213,8445
61466,398,380,348,356,361,289,342,2474
61467,1086,1139,1140,1085,1088,1115,1048,7701
61468,56,146,127,147,264,242,104,1086
61469,2172,2239,2263,2405,2377,2337,2184,15977
61470,554,583,677,633,754,654,547,4402
61471,85,93,97,115,125,147,140,802
61472,537,587,510,711,640,657,648,4290
61473,1683,1647,1634,1649,1539,1433,1667,11252
61474,209,187,165,148,180,158,292,1339
61475,153,363,321,320,312,363,205,2037
61476,529,603,691,668,564,536,407,3998
61477,518,524,657,671,680,684,631,4365
61478,319,265,210,196,257,226,290,1763
61479,206,197,222,182,193,121,165,1286
61480,1281,1202,1412,1506,1530,1664,1324,9919
61482,642,553,534,589,559,676,650,4203
61483,2102,1884,1877,1854,1871,1891,1961,13440
61484,809,743,956,982,1063,1113,825,6491
61485,484,487,583,533,522,480,560,3649
61486,1395,1439,1554,1550,1598,1670,1552,10758
61488,1063,1007,1182,1124,1243,1214,1120,7953
61489,944,913,950,957,851,854,900,6369
61490,1291,1383,1443,1366,1310,1286,1091,9170
61491,2100,2235,2310,2247,2191,2147,2197,15427
61501,1688,1876,1846,1956,2058,1936,1921,13281
61516,730,655,592,684,692,637,720,4710
61517,3354,3075,3141,3154,2995,3021,3259,21999
61519,237,200,174,172,250,268,233,1534
61520,17232,17442,17420,17635,17677,17716,17839,122961
61523,11408,11311,11238,11386,11273,11278,11204,79098
61524,293,256,263,176,194,205,262,1649
61525,9268,9417,9549,9146,8925,8589,9021,63915
61526,926,1033,1138,1047,1073,1112,1088,7417
61528,2916,2766,2620,2409,2170,2248,2668,17797
61529,2666,2860,2836,2934,3039,2995,2880,20210
61530,7016,6903,6693,6500,6472,6614,6713,46911
61531,3334,3330,3375,3360,3329,3384,3379,23491
61532,640,514,518,552,613,591,534,3962
61533,2627,2439,2313,2302,2292,2261,2427,16661
61534,1736,1693,1739,1757,1648,1659,1737,11969
61535,1359,1320,1331,1453,1546,1719,1629,10357
61536,2822,2757,2725,2763,2880,2825,2919,19691
61537,2665,2772,2783,2871,3023,3154,2974,20242
61539,223,233,213,200,197,211,205,1482
61540,2769,2882,2686,2843,2891,2851,2916,19838
61541,109,110,129,128,117,105,136,834
61542,3665,3816,3811,3791,3910,3962,3794,26749
61543,180,160,130,126,115,89,151,951
61544,559,563,648,733,747,738,713,4701
61545,727,933,855,870,803,662,646,5496
61546,3717,4081,4173,4554,4662,4973,4276,30436
61547,4152,4247,4240,4267,3790,3795,3779,28270
61548,12133,12082,12210,12257,11954,11888,12085,84609
61550,17847,17839,17731,17777,17640,17510,17721,124065
61552,181,185,213,241,195,140,239,1394
61553,167,172,194,231,260,219,213,1456
61554,43456,43557,43691,43781,43442,43529,43810,305266
61559,3099,3156,3241,3308,3485,3342,3332,22963
61560,498,483,441,504,536,555,754,3771
61561,2714,2736,2772,2786,2716,2887,2788,19399
61562,0,64,54,62,141,154,46,521
61563,575,552,512,450,406,436,526,3457
61564,1058,1104,1093,1191,1215,1088,1077,7826
61565,1481,1483,1656,1710,1467,1547,1504,10848
61567,596,606,522,478,506,363,624,3695
61568,4097,4232,4421,4514,4632,4569,4459,30924
61569,1130,1022,925,852,954,949,1220,7052
61570,1758,1742,1772,1788,1847,1794,1879,12580
61571,24674,24445,24147,24053,23716,23375,23744,168154
61572,1120,1238,1221,1255,1319,1318,1068,8539
61602,1058,1015,978,1008,997,1098,1055,7209
61603,16594,16775,16503,16557,16790,16821,17600,117640
61604,31256,31821,31790,31427,31481,31189,31647,220611
61605,16243,15859,15871,15794,15673,15266,16303,111009
61606,7868,7904,8197,7989,8558,9463,8051,58030
61607,11154,11455,11476,11212,11161,11057,10941,78456
61610,5653,5652,5717,5498,5490,5320,5476,38806
61611,25243,25463,25495,25203,25203,24972,25268,176847
61614,28600,27967,28632,28401,28477,28407,27628,198112
61615,22984,23212,22710,23716,22926,22702,22432,160682
61616,6019,6026,6041,6080,6078,6112,6116,42472
61625,344,337,284,570,603,364,385,2887
61701,35788,35589,35511,36129,36618,37065,36105,252805
61704,36869,36817,36808,35677,34964,34343,35981,251459
61705,13273,13474,13254,13044,12327,11600,12263,89235
61720,185,164,179,157,155,219,236,1295
61721,644,610,629,613,780,757,613,4646
61722,419,471,501,610,607,663,549,3820
61723,1971,1811,1762,1693,1727,1755,2321,13040
61724,614,440,532,450,483,463,536,3518
61725,1629,1368,1471,1514,1540,1433,1547,10502
61726,2424,2340,2454,2597,2544,2441,2544,17344
61727,10019,9940,10161,10268,9888,10207,10015,70498
61728,1320,1413,1418,1418,1456,1569,1410,10004
61729,1089,1029,1057,991,991,948,1073,7178
61730,291,327,404,378,454,419,379,2652
61731,144,206,269,208,226,249,280,1582
61732,2114,1961,2037,2012,1959,1898,2096,14077
61733,988,929,998,979,977,913,1124,6908
61734,2891,2956,2880,2753,2721,2788,2867,19856
61735,527,533,548,576,597,499,420,3700
61736,1760,1813,1825,1676,1729,1843,1808,12454
61737,635,720,730,654,593,751,516,4599
61738,4560,4603,4494,4448,4354,4166,4212,30837
61739,4799,4790,4948,5001,4833,4897,4897,34165
61740,1669,1733,1779,1664,1596,1666,1634,11741
61741,1593,1719,1744,1608,1573,1642,1746,11625
61742,1249,1231,1352,1431,1478,1341,1144,9226
61743,208,208,224,219,229,245,212,1545
61744,1863,1885,1863,1827,1942,1958,2031,13369
61745,4364,4364,4258,4340,4381,4259,4408,30374
61747,1348,1458,1584,1511,1562,1612,1560,10635
61748,2764,2808,2776,2692,2624,2651,2782,19097
61749,501,515,549,636,620,600,556,3977
61750,103,93,115,59,55,89,133,647
61751,128,116,99,115,81,128,124,791
61752,4451,4451,4389,4353,4246,4050,4339,30279
61753,3362,3307,3076,3115,3033,2760,3012,21665
61754,1089,1148,1181,1300,1320,1373,1261,8672
61755,4772,4768,4708,4724,4700,4700,4669,33041
61756,2426,2254,2261,2261,2428,2466,2337,16433
61759,1813,1779,1595,1653,1493,1377,1534,11244
61760,2512,2475,2497,2380,2640,2746,2544,17794
61761,54812,54779,54454,53926,53282,52648,52879,376780
61764,14714,14418,14404,14464,14512,14493,14460,101465
61769,553,550,573,541,507,527,619,3870
61770,1115,990,994,1127,1115,1140,1108,7589
61771,933,1065,1080,1120,1109,1164,860,7331
61772,291,311,371,338,300,281,351,2243
61773,507,562,553,553,596,539,477,3787
61774,1002,985,871,989,991,1197,962,6997
61775,351,380,360,338,433,481,307,2650
61776,1389,1587,1582,1716,1834,1943,1409,11460
61777,734,720,780,800,706,839,952,5531
61778,820,911,800,688,869,788,683,5559
61801,31558,31359,31300,31196,31751,32304,30937,220405
61802,18537,18993,19084,18944,18320,17688,19052,130618
61810,322,257,269,185,246,201,361,1841
61811,545,788,677,664,866,809,703,5052
61812,418,407,409,426,366,372,375,2773
61813,1908,1930,1952,2025,2080,2119,1971,13985
61814,1289,1301,1284,1268,1134,1073,1157,8506
61815,257,214,253,262,329,316,228,1859
61816,462,540,512,465,475,448,509,3411
61817,2655,2660,2892,2912,2742,2660,2583,19104
61818,1667,1666,1557,1544,1586,1593,1665,11278
61820,36455,36204,36092,35792,36026,37130,36964,254663
61821,30784,30401,30757,30631,29893,29196,30174,211836
61822,25105,24759,23590,23086,22834,21677,21608,162659
61830,289,323,528,637,698,696,478,3649
61831,142,122,116,109,120,133,157,899
61832,35812,36965,37330,37343,37593,38411,37290,260744
61833,2275,2084,2051,2153,2134,2103,2124,14924
61834,8492,7953,7780,7774,7571,7141,8454,55165
61839,681,657,682,666,640,703,586,4615
61840,901,876,846,778,531,480,709,5121
61841,1375,1398,1198,1316,1444,1320,1386,9437
61842,2620,2911,2856,2843,3233,3146,2984,20593
61843,2326,2246,2210,2318,2355,2211,2363,16029
61844,843,871,898,954,908,1021,970,6465
61845,275,298,450,403,475,555,364,2820
61846,5007,5084,5222,5057,5164,5356,5101,35991
61847,1149,1132,1250,1268,1246,1242,1256,8543
61848,232,234,245,237,227,227,227,1629
61849,1765,1763,1734,1689,1719,1736,1842,12248
61850,510,553,580,582,579,615,671,4090
61851,269,321,324,314,335,351,436,2350
61852,246,263,289,283,235,236,261,1813
61853,13819,13695,13453,13142,12810,12718,13206,92843
61854,1211,1460,1547,1689,1700,1540,1438,10585
61855,157,240,226,241,194,97,96,1251
61856,7600,7426,7344,7159,7219,7128,7433,51309
61857,194,193,151,108,90,102,153,991
61858,2908,2901,2910,2965,3139,3070,3124,21017
61859,1267,1266,1289,1263,1225,1295,1297,8902
61862,518,486,465,468,445,470,510,3362
61863,683,723,677,662,692,710,814,4961
61864,1750,1903,1855,1912,1796,1829,1715,12760
61865,1334,1284,1387,1441,1636,1691,1391,10164
61866,14270,14216,14195,14113,14184,14141,14048,99167
61870,1234,1282,1339,1495,1497,1439,1327,9613
61871,234,229,254,257,252,273,284,1783
61872,1172,1101,1091,918,977,1054,760,7073
61873,6520,6470,6341,6244,6196,6107,6250,44128
61874,7846,7694,7504,7050,6816,6420,7114,50444
61875,849,825,683,713,741,625,761,5197
61876,769,782,882,1014,842,760,800,5849
61877,1842,1810,1773,2016,1948,2004,1627,13020
61878,1396,1556,1432,1356,1348,1377,1433,9898
61880,3980,4058,4028,4420,4546,4345,4183,29560
61882,713,740,680,662,650,619,713,4777
61883,4279,4362,4447,4413,4415,4504,4438,30858
61884,1222,1192,1168,1163,1130,1179,1244,8298
61910,4142,4309,4371,4366,4383,4365,4463,30399
61911,5034,4714,5013,5292,5424,5527,4860,35864
61912,1275,1227,1260,1324,1326,1330,1344,9086
61913,1399,1492,1549,1479,1516,1618,1684,10737
61914,1832,1814,1721,1725,1831,1807,1920,12650
61917,666,683,645,604,680,622,591,4491
61919,965,975,1021,1046,974,804,813,6598
61920,25043,25419,25959,26109,25959,25830,25594,179913
61924,2426,2445,2473,2538,2402,2416,2449,17149
61925,572,571,810,866,853,937,912,5521
61928,694,709,954,1159,1018,1044,757,6335
61929,744,708,690,652,648,635,769,4846
61930,542,495,435,462,587,678,515,3714
61931,1277,1196,1369,1231,1137,925,1255,8390
61932,464,471,463,467,465,535,456,3321
61933,941,980,1237,1119,1141,1365,1141,7924
61936,161,157,133,137,120,169,243,1120
61937,2167,2076,1974,1998,1845,1919,2022,14001
61938,21808,22070,21898,21927,21873,21944,22409,153929
61940,217,242,284,264,222,263,258,1750
61941,66,56,20,37,49,42,57,327
61942,1222,1245,1283,1279,1227,1251,1202,8709
61943,1646,1531,1381,1342,1346,1433,1637,10316
61944,12038,12231,12194,12399,12734,12762,12908,87266
61949,133,124,177,195,194,212,179,1214
61951,8125,8353,8254,8048,8022,7661,8017,56480
61953,6241,6336,6209,6251,6287,6240,6216,43780
61955,229,178,186,149,154,162,157,1215
61956,2551,2553,2625,2642,2717,2879,2909,18876
61957,2211,2296,2161,2119,2009,1975,1869,14640
62001,1625,1754,1692,1620,1599,1754,1752,11796
62002,31742,32040,32459,32345,32292,32141,32704,225723
62006,621,602,648,572,581,539,648,4211
62009,1773,1836,1932,1973,1934,1866,1810,13124
62010,11576,11309,11083,11303,11113,11032,11186,78602
62011,195,191,277,271,315,374,284,1907
62012,6518,6490,6475,6809,6758,6860,6654,46564
62013,507,488,486,525,550,537,552,3645
62014,4147,4279,4266,4194,4015,4000,4122,29023
62015,462,388,314,370,319,366,487,2706
62016,3654,3808,3727,3717,3687,3679,3816,26088
62017,903,645,730,771,802,921,1185,5957
62018,3286,3533,3692,4065,4390,4428,3604,26998
62019,385,345,411,401,477,527,490,3036
62021,932,778,728,812,726,768,936,5680
62022,846,984,916,987,944,1142,1138,6957
62023,134,135,121,88,50,48,91,667
62024,9695,9772,9731,9652,9703,9847,9775,68175
62025,34151,34092,33742,33736,33356,33448,33748,236273
62027,462,438,476,557,513,457,536,3439
62028,1340,1324,1386,1316,1275,1213,1276,9130
62030,161,133,140,140,145,116,114,949
62031,987,991,823,825,876,784,970,6256
62032,690,664,617,633,771,890,749,5014
62033,4639,4661,4764,4732,4905,4898,4894,33493
62034,13662,13827,13933,14089,14228,13529,13819,97087
62035,16238,16247,16285,16163,16232,16472,16494,114131
62036,767,700,715,660,668,860,704,5074
62037,2125,1851,1971,2001,1951,1942,1993,13834
62040,42880,42495,43027,43276,43303,44140,43735,302856
62044,2128,2231,2227,2350,2376,2433,2009,15754
62045,443,436,417,515,584,558,647,3600
62046,900,773,750,743,577,440,713,4896
62047,1603,1751,1732,1911,1782,1767,1555,12101
62048,1686,1779,1549,1527,1552,1616,1459,11168
62049,9493,10461,10994,10575,10178,8728,8470,68899
62050,412,459,342,346,279,302,473,2613
62051,857,823,705,691,604,809,950,5439
62052,12502,12994,13323,13223,13238,13173,13002,91455
62053,648,610,639,515,590,543,650,4195
62054,809,818,694,532,585,634,872,4944
62056,8776,8862,8862,8815,8819,8886,8930,61950
62058,790,790,833,732,747,803,843,5538
62059,726,836,807,777,669,495,746,5056
62060,4671,4959,4887,4871,5102,5187,4847,34524
62061,1687,1869,2095,2151,2267,2098,1718,13885
62062,8126,8204,8161,8000,7806,7543,7658,55498
62063,1225,1161,1062,1056,1125,1201,1214,8044
62065,82,94,98,64,69,24,97,528
62067,2552,2460,2498,2202,2500,2468,2401,17081
62069,3053,3063,3158,3235,3263,3225,3313,22310
62070,22,27,23,11,10,42,37,172
62074,1470,1379,1391,1165,1213,1084,1087,8789
62075,3384,3275,3251,3466,3621,3669,3458,24124
62076,113,110,88,76,97,129,135,748
62077,284,259,235,230,180,195,347,1730
62078,100,94,119,126,99,120,119,777
62079,300,327,359,407,489,396,256,2534
62080,2809,2753,2569,2830,2731,2580,2508,18780
62081,355,345,355,325,313,286,298,2277
62082,2933,2747,2944,2927,3098,3035,3109,20793
62083,389,379,271,385,365,392,295,2476
62084,1746,1610,1546,1601,1620,1666,1606,11395
62085,203,208,188,172,216,204,209,1400
62086,1484,1452,1543,1563,1477,1448,1437,10404
62087,2316,2362,2294,2239,2247,2260,2087,15805
62088,6583,6592,6796,7114,7031,7163,6960,48239
62089,292,372,381,369,405,431,489,2739
62090,1187,1189,1083,1114,961,925,1189,7648
62091,287,323,309,260,336,320,337,2172
62092,2932,2922,3050,3156,3053,3138,2979,21230
62093,474,426,462,398,382,334,435,2911
62094,1090,855,872,998,952,1066,1152,6985
62095,10705,10876,10977,11066,11183,11253,11237,77297
62097,2959,2918,2602,2495,2620,2687,2828,19109
62098,24,35,132,122,122,131,91,657
62201,7655,7656,7897,7065,7205,7534,7547,52559
62203,7379,7384,7163,7542,8327,7963,8209,53967
62204,8295,8503,8612,8806,8627,8935,7960,59738
62205,8391,8745,8645,9203,8819,9071,9329,62203
62206,15405,15713,16222,16556,16734,16901,16509,114040
62207,8989,8646,8445,8374,8693,8590,8750,60487
62208,16758,16885,16969,17185,16899,16877,17376,118949
62214,1173,1104,1100,1095,1053,1103,1229,7857
62215,1786,1731,1763,1742,1919,1789,1872,12602
62216,2955,2925,2847,2678,2642,2477,2526,19050
62217,609,660,738,690,762,768,807,5034
62218,1743,1794,1769,1674,1678,1534,1481,11673
62219,950,907,957,956,893,1007,1009,6679
62220,19922,20063,20065,20366,20695,21092,20504,142707
62221,28228,28402,29028,27656,27571,26856,27858,195599
62223,17128,17297,17344,17698,17786,17104,17560,121917
62225,5192,5051,5343,5590,5586,5842,5381,37985
62226,29019,29862,29624,29913,29221,29076,29744,206459
62230,6273,6288,6254,6350,6315,6244,6194,43918
62231,7378,7481,7358,7354,7352,7615,7589,52127
62232,7269,7070,7155,6970,7114,6919,7260,49757
62233,9922,9839,9769,9834,9842,9952,10037,69195
62234,31937,32054,32498,32843,33038,33045,33430,228845
62236,13329,13114,12682,12648,12670,12250,12562,89255
62237,2606,2806,2767,2776,2787,2553,2659,18954
62238,697,592,686,739,788,672,696,4870
62239,5012,4933,4895,4650,4722,4891,4954,34057
62240,1790,1933,2230,2209,2183,2121,1966,14432
62241,989,1124,1176,1288,1381,1276,1061,8295
62242,1278,1346,1391,1357,1539,1650,1526,10087
62243,5769,5685,5914,5989,5870,5891,5910,41028
62244,1131,1096,1175,1300,1161,1386,1156,8405
62245,1675,1575,1556,1610,1681,1669,1794,11560
62246,9960,9996,10145,10321,10428,10716,10355,71921
62248,356,323,304,264,322,309,320,2198
62249,15764,15790,15726,15569,15318,15019,15971,109157
62250,486,467,551,552,584,530,504,3674
62253,669,825,737,810,790,698,696,5225
62254,5875,5927,5691,5495,5636,5656,6089,40369
62255,1258,1073,887,892,843,842,1001,6796
62257,2734,2955,3139,3032,3430,3408,3214,21912
62258,9623,9467,9446,9418,9160,9299,9199,65612
62260,7252,6862,6784,6763,7167,7505,7290,49623
62261,123,148,149,154,184,146,152,1056
62262,1787,1773,1834,1722,1744,1743,1810,12413
62263,5078,5192,5295,5296,5268,5367,5387,36883
62264,3237,3253,3238,3410,3508,3503,3338,23487
62265,4511,4562,4531,4566,4252,4432,4353,31207
62266,172,259,334,342,238,247,254,1846
62268,673,674,739,822,833,790,738,5269
62269,31791,31674,31791,32011,31441,30942,31348,220998
62271,2227,2041,2095,1956,2072,2047,2077,14515
62272,1681,1806,1706,1589,1343,1502,1674,11301
62273,381,470,471,393,413,256,426,2810
62274,7883,8111,8304,8394,8337,8514,8410,57953
62275,3549,3497,3435,3511,3712,3523,3621,24848
62277,1387,1501,1513,1183,1174,1567,1314,9639
62278,6785,7091,7119,7329,7329,6994,6690,49337
62279,35,36,58,62,61,27,69,348
62280,466,336,426,494,491,376,444,3033
62281,2373,2065,2172,2218,2058,2176,2155,15217
62282,456,509,494,475,489,403,471,3297
62284,500,616,587,564,562,713,636,4178
62285,4414,4476,4372,4382,4434,4294,4484,30856
62286,6186,6019,6077,6173,6197,6452,6008,43112
62288,3074,3044,2886,2894,2888,2791,2918,20495
62289,368,384,386,327,351,370,350,2536
62292,763,694,702,744,786,815,947,5451
62293,4736,4805,4677,4882,4902,4737,4748,33487
62294,14304,14261,14548,14593,14576,14419,14367,101068
62295,1414,1670,1681,1696,1788,1870,1599,11718
62297,345,332,244,203,207,155,452,1938
62298,16903,16557,16534,16471,15810,15619,16609,114503
62301,32664,32848,33024,33125,33552,33698,33758,232669
62305,19050,18877,18853,18624,18275,18291,18052,130022
62311,608,725,795,1018,964,1090,860,6060
62312,2472,2380,2359,2285,2155,2404,2162,16217
62313,321,261,239,247,468,471,389,2396
62314,549,566,548,498,449,406,611,3627
62316,714,733,729,775,747,610,660,4968
62319,219,247,331,256,250,228,264,1795
62320,2016,1883,2058,2105,2298,2325,2185,14870
62321,4107,3971,3904,3978,3902,3807,4091,27760
62323,173,185,195,164,143,158,290,1308
62324,1066,1078,1108,1224,1215,1172,1361,8224
62325,520,546,407,374,320,268,403,2838
62326,2439,2437,2197,2267,2207,2278,2478,16303
62330,1902,1815,1766,1852,1834,2060,1769,12998
62334,124,119,104,134,122,112,172,887
62336,36,50,71,95,103,73,47,475
62338,1335,1148,1134,1348,1407,1507,1473,9352
62339,811,916,996,916,878,959,874,6350
62340,1794,1626,1457,1569,1625,1528,1715,11314
62341,3499,3535,3538,3545,3523,3553,3610,24803
62343,775,628,572,533,593,553,712,4366
62344,96,83,89,134,139,118,138,797
62345,482,487,450,395,397,339,357,2907
62346,198,235,184,183,176,129,178,1283
62347,2371,2685,2457,2612,2609,2593,2282,17609
62348,155,206,162,187,190,263,170,1333
62349,543,484,475,495,525,480,636,3638
62351,1871,1840,1933,1882,1967,1804,1856,13153
62352,277,287,296,400,425,415,271,2371
62353,5493,5198,5343,5414,5444,5384,5637,37913
62354,1709,1653,1685,1578,1563,1491,1684,11363
62355,912,898,865,868,838,829,820,6030
62356,442,476,527,583,629,660,571,3888
62357,198,205,219,197,199,216,245,1479
62358,851,955,895,752,770,634,752,5609
62359,257,271,260,214,162,39,166,1369
62360,1932,2021,2013,1946,1757,1737,1656,13062
62361,555,647,763,720,631,680,539,4535
62362,325,329,355,343,409,435,399,2595
62363,5952,5959,6134,6049,6088,6188,6353,42723
62365,684,760,797,724,880,714,647,5206
62366,1584,1721,1696,1827,1817,1859,1408,11912
62367,842,926,1086,1122,1224,1218,1345,7763
62370,411,392,487,528,387,338,520,3063
62373,327,356,396,314,333,228,300,2254
62374,213,215,382,327,342,340,298,2117
62375,350,555,531,470,607,578,369,3460
62376,1093,1178,1116,1102,1095,1131,1198,7913
62378,962,1068,998,1013,862,935,896,6734
62379,1805,1917,1823,2057,2063,2242,2049,13956
62380,418,355,370,345,352,278,401,2519
62401,18925,18824,18673,18539,18534,18513,19096,131104
62410,1199,1179,1032,942,997,966,985,7300
62411,4247,4356,4575,4653,4484,4372,4430,31117
62413,432,381,371,301,270,349,421,2525
62414,2033,1970,1821,1647,1744,1599,1886,12700
62417,2488,2123,2075,2159,2187,3061,3064,17157
62418,1694,1814,1850,1884,2134,2357,2133,13866
62419,362,408,392,405,390,466,410,2833
62420,4701,4574,4551,4598,4786,4810,4759,32779
62421,807,809,1022,1034,986,868,778,6304
62422,1113,1119,1169,1116,1112,1039,1156,7824
62423,503,567,686,810,866,913,724,5069
62424,2482,2314,2222,2185,1915,1889,2092,15099
62425,351,563,678,704,621,619,649,4185
62426,884,1085,1124,1030,1081,1200,1085,7489
62427,1650,1549,1619,1627,1739,1955,1702,11841
62428,2785,3188,3271,3309,3366,3598,3104,22621
62431,952,1056,1128,1116,1025,947,1232,7456
62432,350,371,415,468,541,469,571,3185
62433,922,965,858,1049,1048,1012,998,6852
62434,325,303,247,176,192,167,330,1740
62436,602,617,605,688,489,533,562,4096
62438,340,423,400,470,435,402,433,2903
62439,6883,6767,7105,7010,7073,7576,7536,49950
62440,1346,1372,1345,1218,1407,1423,1316,9427
62441,7134,7244,7419,7437,7370,7277,7395,51276
62442,2566,2387,2236,2239,2259,2185,2421,16293
62443,1588,1632,1610,1578,1852,1991,1623,11874
62444,262,341,365,407,438,469,387,2669
62445,1365,1260,1225,945,1011,812,907,7525
62446,362,371,361,389,389,398,414,2684
62447,3419,3274,3215,3158,3176,3306,3404,22952
62448,5877,5946,6042,5658,5821,5955,5834,41133
62449,3203,3021,3065,2971,2959,3025,3175,21419
62450,12485,12439,12165,12211,12152,12115,12218,85785
62451,1995,2061,2220,2429,2432,2215,2156,15508
62452,494,479,470,458,555,514,400,3370
62454,11280,11449,11433,11395,11488,11491,11467,80003
62458,1919,2001,2227,2365,2308,2573,2228,15621
62459,273,273,255,223,254,246,243,1767
62460,912,892,848,970,1055,1249,1231,7157
62461,699,782,801,827,903,813,854,5679
62462,949,957,1081,1117,1134,1123,1149,7510
62463,1342,1316,1201,1246,1243,1217,1294,8859
62465,931,1015,987,1023,1005,1009,858,6828
62466,6346,6940,6607,6412,6195,4640,4848,41988
62467,4066,3924,4001,3919,4036,3808,3741,27495
62468,2646,2590,2610,2649,2462,2502,2564,18023
62469,567,510,432,337,294,216,419,2775
62471,10019,9948,9524,9767,9771,9703,10233,68965
62473,1579,1521,1457,1508,1481,1693,1422,10661
62474,1036,1051,984,896,825,941,848,6581
62475,340,300,314,458,346,276,387,2421
62476,1641,1902,1985,2074,1999,2113,1734,13448
62477,1057,1092,1033,1089,1223,1132,946,7572
62478,401,437,406,318,301,316,398,2577
62479,871,941,919,899,917,1033,820,6400
62480,451,432,500,765,742,811,787,4488
62481,412,391,279,284,222,239,386,2213
62501,2819,2605,2523,2372,2491,2604,2661,18075
62510,1869,1993,1898,1905,1766,1594,1669,12694
62512,304,321,471,387,340,396,500,2719
62513,1654,1591,1599,1690,1852,1904,1766,12056
62514,239,207,195,297,186,184,252,1560
62515,1003,1047,1101,966,898,855,961,6831
62517,193,262,291,315,338,364,226,1989
62518,360,333,357,377,348,295,457,2527
62519,70,50,51,41,60,66,94,432
62520,1477,1498,1357,1311,1293,1560,1529,10025
62521,35870,35676,35769,35787,35383,35498,35851,249834
62522,15456,15903,16547,16880,17235,17399,16630,116050
62523,1284,1058,1011,906,905,899,1237,7300
62526,33205,33637,33487,33559,33826,33726,34075,235515
62530,1566,1519,1551,1539,1625,1632,1532,10964
62531,1959,1926,1851,1811,1761,1758,1792,12858
62532,65,81,76,56,166,192,105,741
62533,833,740,709,764,846,1077,973,5942
62534,1167,1201,1151,1224,1231,1327,1130,8431
62535,3558,3610,3783,3876,3785,3498,3534,25644
62536,854,959,1020,908,986,986,912,6625
62537,57,45,50,37,38,33,92,352
62538,307,287,255,290,350,418,378,2285
62539,1349,1422,1438,1472,1408,1310,1358,9757
62540,1680,1653,1666,1621,1572,1505,1492,11189
62541,54,38,101,155,156,179,57,740
62543,465,418,400,412,520,609,540,3364
62544,1811,2048,2020,1973,1822,1714,1776,13164
62545,1066,957,900,891,934,1044,1246,7038
62546,1510,1366,1383,1479,1569,1645,1630,10582
62547,744,840,875,870,890,806,804,5829
62548,2081,1762,1765,1787,1787,2087,2258,13527
62549,6293,6410,6071,6101,6019,5864,6269,43027
62550,2836,2733,2822,2801,2806,2748,2869,19615
62551,626,758,755,852,903,937,837,5668
62553,556,430,510,478,488,563,437,3462
62554,1444,1564,1635,1495,1582,1767,1563,11050
62555,516,486,454,468,391,397,540,3252
62556,301,245,331,362,438,424,422,2523
62557,7086,7102,7026,7132,7109,7264,7607,50326
62558,3561,3625,3575,3630,3577,3533,3590,25091
62560,1251,1112,1048,1119,1215,1492,1508,8745
62561,5184,5246,5268,5281,5269,5141,5315,36704
62563,5707,5706,5927,5844,5874,5750,5686,40494
62565,7603,7488,7541,7562,7517,7463,7538,52712
62567,1027,1098,1127,1038,1018,1095,1154,7557
62568,15985,16273,16417,16512,16584,16669,16355,114795
62570,460,483,483,488,492,548,512,3466
62571,1306,1465,1558,1473,1903,2010,1532,11247
62572,540,513,491,577,694,738,666,4219
62573,1675,1537,1471,1511,1379,1495,1513,10581
62601,382,434,518,478,501,437,434,3184
62610,168,220,251,273,311,336,199,1758
62611,971,1096,1196,1227,987,977,1067,7521
62612,1864,1904,1718,2065,2110,2015,1915,13591
62613,3745,3679,3694,3774,3597,3762,3872,26123
62615,5659,5592,5638,5577,5586,5533,5748,39333
62617,708,679,725,706,738,642,762,4960
62618,7822,7849,7998,7843,7938,7907,7955,55312
62621,1217,1321,1291,1308,1285,1324,1171,8917
62622,57,54,0,0,0,16,49,176
62624,475,473,527,662,659,650,546,3992
62625,752,734,688,754,845,774,855,5402
62626,7925,8237,8459,8227,8312,8327,8354,57841
62627,977,994,1068,1093,1076,1025,992,7225
62628,823,752,782,814,876,964,896,5907
62629,13598,13652,13442,13464,13138,12613,12949,92856
62630,441,633,568,546,514,476,532,3710
62631,266,293,248,213,253,230,262,1765
62633,685,643,659,690,598,525,647,4447
62634,697,692,701,629,556,716,821,4812
62635,598,593,600,613,553,571,738,4266
62638,1298,1251,1309,1206,1251,1174,1337,8826
62639,257,241,251,209,187,299,316,1760
62640,3784,3828,3787,3909,3777,4113,3756,26954
62642,1524,1524,1605,1529,1526,1606,1440,10754
62643,475,436,405,365,400,408,526,3015
62644,5058,5118,5200,5316,5346,5401,5385,36824
62649,474,484,438,457,553,500,488,3394
62650,26948,27170,27069,27001,27100,27663,26992,189943
62655,576,609,631,611,571,576,568,4142
62656,21505,22366,22386,22626,22720,22005,20405,154013
62661,1382,1339,1258,966,1029,1189,1213,8376
62663,296,327,385,454,454,452,292,2660
62664,2756,2943,3050,2998,3107,3218,3042,21114
62665,1491,1490,1559,1524,1533,1451,1629,10677
62666,595,542,537,485,512,566,616,3853
62667,332,313,309,390,468,415,464,2691
62668,1318,1277,1460,1393,1409,1284,1512,9653
62670,3236,3297,3417,3692,3274,3171,2997,23084
62671,434,344,340,389,457,459,572,2995
62672,246,223,226,217,211,197,244,1564
62673,537,677,744,697,609,614,530,4408
62674,1378,1307,1413,1409,1493,1479,1454,9933
62675,6142,6236,6113,6065,6214,5802,6154,42726
62677,2295,2438,2481,2680,2684,2507,2562,17647
62681,5656,5727,5650,5505,5491,5479,5602,39110
62682,956,830,707,667,751,944,907,5762
62684,5581,5821,5759,5608,5601,5524,5111,39005
62685,2079,1876,1756,1893,2093,2182,2097,13976
62688,635,551,610,659,792,959,761,4967
62689,528,529,458,488,427,444,518,3392
62690,4106,4169,4204,4210,4200,4176,4120,29185
62691,2050,2017,2080,2119,2156,2385,2426,15233
62692,1997,1956,1872,2010,2011,1966,2093,13905
62693,1563,1653,1755,1631,1536,1604,1638,11380
62694,2936,2853,2881,2940,3029,3012,3192,20843
62695,209,241,229,233,270,315,296,1793
62701,1108,1086,1045,1095,983,1133,1152,7602
62702,34447,35357,35928,36300,37820,37077,37281,254210
62703,31492,32073,30803,30644,29593,29946,30333,214884
62704,40549,39766,40172,39883,39925,40065,39831,280191
62707,7622,7304,7378,7783,7669,7782,7648,53186
62711,16839,16445,16657,16364,15721,15298,15347,112671
62712,10380,10131,10099,9835,9804,9883,10302,70434
62801,22125,22225,22432,22585,22613,22791,22415,157186
62803,969,1085,978,1099,1006,1102,1014,7253
62806,3433,3431,3275,3389,3359,3375,3412,23674
62807,769,917,1024,1063,1040,1107,961,6881
62808,1397,1424,1529,1570,1744,1793,1457,10914
62809,115,110,87,100,121,118,142,793
62810,1011,911,992,1006,1024,1024,1089,7057
62811,193,204,193,208,231,249,310,1588
62812,11114,11307,11263,11349,11352,11223,11265,78873
62814,2036,2118,1967,1907,1929,1870,2124,13951
62815,407,392,402,394,358,341,416,2710
62816,1449,1442,1430,1433,1319,1228,1306,9607
62817,538,542,685,685,784,671,557,4462
62818,213,258,297,341,427,434,330,2300
62819,463,423,517,440,389,422,448,3102
62820,120,152,180,170,179,161,162,1124
62821,7389,7436,7518,7578,7513,7562,7657,52653
62822,3279,3130,3025,2830,2745,2828,2574,20411
62823,1723,1731,1772,1880,1782,1817,1691,12396
62824,1620,1757,1780,1862,1773,1774,1761,12327
62825,156,185,178,222,211,214,203,1369
62827,1202,1242,1165,1282,1337,1374,1245,8847
62828,1320,1333,1399,1264,1276,1392,1426,9410
62829,26,64,57,122,118,111,72,570
62830,1382,1475,1388,1354,1426,1586,1392,10003
62831,510,495,538,511,495,464,573,3586
62832,8998,9078,9067,8835,9023,8957,9208,63166
62833,304,283,252,206,227,178,383,1833
62835,969,1080,1107,1052,1177,1031,1152,7568
62836,769,685,732,676,742,723,801,5128
62837,8790,8786,8990,8914,9015,9145,8867,62507
62838,1809,1835,2021,1764,1795,1508,1497,12229
62839,6505,6572,6617,6678,6608,6568,6718,46266
62841,155,137,140,137,103,86,98,856
62842,779,767,828,837,970,1034,835,6050
62843,93,96,48,89,131,103,100,660
62844,2242,1985,2013,1960,1943,2117,2083,14343
62846,2685,2616,2539,2580,2544,2591,2631,18186
62848,692,786,683,529,626,537,636,4489
62849,2215,2212,2316,2409,2451,2190,2205,15998
62850,342,365,238,235,305,264,381,2130
62851,245,264,318,242,249,383,329,2030
62852,93,107,137,135,129,123,160,884
62853,846,850,943,857,856,987,1034,6373
62854,1699,1735,1776,1645,1606,1759,1776,11996
62856,319,292,310,279,217,270,324,2011
62858,3111,3067,3210,3260,3325,3156,2981,22110
62859,5602,5609,5531,5577,5611,5680,5748,39358
62860,616,551,541,485,481,423,524,3621
62861,130,118,96,136,133,117,128,858
62862,324,353,319,333,343,377,364,2413
62863,9741,9676,9908,10047,10115,10157,10183,69827
62864,23630,23843,24068,24124,24305,24532,24108,168610
62865,1996,2000,1989,1686,1823,1989,2018,13501
62867,502,461,473,450,528,630,521,3565
62868,1519,1446,1566,1695,1715,1799,1872,11612
62869,2776,2760,2887,2841,2746,2572,2682,19264
62870,1977,2026,1855,2009,1995,2031,2080,13973
62871,688,690,727,675,640,757,686,4863
62872,1067,1209,1264,1196,1114,1161,1178,8189
62874,449,439,458,377,341,304,372,2740
62875,1210,1165,1173,1110,1139,1126,1167,8090
62876,160,171,176,206,252,236,247,1448
62877,492,589,519,579,498,548,514,3739
62878,361,345,365,328,295,316,410,2420
62879,99,90,103,86,113,115,85,691
62880,656,494,604,528,573,677,717,4249
62881,11193,11115,11183,11164,11386,11305,11385,78731
62882,2298,2251,2193,2239,2175,2217,2331,15704
62883,845,739,813,820,803,760,591,5371
62884,2781,2857,2773,2890,2884,2913,2940,20038
62885,1023,1081,1048,945,769,751,839,6456
62886,413,424,485,559,480,459,440,3260
62887,492,359,364,303,237,269,295,2319
62888,2070,1991,2212,2460,2504,2621,2135,15993
62889,803,907,1006,920,852,878,851,6217
62890,2927,3044,2888,3318,3422,3307,2882,21788
62891,583,579,610,631,596,553,652,4204
62892,429,355,306,238,247,243,317,2135
62893,1053,916,798,910,887,867,977,6408
62894,981,875,912,969,1022,1067,1006,6832
62895,2095,2270,2212,2178,2094,2079,2022,14950
62896,11984,12045,12247,12359,12605,12680,12626,86546
62897,405,344,415,413,550,520,398,3045
62898,2263,2203,2090,2125,2012,1893,2097,14683
62899,1879,1698,1598,1697,1779,1783,1612,12046
62901,26752,27035,27557,27417,27823,27666,27182,191432
62902,4714,4752,4534,4544,4506,4531,4531,32112
62903,2912,3092,2711,2646,2248,2333,2962,18904
62905,687,654,829,799,800,773,677,5219
62906,6724,6779,6833,6988,7007,6934,7276,48541
62907,2150,1953,2212,2406,2362,2445,2164,15692
62908,481,376,497,419,458,432,467,3130
62910,2395,2380,2414,2496,2535,2433,2865,17518
62912,1127,1176,1210,1119,1198,1010,1179,8019
62914,2900,3079,2969,3013,3008,3067,3147,21183
62915,432,320,362,312,392,381,321,2520
62916,1002,1003,869,743,878,895,995,6385
62917,2581,2685,2481,2391,2315,2273,2305,17031
62918,10175,10103,9787,9731,9589,9029,9793,68207
62919,1162,1117,1021,931,861,884,1003,6979
62920,3477,3410,3490,3558,3643,3532,3265,24375
62921,302,461,550,510,486,522,375,3206
62922,2505,2815,3241,3192,3415,3188,3119,21475
62923,433,460,510,590,671,720,518,3902
62924,2920,2933,2735,2788,2880,2817,2809,19882
62926,2571,2527,2230,2130,2104,2347,2263,16172
62927,289,278,242,285,235,234,367,1930
62928,141,182,189,257,288,189,293,1539
62930,6236,6196,6205,6153,6204,6347,6263,43604
62931,1527,1546,1404,1610,1712,1507,1571,10877
62932,1849,1901,1843,1667,1618,1617,1592,12087
62933,1329,1329,1112,1085,972,930,1230,7987
62934,955,838,998,983,965,964,927,6630
62935,1698,1626,1552,1757,2009,1804,1943,12389
62938,3002,2743,2997,2985,2793,3024,3033,20577
62939,3324,3402,3219,3176,3036,2921,3119,22197
62940,323,362,392,391,510,530,445,2953
62941,813,781,759,729,753,865,808,5508
62942,538,552,492,556,675,654,707,4174
62943,403,498,676,668,703,1001,715,4664
62946,12955,13232,13336,13336,13224,13318,12930,92331
62947,473,536,525,579,583,506,539,3741
62948,13093,13110,12978,12888,12771,12928,12865,90633
62949,689,762,802,760,806,789,810,5418
62950,204,292,246,226,264,267,193,1692
62951,5280,5133,5526,5747,5375,5393,5352,37806
62952,3160,3273,3231,3205,3220,3410,3372,22871
62953,325,342,319,299,311,378,360,2334
62954,346,429,417,571,645,563,515,3486
62956,931,991,903,902,951,852,869,6399
62957,1140,1075,1085,1044,1229,1156,996,7725
62958,2178,2102,2075,2037,2032,2086,2262,14772
62959,28257,28026,27400,27205,26628,26757,26948,191221
62960,11596,11712,11732,11841,11937,11841,11603,82262
62961,39,36,48,70,80,113,65,451
62962,76,78,87,83,84,20,82,510
62963,624,634,603,715,791,787,611,4765
62964,1431,1513,1561,1553,1339,1250,1456,10103
62965,79,77,90,74,112,142,125,699
62966,15061,15072,15751,15876,15527,15483,15607,108377
62967,272,312,293,312,269,440,326,2224
62969,456,543,596,667,689,695,731,4377
62970,694,675,867,708,732,711,639,5026
62972,922,1001,1023,1151,1022,1059,1205,7383
62974,1626,1422,1545,1364,1463,1521,1401,10342
62975,344,342,373,209,161,211,279,1919
62976,402,422,396,436,441,478,469,3044
62977,560,577,595,552,577,587,700,4148
62979,1164,1202,1146,1171,1311,1319,1230,8543
62982,934,1100,1352,1363,1365,1650,1328,9092
62983,1403,1414,1285,1365,1365,1262,1504,9598
62984,1869,1931,1917,1869,1753,1817,1841,12997
62985,836,923,1233,1304,1404,1353,845,7898
62987,1326,1173,1085,887,887,1023,1174,7555
62988,1617,1734,1988,2130,2143,2280,2110,14002
62990,849,855,1079,1023,966,1070,1109,6951
62992,714,713,735,835,996,999,1032,6024
62994,511,616,597,612,733,690,755,4514
62995,5775,5663,5148,5130,5210,5127,5284,37337
62996,397,407,427,508,413,421,535,3108
62997,506,416,422,475,503,558,599,3479
62998,365,313,342,369,371,378,419,2557
62999,1752,1827,1870,1915,1922,1987,1829,13102
63005,17570,17602,17761,17700,17741,18018,17753,124145
63010,36171,36347,36306,36472,36304,35746,35439,252785
63011,38305,37760,37338,36799,37114,36823,36347,260486
63012,10626,10397,10654,10762,10334,10545,9973,73291
63013,1707,1789,1563,1689,1697,1685,1589,11719
63014,616,580,500,467,483,495,779,3920
63015,2122,2044,2249,2045,1883,2198,2076,14617
63016,7169,7800,7600,7630,8088,8050,7582,53919
63017,41596,41701,41655,41732,41402,41384,41470,290940
63019,4521,4495,4468,4474,4512,4463,4449,31382
63020,20647,19897,20018,20437,20781,20592,20714,143086
63021,56477,56456,56552,56217,56102,54398,56261,392463
63023,6064,6066,5662,5336,4925,5412,5831,39296
63025,14054,13912,13148,13267,13184,12552,13854,93971
63026,44122,44544,44121,44349,43886,44207,44124,309353
63028,26272,26690,26720,26982,26152,25426,26413,184655
63030,222,368,340,315,333,361,407,2346
63031,48591,48889,49324,49650,48529,48478,48212,341673
63033,42434,42635,41408,41434,41502,42788,43000,295201
63034,17840,17848,18087,17976,18035,18340,17761,125887
63036,1054,978,854,841,680,562,1064,6033
63037,3095,3171,3034,3032,3093,3084,3241,21750
63038,6943,6815,6680,6631,6797,6817,6914,47597
63039,785,823,1144,1297,1378,1240,726,7393
63040,8063,8115,8396,8901,8795,8570,8512,59352
63041,698,514,482,409,363,244,534,3244
63042,20409,20462,20119,19895,19924,19144,19602,139555
63043,22317,22317,22400,22286,22311,22386,22367,156384
63044,10579,10633,10531,10634,10645,10846,10568,74436
63045,0,0,0,0,0,0,3,3
63047,64,0,0,0,0,0,31,95
63048,3781,3652,3562,3469,3397,3324,3357,24542
63049,16693,16425,16188,15879,16098,15839,15896,113018
63050,16340,15873,15507,15152,14604,15085,15716,108277
63051,14466,14288,14437,14450,14345,13979,14495,100460
63052,26051,25526,25836,25362,25501,25842,26431,180549
63053,66,67,90,94,89,69,62,537
63055,2610,2595,2274,2188,2329,2383,2449,16828
63056,2010,1824,1987,2136,1914,2112,2002,13985
63057,64,63,61,61,61,60,56,426
63060,2891,2715,2786,2723,2518,1992,2461,18086
63061,102,136,217,223,191,181,95,1145
63068,5375,5166,5257,5228,5074,4983,4909,35992
63069,15474,15452,15173,14883,14815,15264,15647,106708
63070,7731,7771,7848,7762,7850,7934,7438,54334
63071,1259,1331,1388,1407,1284,1233,1103,9005
63072,2909,2782,2762,3187,3360,3126,3194,21320
63073,1012,965,891,574,331,170,301,4244
63074,15189,15184,15212,15202,15420,15418,15164,106789
63077,11085,11366,11402,11154,11280,11773,11798,79858
63079,0,10,9,9,34,32,58,152
63080,13143,13410,13145,14333,15015,14911,13987,97944
63084,18245,17887,18195,17990,17919,17073,17414,124723
63087,825,865,970,976,1044,974,769,6423
63088,8394,8484,8380,8427,8058,8351,8269,58363
63089,5459,5582,5500,5409,5387,5536,5965,38838
63090,21713,22066,21788,21743,21833,22291,21524,152958
63091,1249,1201,1154,1105,1315,1339,1264,8627
63101,3303,3051,2689,2613,1989,1644,2620,17909
63102,2314,2273,2291,2216,2154,1693,2316,15257
63103,7265,7359,6921,6824,6242,5349,6900,46860
63104,20320,19533,19283,19520,19454,18680,18656,135446
63105,17599,17563,17539,17361,17380,17131,17667,122240
63106,11989,11998,11990,11736,11546,10823,11883,81965
63107,10437,9949,11725,12127,12349,12886,11912,81385
63108,21345,20916,20760,21277,21175,20862,21568,147903
63109,27072,27507,27391,27658,27255,27484,26946,191313
63110,17423,17164,16803,16635,16217,16272,17107,117621
63111,21380,22327,21294,20891,21363,20880,20313,148448
63112,19982,20007,20185,20110,20024,19483,20368,140159
63113,11270,12113,11881,12239,13045,12767,13167,86482
63114,35530,36061,35589,36307,36400,36667,36201,252755
63115,18446,19463,20510,21059,22192,23005,20775,145450
63116,44175,44433,44612,44010,43884,44107,43540,308761
63117,9097,9113,9035,9221,9331,9243,9163,64203
63118,28810,28113,28728,27350,26862,28506,26704,195073
63119,33894,33847,33897,33929,33856,33951,33969,237343
63120,9158,9385,9202,9022,8890,9111,10296,65064
63121,25276,25639,26278,26316,26736,26778,26602,183625
63122,38857,38799,38871,38585,38582,38226,38495,270415
63123,50739,49924,49581,49390,48869,48538,49308,346349
63124,10720,10841,10615,10594,10418,10358,10417,73963
63125,33089,33211,32900,32219,32685,31458,32201,227763
63126,14959,14969,14929,14920,14907,15080,15112,104876
63127,4852,4678,4893,4784,4610,4795,4939,33551
63128,29784,29716,29697,29973,29082,29138,29356,206746
63129,54634,54075,53540,52733,52927,52970,52718,373597
63130,29488,29221,30773,30810,30832,30731,30084,211939
63131,17631,17446,17741,17410,17281,17000,16769,121278
63132,13861,14407,13997,13816,13817,14309,13988,98195
63133,7507,7952,7971,8210,8616,8630,8161,57047
63134,13801,13759,13894,13927,14173,14330,13638,97522
63135,21512,22081,21986,21940,21943,21773,21334,152569
63136,44982,45444,46686,47220,47430,47984,48560,328306
63137,20460,20250,19966,20546,20604,20804,20654,143284
63138,19944,20055,20492,20863,21118,21663,20175,144310
63139,22072,22240,22081,22212,22384,22206,22789,155984
63140,308,265,232,252,426,573,294,2350
63141,19920,20070,19900,19915,20326,20263,20593,140987
63143,9399,9677,9772,9996,9668,10070,9678,68260
63144,8796,8792,8821,8850,8869,8848,8825,61801
63146,29770,30352,30325,30127,30027,29908,29262,209771
63147,10164,10239,10137,10534,10994,11550,11373,74991
63155,0,0,0,0,0,0,0,0
63301,49850,49481,49679,49549,49478,49461,48514,346012
63303,47660,47227,46731,46318,45781,45851,45834,325402
63304,41278,40601,39863,40094,39986,40341,40336,282499
63330,175,163,157,141,123,114,125,998
63332,1463,1355,1361,1306,1233,1146,1292,9156
63333,617,681,672,830,825,840,783,5248
63334,9167,8865,9549,9422,9480,9376,8569,64428
63336,1172,1209,946,957,1012,955,1146,7397
63339,1138,1266,1162,1028,984,1022,1145,7745
63341,3390,3534,3521,3704,3712,3448,3530,24839
63343,4490,4248,4149,4394,4424,4552,4546,30803
63344,1400,1592,1613,1903,1606,1610,1663,11387
63345,456,469,541,528,491,420,393,3298
63347,3152,3076,3323,3011,2969,3334,3078,21943
63348,6646,6600,6649,6224,6471,6448,6059,45097
63349,1847,1952,1770,1647,1523,1772,1934,12445
63350,654,722,758,769,855,568,562,4888
63351,1557,1608,1710,1613,1852,1947,1768,12055
63352,1087,1102,1058,1008,943,1107,1078,7383
63353,4296,4353,4487,4543,4733,4735,4593,31740
63357,5530,4945,5009,5291,4574,4842,5534,35725
63359,1113,1102,1093,1138,1281,1340,1296,8363
63361,4374,4469,4503,4508,4484,4297,4525,31160
63362,7256,7018,6652,6346,5893,5880,6350,45395
63363,1756,1796,1667,1844,1712,1758,1719,12252
63366,48371,48162,48249,47697,47464,45701,46175,331819
63367,22149,21166,21186,20532,20018,19510,19433,143994
63368,45967,45682,43855,42886,42201,40759,43360,304710
63369,1665,2020,1909,2006,2284,2504,2258,14646
63370,17,9,14,17,17,5,33,112
63373,538,581,456,577,530,584,603,3869
63376,73691,72711,72474,71988,71241,71040,70828,503973
63377,2759,2756,2685,2766,2472,2388,2462,18288
63379,24571,23958,23929,23383,23911,23172,23348,166272
63381,520,432,445,448,434,478,532,3289
63382,4939,4932,5118,4926,5026,5153,4897,34991
63383,15524,15709,15746,15126,15783,15815,15770,109473
63384,1808,1752,1735,1858,1899,2002,1955,13009
63385,39897,38737,36777,35253,33903,33364,35750,253681
63386,468,562,601,610,648,642,538,4069
63387,54,48,68,74,82,80,73,479
63388,636,784,1003,851,820,813,710,5617
63389,6598,6351,6660,7051,6945,6469,6336,46410
63390,10787,11324,10714,10736,9905,9158,9760,72384
63401,22248,22221,21815,21795,21229,21345,22067,152720
63430,478,513,494,501,555,599,639,3779
63431,279,195,182,117,108,130,334,1345
63432,454,393,409,451,483,608,513,3311
63433,61,68,55,31,17,14,68,314
63434,736,787,884,732,662,542,687,5030
63435,4557,4463,4529,4506,4734,4753,4219,31761
63436,1149,1121,1170,1074,991,1183,1155,7843
63437,1554,1527,1467,1356,1419,1706,1503,10532
63438,449,524,687,721,772,685,466,4304
63439,86,68,42,44,39,54,127,460
63440,1077,1104,1239,1451,1392,1309,1407,8979
63441,1216,1279,1051,1122,998,889,1121,7676
63443,491,517,546,460,464,429,440,3347
63445,3560,3605,3561,3675,3678,3677,3911,25667
63446,644,765,732,704,746,738,691,5020
63447,1302,1226,1137,1192,1143,1074,1133,8207
63448,1510,1611,1659,1595,1463,1491,1520,10849
63450,28,65,108,132,142,137,132,744
63451,148,206,274,335,291,323,244,1821
63452,1081,1114,1058,1043,1091,1046,1167,7600
63453,573,486,572,613,537,526,519,3826
63454,886,906,697,809,1032,1013,946,6289
63456,4262,4345,3990,3839,3985,3742,4271,28434
63457,340,392,337,255,298,263,337,2222
63458,176,202,229,205,199,195,197,1403
63459,4099,4309,4446,4583,4651,4537,4153,30778
63460,416,354,370,331,405,338,328,2542
63461,5875,5847,6022,5685,5752,5555,5876,40612
63462,1442,1256,1376,1528,1650,1711,1458,10421
63463,763,704,745,728,645,745,652,4982
63464,6,15,40,43,65,64,21,254
63465,438,495,526,491,468,418,407,3243
63467,16,19,17,31,70,58,75,286
63468,2300,2199,2103,2310,2327,2399,2644,16282
63469,1163,1167,1233,1280,1364,1346,1194,8747
63471,615,576,662,577,680,742,639,4491
63472,606,585,592,564,440,527,587,3901
63473,317,265,303,372,312,431,262,2262
63474,440,416,491,435,539,479,479,3279
63501,21552,21560,21509,21559,21293,21391,21532,150396
63530,1169,1150,940,871,897,930,868,6825
63531,341,402,363,453,381,356,532,2828
63532,1326,1265,1140,1131,1187,1281,1322,8652
63533,749,776,745,841,960,987,805,5863
63534,744,906,872,823,818,867,804,5834
63535,93,145,118,176,208,212,114,1066
63536,890,834,713,719,766,645,851,5418
63537,1880,1767,1672,1782,1812,1969,1916,12798
63538,341,277,292,310,325,310,283,2138
63539,201,215,217,201,181,246,206,1467
63540,121,203,271,307,326,267,150,1645
63541,263,272,316,325,343,310,409,2238
63543,397,375,392,386,418,430,352,2750
63544,867,908,975,1011,994,1019,818,6592
63545,1124,1114,1144,1053,1160,1184,1111,7890
63546,1711,1488,1455,1154,1213,1300,1715,10036
63547,439,556,696,667,619,606,459,4042
63548,1318,1348,1240,1247,1185,1163,1287,8788
63549,2428,2512,2450,2642,2763,2733,2742,18270
63551,233,246,251,255,305,313,338,1941
63552,7836,7750,7982,7932,7929,7718,7926,55073
63555,3221,3287,3333,3261,3128,3037,3201,22468
63556,3596,3586,3662,3716,3583,3530,3779,25452
63557,231,261,252,240,240,260,291,1775
63558,746,732,780,758,675,796,742,5229
63559,1390,1411,1635,1515,1523,1338,1420,10232
63560,145,247,209,293,244,262,239,1639
63561,1174,1197,1365,1462,1531,1601,1206,9536
63563,775,662,588,591,645,606,575,4442
63565,3647,3737,3934,3980,4005,3783,3805,26891
63566,160,143,135,118,152,130,125,963
63567,254,141,169,237,276,328,192,1597
63601,15858,15614,16167,16707,16391,16190,16656,113583
63620,1393,1393,1323,1418,1468,1479,1619,10093
63621,1389,1444,1387,1437,1437,1233,1228,9555
63622,994,721,842,726,835,781,1011,5910
63623,779,796,807,841,795,804,882,5704
63624,4247,4011,3779,3579,3457,3439,3757,26269
63625,376,400,435,394,441,465,457,2968
63626,1584,1505,1318,1085,934,1134,1037,8597
63627,2933,2604,2361,2612,2776,2743,2937,18966
63628,16026,16119,16333,16088,16944,17484,16014,115008
63629,1458,1417,1420,1541,1503,1248,1314,9901
63630,3736,3666,3976,4226,4362,4564,4062,28592
63631,1097,1151,1241,1120,1178,1302,849,7938
63633,723,714,756,914,1066,1011,645,5829
63636,688,567,632,599,563,467,608,4124
63637,1436,1448,1241,1108,1053,1074,1329,8689
63638,2607,2726,2755,2601,2595,2799,2920,19003
63640,27873,28156,27219,26933,26864,26238,26335,189618
63645,11518,11634,11388,11341,11335,11186,11420,79822
63648,1531,1795,1556,1623,1711,1585,1628,11429
63650,3635,4011,4397,4447,4406,4931,4401,30228
63653,1268,1442,1461,1471,1197,1076,1206,9121
63654,525,646,553,562,616,678,706,4286
63655,1730,1462,1535,1480,1763,1727,1523,11220
63656,408,403,328,326,344,346,531,2686
63660,4207,3901,4194,4023,4017,4228,4276,28846
63662,1267,1325,1264,1313,1451,1435,1185,9240
63663,714,648,658,661,709,566,723,4679
63664,8475,8544,8043,8234,8230,7622,8920,58068
63665,239,214,259,278,254,250,241,1735
63666,200,172,214,178,127,105,93,1089
63670,11079,10910,11366,11034,10854,11077,11295,77615
63673,2030,2139,2078,2014,2105,2384,2115,14865
63674,145,213,199,150,203,172,132,1214
63675,196,199,213,200,265,206,144,1423
63701,38941,38050,36782,36346,34967,34976,36812,256874
63703,8079,8653,9068,8853,9411,9407,8182,61653
63730,3265,3390,3652,3968,3793,3806,3430,25304
63732,918,817,858,688,718,871,834,5704
63735,849,828,819,801,773,769,847,5686
63736,3356,3293,3209,3341,3335,3406,3310,23250
63738,50,46,43,15,34,15,76,279
63739,280,294,335,469,533,531,464,2906
63740,4862,4940,5056,5504,5645,5710,5339,37056
63742,57,39,40,54,55,78,64,387
63743,82,57,62,79,114,139,122,655
63744,108,111,147,136,124,150,111,887
63745,22,31,37,38,36,62,66,292
63746,42,38,29,30,4,5,65,213
63747,506,535,557,517,560,454,469,3598
63748,1025,1115,1194,1162,1014,1061,1015,7586
63750,0,0,0,5,12,24,43,84
63751,1208,1303,1202,1185,1103,903,1249,8153
63755,25319,24920,25175,24358,24504,23886,24006,172168
63758,163,186,168,153,111,90,170,1041
63760,640,672,705,831,843,736,614,5041
63763,127,228,289,244,261,297,223,1669
63764,5685,5647,5688,5538,5244,5810,5984,39596
63766,1171,1332,1367,1503,1058,919,1288,8638
63767,758,782,737,756,608,642,655,4938
63769,1486,1487,1298,1572,1597,1513,1389,10342
63770,161,122,127,121,135,110,192,968
63771,2758,2575,2656,2576,2695,2873,2862,18995
63774,110,152,116,127,71,74,76,726
63775,16703,16548,16314,16429,16553,16282,16710,115539
63780,6742,6681,6729,6623,6690,6584,6740,46789
63781,1230,1182,1080,1150,1130,1064,1272,8108
63782,247,290,335,312,356,321,274,2135
63783,145,164,133,216,192,279,132,1261
63784,166,133,206,335,299,318,279,1736
63785,892,1013,986,1108,1071,1126,1000,7196
63787,788,723,789,806,1019,1028,719,5872
63801,23293,23547,23763,23415,23370,23048,23123,163559
63820,140,277,282,328,383,476,226,2112
63821,865,954,1052,974,1097,999,970,6911
63822,2910,2929,2978,3249,3136,3049,2867,21118
63823,1135,1264,1298,1274,1296,1292,1247,8806
63824,163,212,167,174,231,234,164,1345
63825,4247,4098,4197,4129,4364,4320,4409,29764
63826,44,36,36,41,30,16,84,287
63827,900,834,864,913,905,982,829,6227
63828,260,278,339,289,257,196,345,1964
63829,1124,1114,1000,1117,1168,1278,1120,7921
63830,7175,7187,7065,7122,7044,7080,7102,49775
63833,212,228,235,282,278,209,242,1686
63834,6989,6909,6962,6801,6766,6797,7135,48359
63837,1624,1686,1645,1533,1514,1432,1653,11087
63839,362,451,469,464,486,527,485,3244
63841,13375,13482,13202,13003,12868,12844,13123,91897
63845,5730,5636,5640,5775,5671,5518,5814,39784
63846,1689,1670,1607,1623,1591,1792,1554,11526
63847,230,201,72,37,35,37,64,676
63848,1438,1525,1449,1318,1461,1588,1592,10371
63849,128,85,232,241,267,222,186,1361
63851,3868,3880,4049,4163,4011,4089,4225,28285
63852,1160,1274,1310,1402,1386,1564,1488,9584
63853,239,223,235,266,308,233,244,1748
63855,1336,1234,1147,1261,1283,1240,1117,8618
63857,12749,12821,12958,12999,13000,12974,12956,90457
63860,201,149,232,167,116,167,131,1163
63862,1540,1562,1525,1512,1492,1631,1705,10967
63863,6299,6155,6144,6123,6208,6258,6359,43546
63866,318,410,522,476,502,566,488,3282
63867,1089,1220,1253,1257,1416,1435,1019,8689
63868,759,678,649,753,776,734,838,5187
63869,3576,3546,3584,3789,3795,3883,3783,25956
63870,950,1081,1016,1099,1012,1023,1097,7278
63873,5030,4903,4806,4841,5149,4970,4947,34646
63874,402,362,320,389,293,301,350,2417
63876,2325,2343,2378,2314,2121,2212,2374,16067
63877,3881,3877,3999,3779,4046,3930,3931,27443
63878,129,185,203,139,128,128,138,1050
63879,649,740,728,774,676,724,773,5064
63880,30,15,46,92,89,71,117,460
63882,457,498,529,462,480,497,431,3354
63901,35437,34642,34127,34486,34429,34757,34665,242543
63902,0,0,0,0,0,0,0,0
63932,1380,1456,1581,1341,1197,1281,1254,9490
63933,3531,3773,3846,3890,3825,3843,3719,26427
63934,115,116,97,103,94,188,201,914
63935,9943,9734,10036,9863,10064,9825,10158,69623
63936,886,811,724,734,831,623,754,5363
63937,2865,3026,2793,2883,3084,2728,2922,20301
63939,1378,1285,1419,1434,1521,1713,1430,10180
63940,1294,1269,1302,1473,1429,1574,1393,9734
63941,240,242,366,434,548,472,371,2673
63942,687,751,768,800,777,733,652,5168
63943,584,807,742,1032,1038,1380,915,6498
63944,1748,1704,1776,1772,1827,1968,1844,12639
63945,992,1358,1241,1234,1245,1035,1163,8268
63951,171,139,231,219,384,424,331,1899
63952,465,531,468,415,383,446,408,3116
63953,1864,2072,2276,1968,1594,1600,1635,13009
63954,952,1106,1077,1071,1081,1185,1219,7691
63955,125,161,159,140,200,221,288,1294
63956,1127,1250,966,1064,959,1057,1133,7556
63957,5831,5787,6003,6042,5985,5665,5440,40753
63960,3071,3232,3352,3142,3153,3380,3326,22656
63961,1680,1693,1875,2086,1910,1674,1610,12528
63962,0,0,0,0,0,0,41,41
63964,800,756,779,644,613,695,784,5071
63965,3223,3055,3130,2771,2534,2350,2697,19760
63966,2476,2511,2294,2068,2159,1889,2601,15998
63967,1743,1694,1754,1800,1717,1528,1906,12142
64001,635,630,574,625,623,681,656,4424
64011,3374,3858,3722,3297,3167,3381,3106,23905
64012,27183,27270,27270,27338,27259,27245,27260,190825
64014,24788,25553,25481,25640,25991,25528,24797,177778
64015,31385,30949,30539,30828,30151,30297,31217,215366
64016,4603,4497,4596,4775,4995,4958,4713,33137
64017,503,498,429,427,395,366,464,3082
64018,1080,872,890,823,932,892,890,6379
64019,2606,2625,2247,1732,1861,1925,2368,15364
64020,3534,3374,3428,3324,3663,3561,3608,24492
64021,759,663,592,625,471,598,633,4341
64022,216,203,163,126,158,155,183,1204
64024,17189,17218,17224,16628,16715,16453,16230,117657
64029,17417,17560,17431,16745,16210,15829,16574,117766
64030,25102,24970,24836,24673,24463,24437,24422,172903
64034,8048,7927,7976,8191,8190,7887,7612,55831
64035,1086,966,971,1031,1013,973,971,7011
64036,331,330,336,355,363,421,389,2525
64037,6104,6079,6169,6347,6419,6244,6150,43512
64040,6534,6452,6416,5954,6313,6233,6574,44476
64048,4022,3874,4319,4111,4480,4607,4140,29553
64050,22281,22264,21663,21395,21631,21762,22178,153174
64052,20705,20353,21492,21723,20945,19853,20911,145982
64053,5146,5073,4588,4798,5256,5485,5319,35665
64054,4036,3664,3642,3684,3841,3435,3731,26033
64055,33472,33367,33582,33281,33467,34089,33858,235116
64056,17220,17344,17287,16538,16756,17249,16576,118970
64057,14024,14745,14457,14593,13680,13703,14141,99343
64058,7064,7164,7203,6898,7079,6485,6659,48552
64060,13984,13700,13515,13615,13017,12996,13042,93869
64061,3204,3133,3409,3709,3516,3655,3387,24013
64062,5704,5847,5472,5441,5713,5768,6121,40066
64063,19915,20371,20421,20254,20467,20182,20374,141984
64064,17132,16540,16581,16774,16457,16398,16223,116105
64065,39,48,53,72,94,102,27,435
64066,30,33,34,18,19,19,38,191
64067,5287,5338,5388,5627,5707,5737,5789,38873
64068,37749,37595,37005,36798,36474,36081,36280,257982
64070,3509,3429,3175,3118,3347,3046,3309,22933
64071,773,994,1048,1168,904,870,828,6585
64072,418,286,232,220,227,228,239,1850
64074,697,714,890,820,779,721,638,5259
64075,12150,12088,11654,11888,11611,11480,11810,82681
64076,8999,8872,8991,9259,9368,9506,9512,64507
64077,1675,1627,1603,1742,1791,1797,1940,12175
64078,9640,10040,9755,9375,9669,9233,8902,66614
64079,14049,13444,13141,12664,12569,11941,12485,90293
64080,12874,12474,12543,12351,12070,12511,12866,87689
64081,24631,24256,24072,23549,22728,22641,23144,165021
64082,15535,15437,14877,14634,14208,13472,14456,102619
64083,21790,21433,21310,20563,20375,20064,20995,146530
64084,1375,1389,1623,1695,1812,1821,1556,11271
64085,8456,8563,8833,8938,8694,8842,8803,61129
64086,22387,21751,21732,21430,21121,20666,21925,151012
64088,1460,1269,1221,1196,1226,1104,1378,8854
64089,12325,12134,11529,11194,10866,10622,11470,80140
64090,94,89,75,69,64,75,116,582
64092,0,0,0,106,64,87,44,301
64093,27951,27839,28074,28045,27401,26934,27608,193852
64096,1118,1049,1169,1204,1187,1111,1171,8009
64097,1416,1340,1314,1362,1482,1479,1410,9803
64098,2936,2811,2763,2858,2843,2908,2892,20011
64101,309,182,232,291,339,352,339,2044
64102,0,0,0,0,0,0,0,0
64105,4130,4123,3898,3712,3698,3373,3505,26439
64106,9092,8498,8348,8125,7712,7368,7701,56844
64108,7428,7410,8010,8535,8348,7865,7584,55180
64109,9243,8875,8728,8764,9279,8936,9931,63756
64110,16179,15737,15637,15063,14896,15423,15318,108253
64111,17507,17462,16403,16083,15848,15691,16318,115312
64112,8641,8631,8418,8308,7949,7850,8147,57944
64113,12084,12251,11754,11718,11719,11724,11328,82578
64114,25410,25076,25091,24720,24451,23830,23158,171736
64116,15378,14573,14911,14938,14445,14662,15318,104225
64117,15017,14839,14148,14015,13609,12723,14017,98368
64118,41451,41198,40857,41146,41760,41416,40191,288019
64119,26678,26997,27420,27232,27683,27696,27341,191047
64120,278,256,306,346,373,371,369,2299
64123,8048,8747,9273,9511,10082,10938,10387,66986
64124,9862,9321,10373,11340,11267,12270,12639,77072
64125,1303,1570,1864,1665,1678,1734,1953,11767
64126,6253,6289,5795,6011,5985,6377,6514,43224
64127,14980,14793,14871,15419,16343,16654,17332,110392
64128,12027,12370,12391,12339,12014,12139,11613,84893
64129,8920,9137,9192,9100,9178,9471,9486,64484
64130,20590,20590,20463,21000,21250,21446,20492,145831
64131,22104,22663,22182,22850,22559,22112,21465,155935
64132,14304,14216,13989,13621,13228,12818,13810,95986
64133,34053,34712,34981,33567,34953,34259,33780,240305
64134,23771,22789,22692,22292,21832,22047,21973,157396
64136,2282,2498,2104,2148,2156,1980,2153,15321
64137,11298,12073,12387,12148,11737,11802,10554,81999
64138,27028,25793,25084,25090,24727,25520,25294,178536
64139,1850,1570,1793,1854,1816,1729,1762,12374
64145,4960,5046,5139,4915,5154,5097,5389,35700
64146,1426,1261,1511,1689,1467,1642,1376,10372
64147,639,678,773,817,751,628,769,5055
64149,228,306,347,193,277,367,343,2061
64150,3248,3192,3177,3131,3083,3017,3048,21896
64151,25919,25739,24902,24580,24023,24158,24134,173455
64152,27619,27454,27169,26430,26126,25868,26024,186690
64153,5371,4912,5233,5168,5045,4894,5358,35981
64154,10137,9866,9769,9811,9606,9207,9257,67653
64155,22853,22621,22713,22581,22080,22100,21901,156849
64156,6987,6509,5943,5400,4907,4547,5404,39697
64157,19169,18548,17857,17030,15807,15073,16122,119606
64158,5067,5310,5167,5082,5074,4811,5161,35672
64161,312,325,326,328,361,347,388,2387
64163,623,617,655,785,636,663,689,4668
64164,261,328,348,341,327,328,302,2235
64165,114,63,83,55,19,28,112,474
64166,245,258,321,252,358,348,278,2060
64167,377,447,269,280,410,344,353,2480
64192,0,0,0,0,0,0,15,15
64401,1743,1723,1546,1463,1256,1232,1417,10380
64402,2746,2674,2622,2594,2636,2465,2388,18125
64420,70,44,94,99,95,77,53,532
64421,774,661,665,607,659,655,952,4973
64422,312,222,251,228,199,210,337,1759
64423,808,854,840,767,832,746,761,5608
64424,4567,4494,4322,4353,4309,4410,4585,31040
64426,308,305,313,360,337,408,356,2387
64427,639,743,723,672,657,633,606,4673
64428,780,769,842,867,908,929,898,5993
64429,13145,13229,13565,13218,13444,13493,13158,93252
64430,724,647,675,659,669,728,764,4866
64431,347,364,398,446,443,428,382,2808
64432,172,173,161,150,149,159,141,1105
64433,249,262,231,246,239,234,210,1671
64434,410,487,542,482,440,453,518,3332
64436,814,746,869,779,748,883,781,5620
64437,576,543,572,669,789,875,792,4816
64438,219,204,268,353,349,338,270,2001
64439,1677,1701,1717,1618,1695,1892,1642,11942
64440,745,676,618,610,887,867,737,5140
64441,163,162,136,106,136,158,178,1039
64442,800,783,752,739,777,806,882,5539
64443,1141,1074,1228,1301,1443,1283,1096,8566
64444,1352,1495,1675,1682,1509,1491,1340,10544
64445,365,334,330,312,258,268,312,2179
64446,1046,1001,1023,939,980,1047,1117,7153
64448,897,920,986,1088,1161,1148,1104,7304
64449,522,474,502,493,450,466,451,3358
64451,386,463,464,460,488,526,446,3233
64453,158,146,164,160,187,218,217,1250
64454,2396,2432,2581,2664,2693,2766,2667,18199
64455,368,359,345,315,336,426,368,2517
64456,1423,1393,1375,1303,1317,1382,1459,9652
64457,210,203,218,187,252,300,329,1699
64458,120,136,135,173,204,177,145,1090
64459,473,461,424,380,370,438,472,3018
64461,654,775,787,767,814,812,897,5506
64463,1546,1658,1658,1597,1631,1702,1643,11435
64465,4744,4713,4417,4255,4189,4192,4251,30761
64466,463,436,497,524,499,477,541,3437
64467,189,133,222,171,169,171,186,1241
64468,15921,15998,16017,16028,15915,15689,16023,111591
64469,2231,2285,2249,2295,2369,2219,2339,15987
64470,1656,1719,1685,1629,1475,1545,1631,11340
64471,402,443,443,505,566,498,483,3340
64473,1439,1430,1453,1458,1540,1427,1457,10204
64474,815,879,858,920,900,792,820,5984
64475,376,331,261,287,316,302,468,2341
64476,358,373,370,377,403,352,379,2612
64477,3517,3552,3621,3671,3530,3541,3404,24836
64479,1069,960,1017,1270,1153,1175,906,7550
64480,258,347,351,325,339,346,307,2273
64481,1041,1120,1209,1187,1163,1206,1088,8014
64482,2146,2158,2152,2106,2071,2073,2101,14807
64483,765,728,670,653,587,570,709,4682
64484,1103,1011,1084,1009,1053,1109,1229,7598
64485,7996,8181,7853,8052,7951,7856,8124,56013
64486,550,601,490,599,586,492,455,3773
64487,737,779,879,856,862,953,757,5823
64489,2132,2100,2102,2056,1970,2090,2198,14648
64490,2189,2234,2186,2239,2236,2027,2056,15167
64491,1682,1704,1698,1861,1909,1901,1875,12630
64492,1754,1867,1848,1752,1637,1682,1782,12322
64493,454,455,404,511,462,502,460,3248
64494,890,849,902,858,986,960,1018,6463
64496,45,62,100,122,106,114,154,703
64497,405,454,337,442,515,564,598,3315
64498,432,421,444,416,413,410,375,2911
64499,58,77,98,99,94,105,119,650
64501,12414,11994,12023,12311,12554,12455,12503,86254
64503,12275,12959,12800,12902,12395,12688,12921,88940
64504,11190,11286,10998,10746,10964,10250,10763,76197
64505,13168,13029,13248,12890,13559,13226,13161,92281
64506,24574,24974,24573,23744,23377,23655,24030,168927
64507,13593,13374,14242,15282,14592,14499,13738,99320
64601,12047,11916,11774,12085,12093,12036,12438,84389
64620,501,484,515,556,522,484,466,3528
64622,524,426,554,621,704,646,600,4075
64623,420,520,496,486,506,578,609,3615
64624,1532,1461,1691,1728,1706,1761,1662,11541
64625,438,496,521,549,563,560,644,3771
64628,5767,5796,5722,5833,5883,5942,6144,41087
64630,480,480,504,455,449,545,602,3515
64631,820,875,936,851,867,866,902,6117
64632,486,512,498,553,596,586,629,3860
64633,5013,5175,5158,5224,5015,5003,5216,35804
64635,594,575,668,590,557,640,515,4139
64636,193,226,364,328,382,397,299,2189
64637,511,529,583,585,583,539,667,3997
64638,628,549,476,459,477,380,521,3490
64639,244,215,238,257,251,274,240,1719
64640,2956,3008,3126,3255,3144,3261,3140,21890
64641,661,612,665,644,625,675,666,4548
64642,990,1095,1113,1097,939,816,855,6905
64643,1301,1391,1385,1318,1471,1270,1072,9208
64644,3115,3205,3081,3150,3338,3420,3024,22333
64645,158,199,123,151,198,221,195,1245
64646,219,280,295,329,428,321,297,2169
64647,383,377,369,378,375,334,379,2595
64648,2336,2315,2352,2272,2097,2034,2129,15535
64649,394,496,585,665,685,643,864,4332
64650,763,690,715,759,643,580,727,4877
64651,769,742,655,645,672,645,570,4698
64652,481,514,478,542,470,417,441,3343
64653,703,679,695,668,735,758,687,4925
64654,44,57,55,50,56,77,52,391
64655,361,309,272,254,124,217,264,1801
64656,222,248,283,254,266,380,240,1893
64657,286,339,354,393,500,536,323,2731
64658,3152,3086,3086,3308,3368,3343,3277,22620
64659,955,949,983,1012,995,1012,964,6870
64660,546,540,577,537,524,455,513,3692
64661,1104,1064,1179,1068,1002,951,916,7284
64664,512,524,494,399,449,408,350,3136
64667,447,464,350,366,357,375,395,2754
64668,1476,1462,1366,1460,1382,1489,1416,10051
64670,1248,1195,1209,1003,987,1088,1090,7820
64671,2036,2066,2017,2159,2055,1934,2062,14329
64672,236,270,111,91,85,174,251,1218
64673,2289,2242,2284,2357,2343,2394,2492,16401
64674,448,431,426,445,427,434,428,3039
64676,295,344,377,302,296,273,215,2102
64679,682,678,635,662,744,947,805,5153
64681,178,208,252,240,167,153,192,1390
64682,363,271,277,247,292,390,378,2218
64683,8193,8182,8048,7935,7865,7787,8144,56154
64686,216,272,265,266,245,236,271,1771
64688,507,552,673,626,643,626,548,4175
64689,535,615,530,507,562,666,683,4098
64701,14248,14205,14254,14807,14661,14782,14385,101342
64720,3912,4047,4371,4342,4509,4293,3843,29317
64722,453,387,458,462,415,417,525,3117
64723,591,630,548,606,620,591,665,4251
64724,1926,2007,2082,1860,2048,1933,1859,13715
64725,2597,2491,2243,2095,2182,1996,2271,15875
64726,365,367,477,521,453,457,467,3107
64728,514,505,608,665,690,744,594,4320
64730,6580,6615,6798,7078,7051,7019,7109,48250
64733,1221,1284,1246,1225,1251,1380,1159,8766
64734,1890,1706,1658,1837,1952,2037,2004,13084
64735,13307,13473,13586,13794,13653,13707,13258,94778
64738,913,949,924,1092,1147,1118,1149,7292
64739,759,780,893,916,1039,988,997,6372
64740,1832,1794,1818,1625,1587,1507,1884,12047
64741,300,316,386,394,373,275,351,2395
64742,2323,2409,2321,2306,2346,2268,2193,16166
64743,191,239,267,267,323,314,292,1893
64744,7898,7781,7545,7263,7285,7148,7836,52756
64745,220,217,133,148,168,146,117,1149
64746,1501,1509,1565,1686,1515,1502,1428,10706
64747,3779,3735,3807,3959,3781,3681,3910,26652
64748,1167,1147,1246,1312,1464,1519,1493,9348
64750,449,366,350,355,384,405,423,2732
64752,746,773,694,686,692,702,735,5028
64755,2767,2617,2466,2317,2326,2416,2596,17505
64756,558,530,602,682,746,796,742,4656
64759,8456,8533,8574,8778,8525,8391,8244,59501
64761,1386,1478,1543,1523,1517,1561,1493,10501
64762,1607,1558,1495,1329,1404,1454,1604,10451
64763,1517,1514,1317,1449,1276,1363,1568,10004
64765,37,36,42,60,70,67,44,356
64767,665,541,460,380,408,448,821,3723
64769,498,532,502,559,652,641,611,3995
64770,1039,1019,980,985,995,993,1056,7067
64771,549,601,679,694,728,886,610,4747
64772,13636,13692,13854,13687,13660,13727,13596,95852
64776,3651,3716,3774,3707,3688,3742,3942,26220
64778,718,756,652,594,617,521,702,4560
64779,2734,2711,2566,2566,2575,2599,2693,18444
64780,473,579,613,793,819,1048,639,4964
64781,103,89,114,145,125,116,106,798
64783,852,755,738,617,753,657,775,5147
64784,1341,1606,1681,1814,1624,1696,1500,11262
64788,1619,1499,1385,1380,1471,1307,1415,10076
64790,938,825,852,847,821,814,861,5958
64801,36916,37152,36227,35191,34457,33894,34753,248590
64804,35641,35674,36507,36502,37947,38639,37521,258431
64830,563,717,799,710,715,692,639,4835
64831,6305,6185,6353,6411,6097,6168,5879,43398
64832,636,559,693,758,774,941,731,5092
64833,71,100,120,102,107,100,125,725
64834,9928,9944,9763,9784,9509,9103,9556,67587
64835,1813,1795,1806,1777,1773,1665,1899,12528
64836,23262,23481,23784,24239,23934,24295,23940,166935
64840,3044,3091,3165,3142,2999,2847,2813,21101
64841,497,441,285,304,317,355,384,2583
64842,770,716,685,942,899,1021,829,5862
64843,2709,2851,2991,3331,3474,3383,3259,21998
64844,4649,4636,4683,4634,4882,4925,4680,33089
64847,522,477,537,563,426,451,437,3413
64848,872,825,770,747,601,463,744,5022
64849,154,139,223,218,206,172,186,1298
64850,24254,23731,23702,23715,23757,23712,24063,166934
64854,3908,3871,4055,4081,4334,4192,4170,28611
64855,2795,2831,2847,3027,3071,2817,2795,20183
64856,4109,4009,3816,3498,4064,3726,4251,27473
64857,399,387,443,493,439,374,424,2959
64858,42,30,30,160,258,213,166,899
64859,1450,1068,1074,1127,1070,1258,1358,8405
64861,1666,2089,1807,1653,1226,1137,1179,10757
64862,2855,2783,2439,2690,2615,2795,3337,19514
64863,1618,1408,1499,1703,1736,1749,1828,11541
64865,6260,6103,5973,5643,5150,5181,5997,40307
64866,1768,1753,1659,1543,1346,1371,1484,10924
64867,1709,1659,1837,1846,1473,1573,1440,11537
64870,14635,14393,14353,14451,14443,14104,14325,100704
64873,1151,1162,968,895,598,783,1072,6629
64874,732,764,786,834,849,838,760,5563
65001,339,346,272,316,367,328,414,2382
65010,6553,6713,6270,6070,5907,5274,5704,42491
65011,2482,2407,2489,2380,2074,1860,2374,16066
65013,3004,3156,3130,3414,3013,3113,3515,22345
65014,1849,1981,2232,2414,2659,2837,2252,16224
65016,1492,1479,1538,1628,1737,1589,1376,10839
65017,992,1105,1447,1580,1648,1583,1549,9904
65018,7559,7511,7611,7562,7618,7567,7714,53142
65020,15497,15184,14599,14474,14155,14314,14286,102509
65023,1613,1443,1400,1450,1512,1492,1730,10640
65024,1226,1293,1223,1058,985,1021,1086,7892
65025,727,693,702,745,721,673,786,5047
65026,11626,11737,11070,10672,10928,11041,11551,78625
65032,2221,1989,2009,1998,1601,1632,1792,13242
65034,887,762,709,629,634,453,679,4753
65035,1998,2027,1923,1835,1827,1867,1826,13303
65037,4429,4547,4506,4864,4788,4880,4938,32952
65039,2448,2614,2577,2614,2562,2566,2328,17709
65040,1386,1528,1416,1463,1289,1264,1208,9554
65041,5650,5655,5509,5791,5718,5530,5725,39578
65043,10482,10230,9857,10151,9904,9384,9452,69460
65046,1167,1195,1233,1289,1337,1302,1194,8717
65047,852,929,1232,1386,1315,1362,1351,8427
65048,219,164,128,147,44,48,154,904
65049,6185,6110,6131,6166,6443,6400,6618,44053
65050,891,950,913,889,870,774,755,6042
65051,4908,4914,5152,5088,4835,4539,4874,34310
65052,3224,3555,3557,4048,4186,4280,3446,26296
65053,1490,1304,1585,1408,1278,1304,1425,9794
65054,815,797,746,691,651,680,835,5215
65058,913,930,1115,1103,1269,1225,1017,7572
65059,906,792,724,797,510,622,867,5218
65061,739,692,680,762,844,1052,746,5515
65062,40,0,23,25,21,47,49,205
65063,4299,3950,3870,3743,4227,3941,3412,27442
65064,367,374,333,379,404,461,578,2896
65065,6883,6631,6627,6645,6943,6741,6414,46884
65066,6522,6797,6755,6427,6551,6491,6703,46246
65067,354,454,393,471,416,538,379,3005
65068,959,932,852,888,743,764,827,5965
65069,838,772,803,809,715,709,645,5291
65072,1535,1550,1684,1695,1633,1408,1847,11352
65074,2791,2925,3039,3037,3276,3305,3061,21434
65075,992,1014,967,951,787,813,784,6308
65076,792,753,717,817,754,640,829,5302
65077,701,787,687,625,460,328,561,4149
65078,4031,3502,3536,3283,3432,3686,3743,25213
65079,3701,3888,4293,4575,4392,4505,4729,30083
65080,759,751,608,737,798,894,1015,5562
65081,4108,4148,3973,4048,3931,3962,3928,28098
65082,1084,1106,1190,1211,1074,1064,1127,7856
65083,470,343,347,220,225,225,375,2205
65084,7061,7421,7136,7388,7562,7589,6797,50954
65085,1220,1149,1214,1114,1124,1387,1240,8448
65101,30570,30558,30052,29610,29216,29095,30587,209688
65109,38811,39112,39157,39253,39251,39198,38090,272872
65201,43104,40967,40457,40024,40537,39938,39417,284444
65202,48577,49231,46997,46268,45136,44426,46547,327182
65203,56715,56026,56283,55284,54409,53668,53307,385692
65215,270,286,286,283,293,300,203,1921
65230,719,791,716,665,656,565,703,4815
65231,2896,2928,3108,3003,3073,3183,3334,21525
65232,269,286,249,219,197,226,249,1695
65233,11794,11673,11700,11728,11516,11566,11703,81680
65236,1551,1383,1389,1418,1581,1592,1404,10318
65237,772,802,769,829,830,931,907,5840
65239,1297,1351,1472,1237,1262,1272,1309,9200
65240,8389,7871,7725,7610,8046,7845,7590,55076
65243,2488,2753,3069,3176,2914,3224,2806,20430
65244,307,336,279,297,315,288,412,2234
65246,99,142,175,169,105,129,101,920
65247,565,723,899,857,836,852,616,5348
65248,4208,4080,4212,4451,4512,4556,4619,30638
65250,586,618,560,689,560,691,617,4321
65251,21229,21315,21833,21687,21990,22400,22437,152891
65254,1953,1950,1972,1884,2099,2256,1810,13924
65255,3958,3907,4026,3928,3435,3509,3731,26494
65256,1797,1961,1767,1635,1595,1494,1787,12036
65257,1736,1556,1431,1337,1240,1268,1564,10132
65258,413,427,388,492,484,467,500,3171
65259,2840,2565,2648,2773,2753,2564,2858,19001
65260,675,738,631,659,542,445,574,4264
65261,839,980,986,1022,958,1023,1094,6902
65262,916,1110,1104,844,763,837,955,6529
65263,2001,1875,1955,2015,2054,1952,1948,13800
65264,727,707,701,662,643,607,720,4767
65265,15320,15291,15252,15150,15139,14821,15409,106382
65270,17781,18069,17835,18027,18076,18282,17681,125751
65274,1950,2030,2084,1982,1855,1709,1710,13320
65275,2506,2570,2523,2577,2505,2736,2535,17952
65276,1652,1602,1637,1577,1852,1764,1609,11693
65278,140,139,96,111,124,178,123,911
65279,1659,1476,1431,1500,1487,1347,1766,10666
65280,207,157,226,317,276,280,243,1706
65281,2890,2978,3068,3046,3062,3010,3098,21152
65282,184,187,192,181,255,224,178,1401
65283,432,497,428,431,341,308,387,2824
65284,2029,2061,2255,2210,1909,2174,2361,14999
65285,730,850,896,898,843,798,695,5710
65286,98,103,98,121,89,71,129,709
65287,494,451,429,419,413,351,422,2979
65301,33929,34276,34093,34227,34147,33747,34267,238686
65305,4053,3872,3944,3832,3514,3386,2538,25139
65320,34,37,38,37,42,44,56,288
65321,565,472,483,497,442,436,417,3312
65322,566,663,607,585,602,656,587,4266
65323,921,847,827,921,886,960,976,6338
65324,1413,1402,1448,1575,1521,1811,1634,10804
65325,3405,3549,3616,3489,3472,3193,3171,23895
65326,2325,1983,1852,1778,1647,1792,1996,13373
65327,252,239,266,242,254,392,227,1872
65329,379,337,376,464,717,749,494,3516
65330,390,417,398,426,398,440,412,2881
65332,1438,1454,1559,1656,1890,2073,1652,11722
65333,698,669,710,661,608,663,759,4768
65334,1085,1008,920,894,956,969,935,6767
65335,165,165,149,108,134,105,196,1022
65336,5617,5846,5362,5707,5883,5750,5981,40146
65337,1905,1979,2155,2035,1986,1838,1899,13797
65338,2617,2655,2742,2827,3072,2924,3046,19883
65339,722,791,717,690,575,572,712,4779
65340,15777,15836,15819,15928,15833,15644,15937,110774
65344,245,304,308,317,366,386,332,2258
65345,630,691,713,748,424,463,387,4056
65347,746,790,857,842,856,796,681,5568
65348,1345,1639,1610,1499,1507,1411,1350,10361
65349,2503,2444,2540,2391,2536,2514,2441,17369
65350,1905,1736,1628,1629,1591,1737,1822,12048
65351,2396,2435,2452,2417,2372,2530,2525,17127
65354,672,673,655,531,482,572,628,4213
65355,10268,10398,10300,10380,10257,10863,10519,72985
65360,4898,4755,4691,4449,4619,4426,4752,32590
65401,32441,32566,32726,32051,32073,32430,32383,226670
65436,37,81,76,41,81,106,91,513
65438,2679,2896,2699,2620,2842,2686,2980,19402
65439,389,421,438,396,251,257,259,2411
65440,408,250,288,374,507,373,527,2727
65441,5147,5069,5627,5340,5126,5518,5194,37021
65443,53,34,74,105,114,60,96,536
65444,1316,1218,1169,934,859,834,1087,7417
65446,214,294,428,393,320,394,331,2374
65449,287,284,259,381,410,284,351,2256
65452,2866,2990,3096,3264,3361,3311,3315,22203
65453,9033,8767,8968,8494,8509,8065,8548,60384
65456,882,921,443,392,647,633,518,4436
65457,217,192,374,318,289,312,338,2040
65459,7665,7417,7650,7749,7323,7628,8233,53665
65461,107,113,86,99,98,88,105,696
65462,1633,1645,1472,1494,1555,1486,1593,10878
65463,986,1030,669,865,849,566,1011,5976
65464,1038,869,372,507,573,511,492,4362
65466,1636,1598,1447,1535,1834,1916,1634,11600
65468,188,345,284,498,427,370,102,2214
65470,1093,977,975,850,957,939,923,6714
65473,16800,17576,17061,16963,16383,16033,15059,115875
65479,193,287,282,415,249,389,441,2256
65483,4333,4598,4611,4862,4855,4862,4737,32858
65484,153,240,247,201,243,293,186,1563
65486,3430,3211,3551,3605,4004,4336,3423,25560
65501,184,201,222,222,204,153,163,1349
65529,170,185,271,213,282,289,232,1642
65534,1260,1800,1696,1570,1211,1362,1029,9928
65535,1852,1906,1723,1689,1762,1768,1673,12373
65536,29592,29459,29515,29673,29603,29443,28874,206159
65541,172,97,112,98,121,154,236,990
65542,6364,6546,6711,6862,6672,6661,6776,46592
65543,288,279,469,511,583,591,431,3152
65548,5369,5331,5588,5770,5358,5243,5908,38567
65550,3128,3516,3561,4191,3890,3648,3127,25061
65552,2028,1934,2170,2117,2375,1997,2013,14634
65555,1200,1084,1125,1077,960,905,1087,7438
65556,6048,5715,5799,5834,5716,5703,5869,40684
65557,91,107,134,92,106,267,166,963
65559,8955,8896,8805,9069,9045,8674,9385,62829
65560,14508,14428,14476,14536,14155,14203,14392,100698
65564,403,400,442,376,304,184,220,2329
65565,5092,5423,5575,5581,5389,5713,5854,38627
65566,847,727,741,819,857,912,772,5675
65567,1426,1433,1412,1186,1046,959,1253,8715
65570,611,713,711,564,590,550,528,4267
65571,2215,2130,2133,1801,1908,1909,2134,14230
65580,829,746,726,780,717,660,829,5287
65582,2164,2180,2172,1873,2108,2155,2181,14833
65583,11252,11152,11111,11002,11380,10647,12307,78851
65584,11345,10520,10373,9637,9564,9151,9855,70445
65586,63,15,13,17,18,20,33,179
65588,2796,2772,2947,2844,2604,2888,2680,19531
65589,313,326,342,346,143,129,188,1787
65590,1190,1195,1053,934,1016,1184,1231,7803
65591,2019,1837,1752,1788,1729,1733,1512,12370
65601,641,652,732,662,676,740,812,4915
65603,197,182,160,249,271,319,206,1584
65604,4170,4035,4121,3658,3743,3517,3746,26990
65605,12189,11728,11610,11360,11283,11070,12136,81376
65606,3575,3417,3521,3559,3465,3388,3613,24538
65608,9383,9474,9559,9734,9439,9600,9403,66592
65609,668,721,675,565,621,655,778,4683
65610,5905,5898,5427,5573,5153,4645,5239,37840
65611,1949,1998,2033,1895,1796,1981,1969,13621
65612,1234,1537,1572,1581,1442,1461,1354,10181
65613,17613,17223,16799,16862,16826,16984,17396,119703
65614,671,645,641,775,702,705,591,4730
65616,25704,24786,24150,23468,23786,23716,24284,169894
65617,1755,1702,2168,2361,2812,2224,1630,14652
65618,306,323,383,240,287,228,148,1915
65619,7191,7587,7661,7966,7719,7477,7393,52994
65620,274,167,221,222,179,135,262,1460
65622,8062,8385,8737,8963,9093,9541,8716,61497
65623,35,34,23,32,11,10,36,181
65624,1391,1470,1576,1892,1710,1539,1577,11155
65625,8045,7812,7969,8043,8424,8463,8328,57084
65626,1613,1650,1815,1957,1919,1569,1637,12160
65627,503,417,413,470,478,472,460,3213
65629,626,677,609,584,499,522,574,4091
65630,329,340,290,215,138,144,310,1766
65631,4910,4665,4719,4787,4609,4457,4678,32825
65632,2606,2641,2639,2516,2377,2465,2939,18183
65633,4309,4684,4382,4335,4467,4991,4131,31299
65634,796,807,767,776,935,1080,766,5927
65635,520,632,619,656,725,622,541,4315
65637,1325,1338,1373,1451,1585,1639,1135,9846
65638,421,470,450,404,375,324,461,2905
65640,759,815,855,868,908,868,887,5960
65641,1037,1042,1067,964,1144,945,1250,7449
65644,2328,2411,2534,2909,3094,2817,2759,18852
65646,2079,2141,2316,2131,2155,2123,2046,14991
65647,1866,2140,2190,2454,2606,2604,2347,16207
65648,6560,6735,6406,6408,5963,5180,5614,42866
65649,1345,1346,1309,1267,1269,1289,1593,9418
65650,1217,1081,1164,1139,1196,1306,1520,8623
65652,3906,4223,3883,3485,3738,3603,4157,26995
65653,6240,6149,5465,5681,5201,5189,5708,39633
65654,132,123,178,150,146,177,159,1065
65655,3517,3483,3510,3494,3513,3262,3186,23965
65656,4649,4686,4491,5009,5190,4910,4929,33864
65657,172,177,131,109,140,226,94,1049
65658,1362,1501,1751,1668,1600,1347,1131,10360
65660,103,56,66,97,174,155,182,833
65661,2521,2395,2130,2042,2112,2201,2562,15963
65662,1396,1340,1453,1050,1068,1041,1269,8617
65663,2883,2649,2754,2816,2675,2732,2481,18990
65664,167,94,114,118,166,177,159,995
65667,3339,3615,3560,3502,3553,3364,3305,24238
65668,1744,1852,1854,1730,1929,1908,1745,12762
65669,1881,1861,1911,1988,1855,1969,2031,13496
65672,9514,9503,9434,9078,9577,8778,9048,64932
65674,3063,3106,3136,2985,2850,3129,2991,21260
65676,355,465,489,532,503,573,472,3389
65679,2619,3049,3233,3545,2912,2900,2704,20962
65680,1060,1188,1221,1109,1195,1313,1201,8287
65681,1981,1853,2286,2363,2637,2594,2345,16059
65682,2096,2106,2242,2294,2235,2183,1980,15136
65685,636,606,659,661,566,615,877,4620
65686,4565,4573,4439,4409,4289,4512,4920,31707
65689,4576,4551,4599,4466,4682,4718,4859,32451
65690,244,226,211,211,244,250,298,1684
65692,1209,1323,1511,1579,1717,1656,1332,10327
65702,393,487,493,502,535,542,473,3425
65704,3694,3495,3499,3347,3487,3597,4047,25166
65705,4173,4433,4139,4190,3608,3769,3999,28311
65706,15392,14620,14616,14281,14622,14636,14439,102606
65707,2158,2183,2197,2163,2204,2387,2299,15591
65708,12999,13164,13058,13107,13173,13510,12624,91635
65710,1131,1189,1449,1437,1387,1488,1275,9356
65711,9230,9562,9964,10178,9726,10254,9926,68840
65712,8059,8270,8453,8543,9148,8926,8494,59893
65713,2310,2327,2226,2445,2628,2627,2496,17059
65714,31937,31557,30573,29641,29750,28377,29818,211653
65715,34,29,40,46,75,201,92,517
65717,3023,2665,2549,2790,2914,2926,2568,19435
65720,677,566,671,742,738,796,665,4855
65721,30586,29970,30113,29950,29311,29180,28550,207660
65722,1454,1271,1320,1289,1155,1679,1909,10077
65723,3440,3782,4171,4148,4262,4560,3606,27969
65724,1790,1739,1665,1588,1340,1372,1392,10886
65725,2474,2930,2635,2421,2328,2840,2459,18087
65727,295,435,336,260,401,290,218,2235
65728,62,54,55,59,120,58,76,484
65729,417,330,307,337,393,403,264,2451
65730,93,71,104,70,210,225,196,969
65731,433,417,337,137,108,179,281,1892
65732,856,719,713,748,667,563,871,5137
65733,681,798,726,653,758,636,720,4972
65734,3361,3453,3344,3664,3143,3260,3497,23722
65735,97,141,163,192,203,144,110,1050
65737,8658,8193,8425,8085,7792,7687,8413,57253
65738,18037,17773,17838,17677,17390,16524,17550,122789
65739,1058,1015,1097,1312,1402,1441,1326,8651
65740,3174,3216,3501,3662,3618,3656,3405,24232
65742,12390,11734,11809,11918,11551,11415,11367,82184
65744,114,140,176,170,163,185,142,1090
65745,2671,2624,2482,2209,2451,2386,2693,17516
65746,8281,8574,8586,8616,7721,7904,7895,57577
65747,4066,4009,3902,3608,3799,3708,3746,26838
65752,208,302,313,332,325,483,432,2395
65753,4894,5244,4858,4787,4947,4843,5027,34600
65754,1119,1194,1497,1156,878,935,950,7729
65755,245,349,367,435,533,513,519,2961
65756,675,722,689,655,630,522,748,4641
65757,7012,6999,7052,6869,6806,6902,6975,48615
65759,1448,1414,1428,1283,1315,1239,1423,9550
65760,709,618,586,634,518,487,739,4291
65761,956,1052,1091,1120,1110,1284,1273,7886
65762,360,415,407,452,454,460,441,2989
65764,1917,1928,1733,1605,1430,1409,1287,11309
65766,106,141,136,134,131,143,105,896
65767,1813,1784,1796,1834,1593,1486,2106,12412
65768,382,353,311,362,596,572,488,3064
65769,3198,3182,3047,3293,3296,3242,3091,22349
65770,2842,2912,2620,2634,2749,2686,3002,19445
65771,1431,1832,2080,2035,1771,1725,1398,12272
65772,2067,2176,2261,2239,2321,2518,2158,15740
65773,498,362,462,564,546,672,711,3815
65774,934,850,896,996,1020,1153,953,6802
65775,24915,24999,24562,24256,24384,24290,24908,172314
65777,347,373,242,239,230,188,328,1947
65778,576,599,531,489,480,415,524,3614
65779,1753,2059,2287,2381,2398,2248,2207,15333
65781,8368,8131,8162,8386,8034,8109,8543,57733
65783,101,150,165,136,165,179,225,1121
65784,13,13,0,0,0,0,34,60
65785,5076,5019,5140,5395,5443,5630,5259,36962
65786,2241,2453,2567,2452,2547,2174,2250,16684
65787,1664,1507,1689,1525,1397,1282,1864,10928
65788,346,339,292,405,427,550,422,2781
65789,1918,1810,1872,1696,1786,1817,2014,12913
65790,870,901,876,764,641,545,739,5336
65791,4669,4551,4467,4611,4726,5005,4585,32614
65793,6702,6648,6756,6620,6852,6685,6337,46600
65802,45270,43741,43770,43687,43401,42191,44270,306330
65803,41576,42264,42041,42747,42610,42466,40902,294606
65804,37890,37804,37469,36996,36748,36741,36801,260449
65806,11471,10957,10618,9888,9377,9761,10586,72658
65807,57350,56882,56373,55658,56381,55853,54952,393449
65809,11867,11583,11214,11060,10792,10380,11257,78153
65810,22857,22697,22588,21787,21200,21408,20984,153521
66002,13466,13448,13531,13653,13867,13742,13755,95462
66006,7439,7417,7300,7215,7260,7268,7459,51358
66007,6627,6330,6528,6124,6228,5837,5614,43288
66008,244,196,242,262,244,254,286,1728
66010,703,670,713,598,603,587,606,4480
66012,11287,11092,10947,10949,10810,10812,11210,77107
66013,2041,2205,2318,1832,2065,2177,1839,14477
66014,177,186,302,324,465,542,349,2345
66015,886,833,876,859,777,687,782,5700
66016,180,174,207,297,317,404,519,2098
66017,383,350,347,388,321,311,304,2404
66018,6078,6029,5949,5698,5611,5668,5760,40793
66019,360,267,333,290,334,159,246,1989
66020,1524,1759,1549,1691,1696,1593,1442,11254
66021,2643,2261,2078,2068,2212,2444,2612,16318
66023,1240,1449,1408,1358,1263,1163,1124,9005
66024,725,821,913,905,748,859,927,5898
66025,7683,8008,7923,7743,7843,7716,7704,54620
66026,636,548,553,814,968,974,698,5191
66027,6196,6249,5882,5713,5675,5359,5742,40816
66030,22996,22606,22255,21854,21225,20503,20961,152400
66031,713,743,506,456,398,299,1072,4187
66032,5021,5094,5144,5225,5424,5452,5115,36475
66033,553,588,578,663,672,558,767,4379
66035,1298,1340,1344,1385,1417,1358,1311,9453
66039,600,679,652,646,654,670,628,4529
66040,2917,3493,3444,3228,2980,3298,3404,22764
66041,719,700,864,842,707,669,725,5226
66042,764,743,573,552,697,670,657,4656
66043,11089,10971,11034,10990,10673,10648,10787,76192
66044,28217,27570,27690,27547,27800,27873,28417,195114
66045,2083,2394,2447,2427,2533,2612,2023,16519
66046,19368,19691,19716,19695,19292,19088,19452,136302
66047,20118,20193,19594,19379,19172,18559,18268,135283
66048,35958,35500,35444,35424,35632,35913,35475,249346
66049,29132,27556,26876,26147,25623,25217,25957,186508
66050,2017,1987,1970,1968,1989,2257,1822,14010
66052,2368,2355,2346,2021,2054,2161,2031,15336
66053,7357,7457,7573,7768,7496,7321,7524,52496
66054,2898,3300,3151,3164,2767,2831,2860,20971
66056,1830,1731,1616,1681,1598,1526,1694,11676
66058,358,382,393,398,387,496,393,2807
66060,1201,1131,1137,1066,1135,1182,1122,7974
66061,60652,59091,58890,57167,55422,54284,55805,401311
66062,78805,78356,76480,75938,74922,73230,74411,532142
66064,6068,6138,6119,5936,5834,6055,6098,42248
66066,2698,2433,2572,2440,2553,2486,2636,17818
66067,15383,15904,16234,16537,16392,16506,16170,113126
66070,2859,2518,2394,2816,2644,2490,2661,18382
66071,12233,12029,12373,12284,12305,12474,12360,86058
66072,1280,1115,1027,1203,1162,1223,1054,8064
66073,2213,2352,2219,2242,2092,2228,2537,15883
66075,2015,1908,1961,1840,1973,1970,2103,13770
66076,2217,2087,1941,1759,2050,2286,2200,14540
66078,1304,1164,1018,927,851,776,961,7001
66079,670,483,537,477,578,569,781,4095
66080,960,942,858,835,801,779,1065,6240
66083,9032,9119,9112,9256,8920,8341,8910,62690
66085,7601,7653,7484,7852,7853,7968,7779,54190
66086,10227,10210,10029,9965,9655,9224,9759,69069
66087,1989,2025,1962,1840,1916,1989,2042,13763
66088,2579,2482,2667,2579,2560,2430,2457,17754
66090,2661,2546,2518,2480,2675,2539,2520,17939
66091,221,167,195,158,158,285,352,1536
66092,4104,4238,4171,4289,4178,4058,4084,29122
66093,709,647,713,659,546,565,609,4448
66094,446,502,504,538,487,476,416,3369
66095,1012,1033,1228,1260,1243,935,896,7607
66097,1349,1260,1186,985,969,1066,1071,7886
66101,12481,12703,12981,13255,13729,13697,13220,92066
66102,31234,30294,29507,29584,28923,28591,29282,207415
66103,13687,13583,13496,13142,13368,13663,13934,94873
66104,25826,25442,25197,24686,24956,25107,25401,176615
66105,2459,2418,2472,2337,2442,2640,2924,17692
66106,24275,24440,24146,24014,23150,22670,23367,166062
66109,21452,21753,22237,22275,21365,21028,20480,150590
66111,9702,10138,10324,10409,10823,10555,10155,72106
66112,13025,12504,11683,11319,11194,11210,11458,82393
66115,0,0,0,0,0,0,0,0
66118,0,0,0,0,0,0,3,3
66202,15874,15987,16193,16473,16703,16747,16173,114150
66203,19228,19384,19724,19752,19510,19466,19156,136220
66204,19954,19855,19315,18954,18379,18101,18832,133390
66205,13865,13994,13855,13804,13461,13289,13216,95484
66206,10383,10207,10085,9937,10056,9709,9693,70070
66207,13457,13235,13071,13143,12830,12921,13004,91661
66208,21350,21483,21381,21405,21354,21395,20945,149313
66209,19271,19659,19156,19182,19211,19438,19561,135478
66210,18947,18642,18507,18011,17648,17392,18102,127249
66211,4848,4455,4612,4569,4678,4637,4276,32075
66212,33623,33544,33933,33262,32677,32525,32096,231660
66213,28706,28522,28584,28142,28829,28441,27322,198546
66214,11786,11925,11612,11794,11844,12130,11691,82782
66215,26051,25622,25152,25146,24764,24881,24770,176386
66216,25264,25921,25133,25551,25789,25160,24368,177186
66217,5725,5419,5664,4886,4811,4969,5319,36793
66218,7457,7410,7426,7789,7858,7756,7754,53450
66219,11441,11082,11024,10528,10065,9597,10486,74223
66220,7260,7547,7180,7279,7171,6890,7133,50460
66221,16785,16467,15944,15344,15510,14889,15219,110158
66223,23521,22582,22284,21853,21093,20985,21759,154077
66224,13183,12714,12236,11617,11661,11611,11917,84939
66226,14323,13712,13307,12863,12407,11918,12877,91407
66227,5201,4730,4772,4440,4058,3826,4543,31570
66401,1423,1589,1648,1763,1727,1758,1721,11629
66402,2966,2941,2847,2761,2835,2805,2955,20110
66403,727,751,840,811,873,839,757,5598
66404,401,369,489,562,540,564,530,3455
66406,463,481,532,473,424,387,421,3181
66407,560,585,562,431,410,408,479,3435
66408,532,584,597,571,505,556,434,3779
66409,2706,2845,2878,2988,3084,3088,2997,20586
66411,1215,1276,1292,1309,1305,1307,1292,8996
66412,170,219,181,249,327,323,287,1756
66413,1726,1733,1679,1788,1861,1904,1802,12493
66414,2924,2750,2735,2713,2563,2764,2914,19363
66415,976,929,1045,984,979,980,885,6778
66416,437,469,462,607,644,698,489,3806
66417,387,326,283,214,290,295,310,2105
66418,492,574,667,639,629,636,707,4344
66419,346,360,309,343,341,419,442,2560
66422,358,299,389,528,508,569,487,3138
66423,951,985,928,922,962,978,985,6711
66424,511,508,656,631,659,622,610,4197
66425,407,370,386,385,484,512,465,3009
66427,1238,1293,1223,1155,1189,1243,1281,8622
66428,497,487,434,423,332,392,415,2980
66429,271,393,436,689,841,936,579,4145
66431,557,560,580,608,731,905,671,4612
66432,398,366,349,373,433,406,396,2721
66434,4842,4859,4828,4810,4762,4764,4828,33693
66436,5840,5675,5854,5629,5685,5422,5879,39984
66438,243,255,255,234,158,109,149,1403
66439,2710,2813,2768,2940,2844,2847,2747,19669
66440,2031,1919,2161,2054,1985,1937,2063,14150
66441,28670,28489,28128,27346,26226,24691,26746,190296
66442,15136,15494,15413,15037,14430,13770,14283,103563
66449,823,706,594,551,699,911,846,5130
66451,1669,1731,1752,1809,1709,1785,1793,12248
66501,437,364,326,255,267,268,260,2177
66502,45915,46288,45677,44791,44126,43274,43850,313921
66503,15576,15048,14946,14737,13889,12930,13428,100554
66506,3513,3546,3736,3779,3898,4039,3614,26125
66507,1432,1315,1138,1237,1251,1063,1247,8683
66508,4408,4313,4390,4347,4382,4441,4375,30656
66509,2889,2956,2717,2906,2739,2703,2596,19506
66510,836,804,789,731,667,733,779,5339
66512,3097,3261,3202,3140,3315,3387,3361,22763
66514,1319,1333,1373,1608,1733,1822,1657,10845
66515,518,501,535,521,388,314,425,3202
66516,364,379,370,280,290,280,378,2341
66517,1919,2010,1987,1832,1822,1657,2087,13314
66518,105,121,126,202,184,185,189,1112
66520,521,522,536,603,622,604,577,3985
66521,1780,1918,1927,1740,1718,1814,1532,12429
66522,22,28,35,30,31,38,49,233
66523,3695,3751,3630,3656,3872,3776,3833,26213
66524,2574,2887,2906,2929,2689,2706,2499,19190
66526,734,761,880,878,804,889,801,5747
66527,274,273,269,272,303,293,267,1951
66528,1032,1067,1079,1226,1044,959,945,7352
66531,1492,1363,1371,1262,1261,1146,1380,9275
66532,548,612,571,565,679,770,668,4413
66533,1707,1687,1504,1559,1427,1401,1832,11117
66534,3644,3766,3865,3784,3751,3801,3725,26336
66535,2632,2781,2837,2605,2651,2601,2616,18723
66536,4364,4450,4452,4347,4059,4098,3922,29692
66537,1161,1197,1329,1297,1319,1271,1448,9022
66538,3251,3106,2798,3024,3126,3038,3264,21607
66539,3036,3093,3014,2770,3126,3055,2806,20900
66540,400,433,417,490,431,528,540,3239
66541,217,244,259,305,329,350,264,1968
66542,3323,3389,3556,3262,3274,3345,3335,23484
66543,1022,1052,997,910,1004,902,725,6612
66544,384,364,262,311,301,291,337,2250
66546,1132,1085,1316,1195,1131,1120,1012,7991
66547,8322,7870,7521,7668,7503,7425,7617,53926
66548,943,880,887,830,852,871,961,6224
66549,1707,1822,1802,1675,1523,1380,1646,11555
66550,599,646,601,510,512,501,607,3976
66552,503,523,485,457,509,506,396,3379
66554,644,639,645,766,816,772,567,4849
66603,1626,1546,1393,1378,1460,1558,2001,10962
66604,22796,22576,22579,21886,22450,21520,23344,157151
66605,19883,20431,19589,20732,20786,20750,19919,142090
66606,11115,11205,11377,11351,11381,11427,11284,79140
66607,9584,9984,10695,11181,10961,10866,10498,73769
66608,5404,5633,5752,5945,5597,5992,5991,40314
66609,8289,7807,8620,7750,7362,7241,7068,54137
66610,9758,9856,9753,9311,9118,9150,9080,66026
66611,9600,9276,9193,9061,9204,9292,9832,65458
66612,2594,2667,2768,2976,2689,2917,2477,19088
66614,31705,31315,31114,31709,31569,31984,31354,220750
66615,3432,3470,3220,3146,2818,2763,2814,21663
66616,5661,5937,5706,5510,6024,5917,5874,40629
66617,9181,9023,8924,8902,8577,8012,8688,61307
66618,9529,9464,9648,9688,9626,9317,9402,66674
66619,3022,3015,2756,2931,2959,2805,3070,20558
66621,679,706,608,513,496,419,643,4064
66622,83,83,163,183,187,192,76,967
66701,12294,12298,12018,12130,12231,12251,12325,85547
66710,637,729,764,887,977,915,746,5655
66711,631,660,804,727,722,706,610,4860
66712,1813,1816,1831,1850,1884,1844,1939,12977
66713,5533,5541,5615,6063,6231,6284,5836,41103
66714,216,171,174,151,145,122,177,1156
66716,543,648,735,788,610,585,567,4476
66717,639,598,580,600,510,539,497,3963
66720,11397,11644,11409,11316,11431,11602,11299,80098
66724,1224,1240,1210,1062,1109,936,1065,7846
66725,5746,5849,5659,5672,5518,5436,5739,39619
66728,18,0,0,0,0,0,91,109
66732,281,261,261,295,314,289,291,1992
66733,2082,1995,2048,2252,2196,2118,2215,14906
66734,254,334,224,223,225,198,332,1790
66735,603,715,488,588,460,441,421,3716
66736,3701,3683,3700,3595,3370,3435,3954,25438
66738,276,320,392,387,407,345,376,2503
66739,5634,5612,5695,5242,5384,5360,5453,38380
66740,516,449,440,350,465,287,477,2984
66741,171,182,157,151,119,144,237,1161
66743,4362,4297,4223,4137,4086,4243,4373,29721
66746,229,227,193,230,199,426,261,1765
66748,2441,2326,2389,2395,2547,2674,2750,17522
66749,7815,7760,7768,7994,7867,7853,7974,55031
66751,790,1066,1110,951,1079,997,849,6842
66753,1051,1118,1032,1082,1129,1030,1077,7519
66754,455,320,446,428,547,460,451,3107
66755,1164,1148,1180,1065,1054,1106,1178,7895
66756,725,726,891,968,1128,1016,1007,6461
66757,3249,3334,3365,3429,3510,3816,3560,24263
66758,190,177,280,283,283,288,216,1717
66760,0,0,44,29,39,44,98,254
66761,377,356,347,356,254,142,238,2070
66762,24978,24816,24889,24796,24693,24832,24786,173790
66763,3379,3389,3380,3365,3424,3307,3369,23613
66767,567,421,419,515,565,563,511,3561
66769,401,333,344,404,366,454,557,2859
66770,1083,1121,1277,1134,1064,1221,1158,8058
66771,1108,996,1184,1165,1197,1120,1028,7798
66772,334,375,341,364,360,354,253,2381
66773,782,766,896,922,887,1061,866,6180
66775,148,145,109,94,86,108,191,881
66776,1261,1236,1200,1198,1329,1260,1288,8772
66777,553,614,667,726,793,765,639,4757
66778,0,0,26,74,135,198,139,572
66779,663,723,802,780,801,806,650,5225
66780,637,602,725,813,878,966,589,5210
66781,1021,1181,1248,1351,1387,1250,1347,8785
66782,240,239,215,267,250,203,178,1592
66783,2073,2156,2080,2053,2088,2170,2230,14850
66801,28424,28417,28727,28837,29345,29419,28492,201661
66830,179,192,160,177,121,178,262,1269
66833,629,619,637,618,624,716,536,4379
66834,967,789,887,947,989,756,848,6183
66835,1190,1139,1095,1208,1232,1277,1360,8501
66838,141,170,197,238,264,196,182,1388
66839,3794,3830,3846,3774,3633,3820,4007,26704
66840,776,934,703,750,655,654,777,5249
66842,316,311,240,246,265,256,324,1958
66843,194,195,185,90,73,54,205,996
66845,1277,1272,1390,1431,1397,1482,1232,9481
66846,3337,3423,3335,3172,3207,3300,3504,23278
66849,405,400,472,483,571,613,485,3429
66850,177,168,120,130,180,149,228,1152
66851,568,543,637,570,542,510,583,3953
66852,590,519,541,563,633,677,631,4154
66853,428,373,364,419,515,518,429,3046
66854,791,823,867,781,859,760,816,5697
66856,1739,1728,1702,1670,1683,1587,1613,11722
66857,996,1028,1015,1126,1146,1107,943,7361
66858,510,578,596,471,462,395,456,3468
66859,211,214,166,201,185,160,178,1315
66860,1440,1509,1371,1416,1209,1361,1258,9564
66861,2936,2817,3058,3072,3126,3140,3204,21353
66862,63,79,78,76,61,57,116,530
66863,52,50,49,79,162,102,63,557
66864,351,336,399,486,452,457,456,2937
66865,1188,1197,1077,1094,1110,1164,1124,7954
66866,1630,1681,1623,1737,1874,2028,1789,12362
66868,846,888,726,692,681,684,764,5281
66869,727,727,730,676,735,790,748,5133
66870,115,97,113,115,112,91,166,809
66871,1342,1320,1296,1311,1309,1321,1346,9245
66872,1039,1014,1123,1367,1195,1293,1134,8165
66873,280,275,316,346,267,291,319,2094
66901,6306,6398,6556,6518,6585,6510,6605,45478
66930,252,247,257,255,281,247,186,1725
66932,104,129,126,144,106,125,157,891
66933,332,291,284,246,236,253,298,1940
66935,2132,2240,2199,2247,2311,2395,2563,16087
66936,315,303,319,306,335,309,344,2231
66937,783,765,786,755,757,752,893,5491
66938,1058,1073,1029,1017,1041,1135,1005,7358
66939,700,679,668,659,606,572,537,4421
66940,353,358,328,370,378,315,339,2441
66941,196,212,255,216,219,246,242,1586
66942,308,280,295,286,269,285,247,1970
66943,546,518,502,469,497,546,505,3583
66944,128,112,158,172,157,206,195,1128
66945,956,937,917,1042,1132,1173,1096,7253
66946,126,142,168,175,156,156,126,1049
66948,525,541,528,575,576,666,494,3905
66949,786,725,679,655,604,642,668,4759
66951,822,814,844,857,778,794,764,5673
66952,330,412,385,507,552,580,499,3265
66953,702,679,674,698,722,733,703,4911
66955,87,80,78,93,97,106,114,655
66956,1047,1083,1104,1172,1172,1168,1157,7903
66958,267,304,314,249,273,282,314,2003
66959,270,292,295,299,237,222,203,1818
66960,130,149,150,167,178,186,167,1127
66962,295,313,313,279,274,224,264,1962
66963,126,157,128,116,161,165,135,988
66964,132,142,188,185,199,185,204,1235
66966,714,631,633,589,566,600,624,4357
66967,2041,1962,1960,1960,2025,2040,2096,14084
66968,1645,1733,1752,1746,1663,1560,1626,11725
66970,118,155,169,180,203,194,97,1116
67001,1517,1669,1809,1922,1887,1813,1676,12293
67002,14298,14348,14162,13834,13791,13486,13764,97683
67003,2593,2663,2754,2720,2693,2736,2626,18785
67004,915,954,868,811,875,794,827,6044
67005,16199,16457,16431,16515,16415,16218,16535,114770
67008,539,550,517,516,442,452,556,3572
67009,944,985,918,955,889,944,856,6491
67010,13755,13389,13246,13685,13458,13526,13890,94949
67012,10,22,20,20,30,30,61,193
67013,2556,2763,2748,2821,2828,2916,3145,19777
67016,507,542,515,503,451,431,530,3479
67017,2253,2265,2242,2213,2533,2526,2294,16326
67018,219,140,124,66,70,77,149,845
67019,1172,1052,989,910,935,969,945,6972
67020,1795,1825,1627,1602,1576,1604,1689,11718
67021,52,57,107,112,134,120,65,647
67022,1590,1559,1650,1699,1669,1725,1461,11353
67023,299,235,184,176,153,118,230,1395
67024,746,765,706,722,692,793,849,5273
67025,3741,3771,3644,3803,3894,3844,3884,26581
67026,5064,5033,4749,4822,4955,4883,4845,34351
67028,284,329,300,245,264,279,225,1926
67029,1035,973,853,829,875,1010,1063,6638
67030,3193,3107,2981,2739,2614,2574,2659,19867
67031,2791,2718,2765,2792,2532,2493,2308,18399
67035,939,1020,946,1092,1014,1144,970,7125
67036,84,94,79,97,125,123,151,753
67037,28360,28097,27928,27430,26631,26076,26577,191099
67038,753,735,719,763,626,673,602,4871
67039,3582,3535,3672,3737,3823,3820,3395,25564
67041,308,285,273,239,239,243,229,1816
67042,17729,17698,17877,17831,17970,17697,17969,124771
67045,3268,3308,3502,3612,3608,3622,3644,24564
67047,729,846,823,754,872,775,731,5530
67049,49,39,39,30,20,22,79,278
67050,1506,1644,1797,1879,1949,2076,1844,12695
67051,430,473,463,448,481,464,456,3215
67052,8994,8721,8332,8097,8062,7669,8325,58200
67053,637,605,545,587,539,533,539,3985
67054,1280,1229,1213,1284,1149,1178,1167,8500
67055,122,150,236,170,122,195,71,1066
67056,3026,3067,3058,3242,2763,2867,2935,20958
67057,216,208,228,253,292,308,241,1746
67058,1821,1896,1981,2055,2117,1986,2093,13949
67059,996,1076,1016,989,988,1028,1042,7135
67060,14122,14267,14244,13988,13920,13556,13733,97830
67061,204,210,220,164,187,207,171,1363
67062,4364,4316,4248,4169,4100,4125,4156,29478
67063,3706,3726,3760,3853,3926,3896,3942,26809
67065,284,167,173,214,188,170,228,1424
67066,367,350,345,335,317,298,302,2314
67067,1797,1674,1748,1824,1701,1708,1541,11993
67068,4245,4285,4574,4280,4328,4282,4354,30348
67070,1152,1128,1267,1252,1172,1178,1169,8318
67071,151,137,93,104,91,125,94,795
67072,191,213,201,217,241,302,244,1609
67073,373,345,294,293,197,223,309,2034
67074,1698,1791,1871,2001,2133,1996,1741,13231
67101,4662,4194,3837,3610,3174,3050,3604,26131
67103,224,208,279,373,408,402,326,2220
67104,2622,2545,2516,2459,2409,2376,2506,17433
67105,186,268,246,281,282,219,190,1672
67106,156,146,135,137,326,284,388,1572
67107,2680,2676,2768,2787,2976,2896,2979,19762
67108,1497,1512,1454,1494,1626,1432,1696,10711
67109,361,359,412,362,436,421,418,2769
67110,8419,8003,8050,7843,7853,7968,8415,56551
67111,247,215,219,219,300,347,352,1899
67112,188,232,227,286,243,234,227,1637
67114,21836,21817,21916,21695,22013,21891,21852,153020
67117,1901,1782,1889,1822,1774,1681,1769,12618
67118,791,820,740,781,867,901,810,5710
67119,1449,1578,1583,1620,1508,1500,1457,10695
67120,1259,1361,1650,1564,1488,1409,1358,10089
67122,126,130,109,97,133,104,221,920
67123,733,824,914,790,759,892,741,5653
67124,8201,8332,8410,8507,8358,8365,8203,58376
67127,716,888,913,914,846,740,701,5718
67131,259,256,191,155,167,270,258,1556
67132,520,440,380,418,447,427,410,3042
67133,6446,6444,6465,6389,6420,6405,6379,44948
67134,350,340,324,314,388,396,420,2532
67135,3665,3680,3885,3770,3514,3307,3493,25314
67137,552,618,667,586,594,720,634,4371
67138,259,275,294,279,325,362,397,2191
67140,782,735,694,592,636,641,802,4882
67142,447,399,431,475,451,491,445,3139
67143,14,30,58,53,60,56,58,329
67144,2936,2961,3066,2828,2607,2591,2716,19705
67146,1833,1919,2066,2017,2293,2210,1830,14168
67147,9759,9812,9472,9138,9259,9098,9908,66446
67149,872,790,974,1018,973,1270,988,6885
67150,63,55,9,25,20,21,12,205
67151,541,562,573,596,665,607,479,4023
67152,9249,9269,9245,9322,9426,9314,9541,65366
67154,1325,1236,1158,1334,1401,1385,1510,9349
67155,189,183,179,162,172,173,166,1224
67156,14790,14826,15079,15100,15150,15362,15269,105576
67159,126,128,115,93,57,117,169,805
67202,1514,1438,1548,1358,1241,1258,1393,9750
67203,29608,30412,30874,31039,31327,31046,31287,215593
67204,21217,20888,20322,20440,20960,21452,21194,146473
67205,17346,16732,17096,16954,16335,16746,16811,118020
67206,15955,15778,15786,16534,15587,15607,15186,110433
67207,29000,28445,28388,27993,27410,27305,26978,195519
67208,18837,18968,19137,19012,19102,19242,18161,132459
67209,13717,13631,13870,14022,13576,13833,13654,96303
67210,10035,10373,10163,10111,9562,9522,10339,70105
67211,19374,20389,20072,21303,21012,20382,20644,143176
67212,44888,44829,44978,44221,44772,44595,44707,312990
67213,22988,21541,22333,22516,22829,22088,21368,155663
67214,15070,15354,15275,16115,15451,15412,16542,109219
67215,5763,5787,5815,5737,6065,6002,5708,40877
67216,24300,24656,25058,23996,24150,23460,24041,169661
67217,30231,29726,28620,27996,28341,28482,30186,203582
67218,22741,23052,22829,22482,22264,22699,22772,158839
67219,12615,12625,12145,11594,11741,11413,12121,84254
67220,14347,14931,14367,14533,14313,13996,14214,100701
67223,622,554,556,718,572,603,513,4138
67226,18649,18625,18305,18002,17945,17355,17757,126638
67227,267,278,239,160,197,180,344,1665
67228,2492,2201,1976,1739,1450,1459,2033,13350
67230,10577,10421,10032,10428,10373,10031,9959,71821
67232,315,379,234,269,417,526,298,2438
67235,12896,12520,12502,11660,11554,10620,11446,83198
67260,0,0,0,0,0,0,0,0
67301,12952,12995,13026,13651,13579,13449,13556,93208
67330,1658,1799,1574,1622,1575,1553,1535,11316
67332,154,168,130,138,115,140,207,1052
67333,2965,3024,3133,3177,3087,2737,3089,21212
67334,55,61,57,72,79,55,104,483
67335,3424,3332,3249,3306,3534,3626,3671,24142
67336,1848,1714,1820,1894,1815,1780,1683,12554
67337,12672,12841,13107,12770,12777,13085,13493,90745
67340,409,396,342,324,311,364,355,2501
67341,190,200,254,289,304,275,373,1885
67342,913,958,932,923,897,873,969,6465
67344,795,779,766,766,1090,1100,877,6173
67345,135,136,127,187,191,191,161,1128
67346,369,364,402,381,334,386,372,2608
67347,410,500,553,459,443,398,431,3194
67349,1092,1100,1086,1043,1080,1099,1034,7534
67351,486,486,519,587,531,514,391,3514
67352,531,558,644,717,648,655,593,4346
67353,515,495,447,375,490,495,582,3399
67354,745,719,739,771,777,738,825,5314
67355,174,148,183,196,213,200,213,1327
67356,2792,2787,3064,2929,3129,3106,2834,20641
67357,12371,12562,12664,12832,12769,13191,13006,89395
67360,396,427,450,465,441,368,409,2956
67361,1823,1887,1997,2044,2078,2149,1841,13819
67363,43,33,39,32,0,0,78,225
67364,206,364,366,343,413,526,311,2529
67401,51285,51374,51394,51196,51209,51127,51499,359084
67410,10334,10292,10323,10393,10283,10305,10141,72071
67416,1102,1226,1210,1325,1529,1576,1146,9114
67417,240,211,170,163,174,140,179,1277
67418,138,141,193,194,176,225,246,1313
67420,4542,4613,4700,4739,4738,4723,4721,32776
67422,1399,1270,1324,1299,1331,1325,1366,9314
67423,336,318,354,286,305,350,316,2265
67425,746,873,1016,804,784,745,689,5657
67427,385,498,469,474,389,416,408,3039
67428,1720,1691,1748,1667,1730,1688,1465,11709
67430,624,591,607,681,675,669,611,4458
67431,2390,2473,2548,2580,2512,2341,2471,17315
67432,5979,6057,5957,6044,6021,6120,6019,42197
67436,718,795,755,694,648,587,636,4833
67437,1068,1206,1263,1229,1273,1211,1161,8411
67438,323,363,402,378,316,353,300,2435
67439,3567,3674,3812,3731,3843,3828,3674,26129
67441,1174,1174,1176,967,985,1074,1115,7665
67442,277,291,251,209,191,198,266,1683
67443,1974,1864,1770,1768,1948,1980,1794,13098
67444,578,553,570,605,660,650,527,4143
67445,609,594,550,613,573,607,680,4226
67446,684,710,609,543,480,544,617,4187
67447,268,255,293,353,340,298,320,2127
67448,1404,1228,1171,1038,951,899,1374,8065
67449,2842,2902,3057,3156,3290,3311,3351,21909
67450,641,541,450,465,518,519,555,3689
67451,976,898,821,921,983,1090,948,6637
67452,202,246,248,254,222,218,201,1591
67454,496,458,476,501,496,481,563,3471
67455,1992,1974,1864,1942,1986,1995,1980,13733
67456,4694,4718,4770,4810,4698,4725,4736,33151
67457,827,818,842,803,735,809,878,5712
67458,293,412,434,421,231,213,261,2265
67459,267,251,190,191,178,191,251,1519
67460,15019,15077,15259,15441,15016,15207,15168,106187
67464,1066,1109,995,1108,984,969,1090,7321
67466,839,878,895,809,873,833,774,5901
67467,2636,2670,2780,2803,2775,2971,2904,19539
67468,246,173,229,212,240,258,307,1665
67470,482,552,460,539,492,390,456,3371
67473,1815,1735,1689,1670,1699,1653,1728,11989
67474,253,267,216,221,178,189,224,1548
67475,245,255,246,249,276,204,283,1758
67478,61,59,50,46,72,67,89,444
67480,1771,1883,1901,1823,1859,1803,1805,12845
67481,537,576,624,583,585,522,590,4017
67482,65,90,119,107,98,133,99,711
67483,336,309,324,367,401,436,338,2511
67484,872,861,799,984,1003,915,891,6325
67485,406,310,350,368,389,356,339,2518
67487,1407,1343,1399,1390,1565,1489,1422,10015
67490,925,960,974,1007,986,1037,1055,6944
67491,446,508,554,493,478,452,399,3330
67492,252,283,191,125,175,217,166,1409
67501,26696,25842,26392,26799,26436,26759,27212,186136
67502,23687,24691,24127,24160,24145,24069,23739,168618
67505,2353,2392,2267,2281,2499,2238,2457,16487
67510,375,333,352,280,209,231,281,2061
67511,332,348,340,363,348,302,318,2351
67512,131,189,233,240,210,234,234,1471
67513,62,48,51,53,87,90,93,484
67514,917,754,710,674,651,574,765,5045
67515,31,46,55,54,67,71,63,387
67516,431,457,501,574,618,544,447,3572
67518,73,68,58,25,14,32,69,339
67519,261,262,222,207,166,159,193,1470
67520,420,386,361,373,338,351,415,2644
67521,119,112,127,123,114,157,155,907
67522,2210,2154,2300,2186,2027,1967,2049,14893
67523,413,409,364,440,460,410,373,2869
67524,677,679,718,685,630,610,630,4629
67525,894,919,997,1115,1063,1100,1119,7207
67526,2982,3029,3058,2929,2826,2514,2759,20097
67529,323,379,314,302,348,518,365,2549
67530,19289,19394,19581,19576,19558,20098,19699,137195
67543,1836,1927,1861,1875,1905,1842,2125,13371
67544,3149,3196,3137,3175,3216,3103,3216,22192
67545,169,216,250,265,251,279,215,1645
67546,2482,2587,2445,2494,2582,2503,2597,17690
67547,1708,1682,1682,1683,1748,1863,1769,12135
67548,1374,1380,1465,1508,1548,1572,1467,10314
67550,5830,5877,5916,5909,5807,5769,5905,41013
67552,586,633,669,674,766,665,720,4713
67553,153,135,103,136,98,105,114,844
67554,4171,4233,4154,4231,4418,4306,4334,29847
67556,256,279,328,353,427,347,320,2310
67557,564,618,661,662,631,652,723,4511
67559,36,44,50,52,39,49,52,322
67560,1747,1777,1782,1693,1636,1694,1740,12069
67561,1576,1608,1665,1630,1712,1677,1538,11406
67563,443,409,444,469,416,429,371,2981
67564,308,291,268,237,219,162,308,1793
67565,498,499,446,364,341,367,429,2944
67566,720,861,955,900,858,841,650,5785
67567,502,430,477,413,579,544,526,3471
67568,234,223,278,301,299,349,309,1993
67570,1378,1517,1524,1647,1664,1653,1338,10721
67572,438,412,370,407,406,434,456,2923
67573,216,181,173,152,146,146,170,1184
67574,258,260,325,291,346,269,252,2001
67575,387,442,419,405,370,373,465,2861
67576,1985,1894,1809,1857,1902,1913,1915,13275
67578,1388,1413,1453,1453,1402,1397,1405,9911
67579,3224,3101,3134,3160,3104,3151,3095,21969
67581,345,341,346,291,369,355,416,2463
67583,786,800,724,652,888,936,1022,5808
67584,321,312,296,293,280,254,269,2025
67601,23958,24087,24273,24080,24001,23689,23797,167885
67621,349,385,409,460,517,520,393,3033
67622,727,714,713,744,681,677,599,4855
67623,205,234,259,248,264,302,270,1782
67625,346,339,314,248,242,231,257,1977
67626,167,168,123,137,143,153,145,1036
67628,57,67,63,57,65,56,78,443
67629,176,180,185,146,181,151,143,1162
67631,205,247,255,219,225,258,249,1658
67632,223,265,348,309,336,370,227,2078
67634,270,263,241,260,224,210,301,1769
67635,128,141,149,118,137,99,169,941
67637,2876,2720,2521,2437,2467,2459,2651,18131
67638,325,341,380,304,298,296,230,2174
67639,122,167,176,161,220,183,193,1222
67640,583,548,518,552,572,570,505,3848
67642,1665,1660,1696,1727,1771,1929,1729,12177
67643,255,231,223,185,223,330,195,1642
67644,291,268,243,224,195,214,264,1699
67645,784,695,676,526,539,510,546,4276
67646,700,658,645,630,632,686,718,4669
67647,362,341,302,312,252,240,256,2065
67648,567,540,657,597,693,647,549,4250
67649,294,302,291,381,324,304,297,2193
67650,215,203,224,273,249,194,258,1616
67651,559,465,454,474,431,470,507,3360
67653,273,265,245,325,233,300,298,1939
67654,3960,4089,4150,4283,4371,4385,4362,29600
67656,30,43,41,40,34,83,156,427
67657,334,323,269,323,386,420,429,2484
67658,190,162,143,96,88,79,120,878
67659,152,167,156,147,96,49,154,921
67660,46,47,59,78,80,89,81,480
67661,3212,3225,3397,3352,3333,3397,3483,23399
67663,2608,2593,2583,2553,2580,2491,2615,18023
67664,373,381,350,347,362,337,305,2455
67665,5001,5049,5004,5048,4994,5060,5162,35318
67667,184,189,190,222,219,224,204,1432
67669,1781,1809,1739,1773,1721,1816,1725,12364
67671,1828,1807,1631,1606,1549,1630,1714,11765
67672,2488,2478,2540,2661,2621,2458,2359,17605
67673,92,110,147,151,159,162,108,929
67674,28,87,112,135,138,171,55,726
67675,269,235,254,282,278,211,217,1746
67701,6423,6643,6580,6547,6568,6530,6502,45793
67730,1611,1599,1561,1549,1593,1505,1612,11030
67731,720,709,709,707,636,644,675,4800
67732,487,437,458,457,449,447,543,3278
67733,286,96,104,202,166,166,149,1169
67734,255,209,210,180,194,218,182,1448
67735,5443,5673,5700,5613,5627,5598,5476,39130
67736,241,207,232,291,286,334,228,1819
67737,445,523,542,536,583,531,444,3604
67738,578,525,577,568,541,521,520,3830
67739,204,246,257,275,313,299,258,1852
67740,1661,1654,1763,1795,1748,1753,1724,12098
67741,255,228,213,187,180,164,326,1553
67743,220,157,115,119,69,49,158,887
67744,222,208,252,248,188,285,185,1588
67745,274,308,300,300,382,348,322,2234
67747,261,259,250,160,118,101,158,1307
67748,2377,2300,2324,2378,2321,2498,2544,16742
67749,2292,2292,2290,2330,2315,2224,2317,16060
67751,212,193,170,199,232,203,259,1468
67752,1332,1394,1423,1446,1371,1353,1399,9718
67753,584,528,567,580,611,602,530,4002
67756,1943,1957,1964,1974,2042,2093,2016,13989
67757,505,522,501,463,457,442,482,3372
67758,1043,933,957,1019,968,908,1016,6844
67761,249,272,268,267,238,300,249,1843
67762,316,427,404,370,373,351,288,2529
67764,441,505,453,410,422,390,345,2966
67801,31011,31183,30736,30507,29968,29217,30559,213181
67831,973,1036,1084,1275,1303,1346,1117,8134
67834,944,1047,1251,1190,1251,1327,964,7974
67835,3019,3000,3015,3105,2984,2933,2954,21010
67836,113,122,107,109,131,108,147,837
67837,889,890,970,934,915,1029,903,6530
67838,1092,1062,1125,938,726,767,982,6692
67839,1288,1279,1292,1251,1325,1230,1416,9081
67840,95,84,112,49,57,84,103,584
67841,322,428,454,410,460,426,339,2839
67842,445,556,576,597,491,562,427,3654
67843,205,215,162,189,178,198,165,1312
67844,793,670,676,736,738,709,894,5216
67846,33726,33900,33959,33720,33588,33400,33696,235989
67849,477,449,480,486,439,381,380,3092
67850,449,428,376,368,334,270,335,2560
67851,2778,2787,2519,2577,2526,2324,2691,18202
67853,732,881,988,1004,948,856,860,6269
67854,1339,1373,1366,1364,1417,1455,1407,9721
67855,1787,1908,1956,1988,2028,2032,1976,13675
67857,163,128,84,105,93,37,174,784
67859,794,711,691,652,638,462,735,4683
67860,2703,2818,2706,2848,3120,3053,2878,20126
67861,1896,1908,1931,1884,1949,1984,1962,13514
67862,339,266,261,264,225,222,302,1879
67863,288,283,279,375,310,286,305,2126
67864,2096,2314,2282,2217,2239,2302,2227,15677
67865,1097,1068,1021,949,919,846,1081,6981
67867,1716,1577,1557,1596,1614,1707,1578,11345
67868,280,252,308,197,120,171,198,1526
67869,1529,1491,1567,1532,1448,1401,1492,10460
67870,1217,1429,1569,1787,1869,1932,1765,11568
67871,4970,4979,5042,5027,5029,5182,4973,35202
67876,1340,1176,1250,1068,1085,1173,1156,8248
67877,2606,2459,2273,2108,2023,1932,2255,15656
67878,2355,2336,2441,2431,2432,2517,2436,16948
67879,1235,1224,1223,1202,1234,1232,1247,8597
67880,7832,7888,7975,8039,7923,7926,7878,55461
67882,311,276,315,382,443,453,346,2526
67901,22336,22419,22499,22353,22302,22243,22073,156225
67950,2348,2434,2582,2629,2584,2622,2558,17757
67951,4909,5032,4964,4827,4781,4730,4981,34224
67952,695,658,697,793,826,769,710,5148
67953,164,150,151,160,157,99,144,1025
67954,636,611,517,522,580,610,661,4137
68001,105,142,154,94,123,87,77,782
68002,2351,2173,1982,1859,2063,2066,2150,14644
68003,4757,4623,4450,4368,4111,4177,4284,30770
68004,909,868,837,809,862,833,885,6003
68005,23202,24082,24203,24163,23949,23493,22132,165224
68007,9247,8974,7548,7649,7123,6682,7612,54835
68008,12208,12360,12233,12173,12364,12537,12285,86160
68010,907,913,914,906,881,870,745,6136
68014,345,277,314,325,316,308,287,2172
68015,1068,1021,1183,1191,1134,1106,1151,7854
68016,438,419,434,393,369,358,413,2824
68017,1535,1541,1451,1351,1413,1514,1692,10497
68018,623,573,514,536,531,470,516,3763
68019,501,483,465,511,583,606,550,3699
68020,577,657,756,814,905,784,749,5242
68022,20065,19763,17071,16310,16134,15145,16422,120910
68023,2311,2232,2377,2178,2049,2161,2536,15844
68025,30030,30299,30151,30095,30136,30307,30376,211394
68028,12326,11814,11860,11303,10716,9927,10839,78785
68029,845,880,917,936,894,794,899,6165
68030,746,832,767,799,772,755,835,5506
68031,1762,1789,1748,1884,1812,1733,1745,12473
68033,332,359,414,465,450,412,392,2824
68034,981,981,1140,1167,954,848,886,6957
68036,256,282,451,465,500,467,402,2823
68037,2078,2001,2038,2072,2314,2412,2286,15201
68038,1342,1292,1234,1242,1232,1333,1280,8955
68039,1249,1231,1230,1220,1220,1251,1421,8822
68040,432,577,547,423,601,528,369,3477
68041,1166,1116,1121,1023,939,866,955,7186
68042,98,93,101,100,128,142,122,784
68044,544,635,562,497,647,640,724,4249
68045,1910,1922,1924,1923,1954,1863,1801,13297
68046,27073,26876,27434,27000,26274,24876,25191,184724
68047,1779,1756,1735,1800,1758,1681,1614,12123
68048,12852,12908,12676,12621,12580,12102,12422,88161
68050,778,681,586,784,859,787,609,5084
68055,312,335,320,303,338,351,341,2300
68057,1540,1579,1589,1535,1496,1557,1544,10840
68058,382,352,313,322,286,277,252,2184
68059,3107,2864,2603,2933,2965,2958,3158,20588
68061,2264,2330,2373,2330,2324,2330,2504,16455
68062,297,337,318,336,321,278,311,2198
68063,226,258,300,313,286,292,234,1909
68064,3171,3285,3121,3257,3224,3272,3376,22706
68065,1755,1478,1605,1484,1228,1244,1510,10304
68066,5593,5514,5185,5205,5106,5259,5640,37502
68067,1280,1252,1245,1193,1241,1296,1288,8795
68068,67,52,51,60,68,59,127,484
68069,2944,2896,2511,2595,2373,2317,2558,18194
68070,713,810,809,1014,947,853,836,5982
68071,2100,2091,2091,2062,2006,1975,1934,14259
68072,53,26,21,21,19,16,66,222
68073,1817,1811,2004,2014,1959,1963,1960,13528
68102,6877,6325,6108,6102,5767,5395,6102,42676
68104,35565,35330,35482,35146,35516,36561,34664,248264
68105,23742,25014,24726,24803,24564,23024,23842,169715
68106,20501,20439,20509,20615,19769,19820,19936,141589
68107,32637,31548,30648,29657,28069,28055,29491,210105
68108,15312,14974,15498,14286,14677,13943,14664,103354
68110,9169,8950,8910,9245,8740,8174,9173,62361
68111,21074,21623,22558,22922,22165,21988,23393,155723
68112,11440,10820,11064,10930,11699,12087,11508,79548
68113,694,741,831,1096,1232,1215,994,6803
68114,17467,17497,17569,17262,17011,17222,16928,120956
68116,29666,29284,26975,26561,25618,24414,25429,187947
68117,8617,8663,8249,8357,8535,8659,8032,59112
68118,9572,9078,9260,9207,9358,9345,9389,65209
68122,11343,11261,10949,11452,10729,10044,9794,75572
68123,30952,30101,28275,27583,26510,26184,27926,197531
68124,15669,15599,16136,15532,15740,15823,15690,110189
68127,22313,21064,22495,21496,21511,21191,21117,151187
68128,18737,18424,19071,18449,17892,17326,17784,127683
68130,20262,19738,19185,18339,17699,17443,17972,130638
68131,12948,12732,13551,13317,13269,13340,12302,91459
68132,15065,14402,14623,14457,14054,14012,14101,100714
68133,10953,10597,10067,9995,9739,9777,9703,70831
68134,29516,29790,29838,29807,30026,29553,28257,206787
68135,27576,27671,25740,26403,26269,25729,25875,185263
68136,16661,15133,14001,13852,13472,13002,13829,99950
68137,25651,25471,24952,24538,24241,24161,24921,173935
68138,12421,12262,11637,11292,11869,11628,12013,83122
68142,3440,3332,2957,3212,3290,3544,3072,22847
68144,23764,24242,25496,24347,24304,24904,24233,171290
68147,11098,11168,11180,10339,10453,10910,10351,75499
68152,6275,5960,5825,6010,6026,6196,5837,42129
68154,22599,22698,22657,22540,22917,22441,22692,158544
68157,5894,5832,5451,5204,4621,4682,5213,36897
68164,28155,27571,27340,27399,26982,26706,27387,191540
68178,1533,1532,1434,1334,1323,1184,1573,9913
68301,1364,1364,1427,1390,1304,1514,1466,9829
68303,294,245,240,264,250,238,289,1820
68304,390,381,353,261,237,263,330,2215
68305,4130,4193,4156,4209,4242,4224,4389,29543
68307,404,325,393,457,618,677,515,3389
68309,100,101,92,90,86,91,121,681
68310,13927,14122,14273,14322,14549,14599,14546,100338
68313,764,821,939,969,1038,1237,900,6668
68314,642,693,637,449,375,322,351,3469
68315,88,95,76,80,75,87,129,630
68316,408,435,361,384,350,433,447,2818
68317,1758,1632,1564,1531,1499,1532,1495,11011
68318,488,439,490,461,429,528,526,3361
68319,753,632,673,612,650,592,552,4464
68320,392,412,385,369,324,332,369,2583
68321,307,358,435,304,296,284,311,2295
68322,450,395,487,491,472,455,440,3190
68323,274,296,225,244,183,235,315,1772
68324,121,135,82,147,115,146,174,920
68325,195,186,185,160,162,148,232,1268
68326,319,281,330,247,263,198,241,1879
68327,276,266,271,295,335,308,299,2050
68328,541,462,423,504,459,483,429,3301
68329,563,597,539,583,642,707,673,4304
68331,991,994,1064,1016,966,923,961,6915
68332,119,107,86,108,109,108,146,783
68333,8832,8844,8591,8438,8413,8246,8327,59691
68335,513,467,443,454,471,544,518,3410
68336,435,349,349,377,377,397,557,2841
68337,285,313,294,261,316,224,383,2076
68338,331,384,405,374,346,404,324,2568
68339,1266,1204,1191,1238,1276,1217,1311,8703
68340,819,854,875,1007,1067,1229,992,6843
68341,1068,965,925,1080,989,928,1041,6996
68342,434,429,459,464,583,610,530,3509
68343,916,915,1051,940,877,1014,1050,6763
68344,499,485,449,462,516,465,441,3317
68345,249,281,307,294,302,362,269,2064
68346,511,478,515,551,412,580,493,3540
68347,2643,2329,2545,2341,2361,2518,2570,17307
68348,339,352,271,236,204,246,256,1904
68349,1031,1151,1022,1182,1209,1304,1098,7997
68350,191,220,258,247,232,238,216,1602
68351,803,850,886,874,889,856,853,6011
68352,5111,5205,5097,5157,5220,5270,5222,36282
68354,943,851,794,750,711,748,839,5636
68355,5165,5254,5205,5125,5019,4959,5113,35840
68357,359,355,366,353,326,380,421,2560
68358,1923,1815,1744,1764,1797,1672,1877,12592
68359,1715,1721,1595,1603,1568,1393,1585,11180
68360,558,570,519,477,452,353,501,3430
68361,2336,2527,2430,2507,2592,2430,2573,17395
68362,115,104,101,94,25,22,46,507
68364,111,84,85,78,74,57,142,631
68365,308,176,173,250,260,311,245,1723
68366,1187,1221,1284,1289,1129,1011,1047,8168
68367,399,415,451,451,490,488,461,3155
68368,437,471,470,384,393,393,485,3033
68370,2086,2238,2144,2009,2036,1978,2075,14566
68371,1476,1448,1407,1499,1435,1538,1467,10270
68372,2941,3282,3293,3214,3052,2932,2827,21541
68375,168,200,205,239,176,170,121,1279
68376,1419,1384,1486,1503,1460,1561,1445,10258
68377,414,387,407,525,498,397,425,3053
68378,670,608,717,752,801,834,680,5062
68379,61,73,66,71,40,62,59,432
68380,88,115,100,93,179,137,81,793
68381,238,216,202,232,277,282,249,1696
68382,34,45,62,67,50,42,41,341
68401,783,759,687,637,625,559,717,4767
68402,1380,1323,1259,1201,1242,1093,1210,8708
68403,177,192,212,210,207,153,206,1357
68404,880,1006,988,1045,1099,1053,902,6973
68405,3532,3466,3413,3400,3448,3304,3257,23820
68406,460,504,551,573,548,570,458,3664
68407,567,644,683,649,741,773,747,4804
68409,778,673,698,764,803,889,807,5412
68410,8657,8739,8728,8817,8692,8670,8716,61019
68413,606,631,577,524,493,657,533,4021
68414,270,267,251,237,223,246,256,1750
68415,722,684,669,640,698,738,649,4800
68416,254,255,275,214,206,300,226,1730
68417,284,323,289,284,324,313,292,2109
68418,1298,1287,1188,1054,1065,951,1070,7913
68419,262,284,272,264,290,311,256,1939
68420,1380,1265,1309,1333,1241,1242,1285,9055
68421,1198,1131,1085,1119,1129,1139,1107,7908
68422,476,457,536,463,455,352,513,3252
68423,1035,969,895,910,855,831,898,6393
68424,749,728,774,721,629,639,730,4970
68428,1178,1415,1523,1357,1406,1432,1375,9686
68430,1569,1448,1377,1512,1553,1573,1402,10434
68431,294,304,290,294,303,344,353,2182
68433,185,184,157,271,346,323,265,1731
68434,8397,8275,8317,8388,8379,8398,8576,58730
68436,540,574,577,543,540,516,581,3871
68437,266,239,217,216,243,252,261,1694
68438,131,142,133,126,174,189,142,1037
68439,499,547,593,659,589,708,478,4073
68440,115,98,118,113,118,122,110,794
68441,199,284,350,334,329,315,302,2113
68442,359,347,302,358,438,360,313,2477
68443,968,1003,1015,1167,1165,1143,1047,7508
68444,64,50,43,51,72,75,97,452
68445,102,96,95,99,105,76,152,725
68446,2828,2754,2779,2619,2601,2586,2690,18857
68447,489,481,477,490,498,500,464,3399
68448,483,422,444,430,338,318,399,2834
68450,3179,3161,3283,3126,3159,3082,3182,22172
68452,96,105,98,117,117,80,86,699
68453,267,319,361,379,416,477,304,2523
68454,503,538,653,653,814,738,625,4524
68455,543,601,537,570,486,573,681,3991
68456,1114,1110,1121,1058,1096,1021,1127,7647
68457,251,301,392,397,381,444,343,2509
68458,166,169,172,160,164,162,135,1128
68460,795,786,869,900,905,899,788,5942
68461,607,561,531,521,374,414,734,3742
68462,4457,4346,4229,4002,4017,3866,3827,28744
68463,1434,1501,1475,1593,1490,1464,1517,10474
68464,510,514,524,468,490,449,478,3433
68465,2199,2160,2313,2481,2468,2618,2404,16643
68466,1778,1844,1751,1887,1928,1886,1861,12935
68467,9311,9409,9345,9334,9302,9439,9338,65478
68502,26402,25821,25629,26156,26268,26076,26238,182590
68503,15804,15764,15940,15410,15014,15108,15264,108304
68504,17347,16797,16736,16336,16374,16167,16444,116201
68505,17009,16718,16130,15634,14815,15135,15137,110578
68506,28772,28849,28597,27995,28036,28058,27952,198259
68507,13909,13725,13771,13456,13777,13446,13429,95513
68508,15274,14854,15226,14340,14386,14181,14475,102736
68510,21710,21942,21189,20381,20740,20672,20514,147148
68512,12944,12584,12044,11875,11542,11149,11659,83797
68514,122,194,217,244,152,178,127,1234
68516,40332,39586,38898,39683,38965,38269,38956,274689
68517,645,629,692,550,666,544,538,4264
68520,1328,1257,1229,989,969,925,1143,7840
68521,34464,34446,33589,33692,32618,32132,31733,232674
68522,13299,13313,12778,12693,12749,12283,12728,89843
68523,1383,1371,1370,1361,1432,1431,1390,9738
68524,6195,6060,5974,6250,6158,6172,5983,42792
68526,6115,5676,5236,5071,4570,4242,4800,35710
68527,945,882,684,964,905,772,696,5848
68528,6758,6703,7158,6460,6625,6693,6285,46682
68531,44,54,13,72,86,89,48,406
68532,807,812,815,896,639,528,493,4990
68601,28179,28211,28192,27824,27646,27334,28185,195571
68620,2782,2825,2747,2836,2886,2935,2967,19978
68621,557,460,518,452,507,522,517,3533
68622,316,314,351,296,271,273,275,2096
68623,271,266,288,305,295,252,313,1990
68624,958,1194,1181,1218,1299,1138,1062,8050
68626,615,678,649,663,684,752,614,4655
68627,709,577,598,625,618,586,622,4335
68628,838,846,853,941,901,831,826,6036
68629,1381,1465,1496,1492,1307,1356,1344,9841
68631,424,515,507,480,565,615,480,3586
68632,4061,3974,3988,3774,3710,3772,3989,27268
68633,1259,1328,1243,1355,1504,1452,1179,9320
68634,484,451,381,349,347,379,345,2736
68635,434,380,400,414,374,431,491,2924
68636,1221,1154,1052,1022,973,1038,1254,7714
68637,339,330,264,285,223,221,267,1929
68638,1824,1751,1763,1746,1807,1832,1749,12472
68640,1484,1530,1573,1592,1546,1592,1613,10930
68641,1058,1012,1028,1100,1082,1050,1063,7393
68642,1867,1869,1787,1744,1814,1743,1721,12545
68643,1116,998,1006,931,915,958,903,6827
68644,811,781,836,893,749,663,721,5454
68647,654,644,541,557,467,551,646,4060
68648,375,526,530,438,507,559,484,3419
68649,2020,1879,1949,1962,1878,1863,1835,13386
68651,1415,1420,1384,1467,1445,1430,1470,10031
68652,616,701,807,825,759,782,715,5205
68653,780,766,836,1020,1058,896,783,6139
68654,495,495,525,471,464,433,541,3424
68655,163,138,159,107,131,127,159,984
68658,724,631,606,758,679,709,683,4790
68659,102,130,149,156,229,268,215,1249
68660,1173,1313,1230,1196,1257,1238,1137,8544
68661,7207,7163,7050,7074,7133,7074,7282,49983
68662,1242,1216,1216,1119,1157,1183,1231,8364
68663,775,741,736,607,515,652,761,4787
68664,353,348,357,338,342,347,300,2385
68665,971,969,915,896,909,896,940,6496
68666,1557,1549,1659,1720,1767,1815,1611,11678
68667,125,134,140,152,136,106,92,885
68669,431,398,368,400,417,461,422,2897
68701,30370,30660,30496,30292,30266,29956,30670,212710
68710,823,844,752,689,761,801,830,5500
68711,294,240,192,258,236,260,141,1621
68713,2230,2267,2142,2112,2070,2124,2212,15157
68714,1212,1163,1202,1217,1263,1327,1224,8608
68715,1559,1445,1455,1336,1419,1486,1446,10146
68716,943,932,876,878,819,814,1011,6273
68717,221,207,195,197,202,183,198,1403
68718,1678,1724,1726,1879,1924,1901,1765,12597
68719,117,107,82,89,122,129,146,792
68720,247,259,240,335,396,402,340,2219
68722,563,617,590,584,577,658,555,4144
68723,469,509,479,513,617,713,566,3866
68724,99,134,158,157,131,152,140,971
68725,446,449,445,452,522,476,501,3291
68726,746,840,902,850,840,829,893,5900
68727,860,831,831,848,879,855,730,5834
68728,217,220,234,251,273,258,254,1707
68729,1939,1870,1846,1995,1968,1973,1745,13336
68730,1800,1801,1976,1868,1699,1838,1860,12842
68731,2829,3101,3057,2764,2909,2797,2637,20094
68732,139,160,209,234,222,246,260,1470
68733,1532,1409,1267,1289,1257,1288,1286,9328
68734,92,127,124,156,146,209,155,1009
68735,806,872,1058,1020,1149,1109,922,6936
68736,617,635,707,667,670,667,726,4689
68739,2983,2898,2710,2744,2753,2944,3002,20034
68740,944,851,867,661,646,694,892,5555
68741,726,758,828,853,707,742,790,5404
68742,112,195,181,173,185,254,243,1343
68743,739,671,730,659,681,750,693,4923
68745,1648,1702,1786,1853,1796,1647,1572,12004
68746,382,436,501,487,417,397,480,3100
68747,179,144,170,132,132,173,174,1104
68748,3273,3213,3376,3563,3573,3536,3260,23794
68749,50,56,43,31,34,28,65,307
68751,75,76,111,106,101,110,76,655
68752,714,816,857,835,892,1014,789,5917
68753,85,55,41,50,53,65,111,460
68755,275,216,271,303,303,330,259,1957
68756,1869,1907,1945,2003,2094,2065,2058,13941
68757,828,817,865,743,754,772,754,5533
68758,1168,1084,1042,961,928,958,1164,7305
68759,239,265,288,234,305,266,295,1892
68760,1388,1405,1381,1423,1490,1401,1364,9852
68761,354,380,445,452,503,553,434,3121
68763,4864,4822,4849,4977,4818,4747,4887,33964
68764,785,715,706,702,629,593,753,4883
68765,1421,1451,1406,1426,1379,1288,1380,9751
68766,491,438,493,428,395,388,393,3026
68767,3255,3459,3367,3296,3374,3383,3174,23308
68768,601,592,598,688,666,668,642,4455
68769,1577,1437,1471,1585,1575,1755,1806,11206
68770,1474,1538,1606,1585,1697,1585,1552,11037
68771,1426,1390,1428,1459,1558,1496,1637,10394
68773,158,168,184,180,204,226,173,1293
68774,253,272,302,343,325,253,348,2096
68776,14912,14796,14899,15206,15185,15255,15447,105700
68777,745,729,686,678,648,646,774,4906
68778,541,518,532,499,546,558,572,3766
68779,2685,2563,2584,2687,2715,2729,2433,18396
68780,1059,1057,1064,1045,1089,1039,1028,7381
68781,1621,1582,1613,1562,1345,1385,1407,10515
68783,1010,1058,979,933,1027,985,1086,7078
68784,2010,2039,2207,2309,2218,2074,2104,14961
68785,350,272,214,196,166,194,274,1666
68786,1087,1091,1069,1014,998,972,1079,7310
68787,6546,6673,6646,6736,6565,6504,6647,46317
68788,4691,4770,4972,5116,5112,5220,4898,34779
68789,157,171,177,152,144,168,176,1145
68790,801,741,728,845,915,931,777,5738
68791,1776,1808,1865,1794,1722,1755,1800,12520
68792,357,390,412,342,334,377,407,2619
68801,30518,30941,30953,30923,31357,29959,30005,214656
68803,24133,23309,22818,22312,21552,21791,22560,158475
68810,1039,1114,1143,1322,1108,1026,1109,7861
68812,646,641,720,769,739,680,785,4980
68813,520,565,562,563,518,577,534,3839
68814,826,912,979,1000,1051,1043,911,6722
68815,572,597,546,654,626,666,596,4257
68816,241,200,238,144,179,238,180,1420
68817,269,280,294,289,357,394,386,2269
68818,5247,5280,5317,5289,5322,5385,5475,37315
68820,331,272,380,398,411,452,391,2635
68821,123,100,89,75,75,109,134,705
68822,4559,4642,4699,4609,4451,4419,4834,32213
68823,2183,2167,2217,2260,2434,2551,2401,16213
68824,1487,1486,1375,1251,1297,1379,1414,9689
68825,1141,1137,1141,1061,1230,1153,1024,7887
68826,3943,3989,3894,3965,3948,3826,3955,27520
68827,528,548,589,700,668,747,693,4473
68828,358,310,274,214,199,209,240,1804
68831,764,723,714,745,823,864,812,5445
68832,2226,2164,2079,2005,1939,1935,1974,14322
68833,452,446,469,446,422,430,299,2964
68834,192,309,376,354,315,299,226,2071
68835,497,501,498,426,589,576,485,3572
68836,1594,1590,1576,1640,1809,1712,1688,11609
68837,134,134,71,53,47,53,103,595
68838,275,260,245,241,270,264,301,1856
68840,3261,3012,2721,2847,2651,2496,2945,19933
68841,612,637,680,690,633,667,610,4529
68842,515,567,606,653,769,809,668,4587
68843,868,828,849,734,742,811,806,5638
68844,224,220,193,265,240,235,228,1605
68845,20810,20171,20971,21039,20575,20664,19523,143753
68846,342,343,386,362,297,258,296,2284
68847,16696,17277,16773,16312,16197,16101,16504,115860
68849,747,717,318,314,317,339,384,3136
68850,12029,11934,12070,12077,12231,12197,12295,84833
68852,733,697,711,712,830,627,565,4875
68853,1476,1538,1456,1496,1397,1573,1559,10495
68854,782,886,857,943,894,741,731,5834
68855,500,463,461,467,416,396,417,3120
68856,559,548,520,547,586,720,611,4091
68858,305,313,302,268,244,264,266,1962
68859,579,561,486,523,529,514,509,3701
68860,287,268,242,244,246,277,324,1888
68861,78,72,48,61,140,135,118,652
68862,3001,2994,3089,2949,3034,2878,3007,20952
68863,1436,1416,1380,1262,1205,1146,1151,8996
68864,1137,1267,1202,1295,1231,1235,1027,8394
68865,1047,923,789,829,905,979,894,6366
68866,914,884,824,900,871,859,850,6102
68869,2123,2041,2099,2110,2143,2039,2202,14757
68870,475,488,426,356,353,341,439,2878
68871,269,236,359,264,271,260,250,1909
68872,957,1002,956,910,935,867,853,6480
68873,3504,3453,3450,3329,3027,3040,3289,23092
68874,989,968,898,1027,1096,1052,956,6986
68875,702,678,709,698,576,575,658,4596
68876,1510,1516,1608,1454,1480,1495,1545,10608
68878,418,391,444,447,439,450,446,3035
68879,365,366,388,413,381,477,417,2807
68881,40,71,83,98,105,96,73,566
68882,339,396,438,512,504,440,473,3102
68883,2397,2477,2562,2337,2274,2467,2411,16925
68901,26202,26122,26191,26199,26291,26120,26354,183479
68920,1450,1398,1339,1293,1367,1470,1446,9763
68922,1214,1154,1145,1184,1303,1397,1336,8733
68923,96,104,109,107,108,140,131,795
68924,1059,1037,1002,1113,1150,1178,1180,7719
68925,616,593,600,644,468,472,474,3867
68926,818,893,898,910,793,794,783,5889
68927,1242,1254,1233,1291,1205,1282,1164,8671
68928,448,480,535,544,530,510,426,3473
68929,214,188,223,177,244,202,160,1408
68930,1539,1400,1348,1430,1423,1362,1461,9963
68932,441,404,426,340,389,347,493,2840
68933,874,912,954,969,935,1023,932,6599
68934,83,85,77,65,98,103,188,699
68935,725,792,759,946,799,784,750,5555
68936,393,361,372,235,100,148,243,1852
68937,1504,1689,1711,1781,1921,1937,1836,12379
68938,481,496,503,482,446,450,582,3440
68939,1171,1191,1145,1286,1339,1321,1318,8771
68940,642,647,561,532,509,410,496,3797
68941,754,734,927,868,915,1056,832,6086
68942,343,402,437,411,466,478,490,3027
68943,240,235,207,269,214,233,269,1667
68944,1202,1070,1156,1134,1079,1132,1323,8096
68945,433,388,422,394,437,320,213,2607
68946,33,39,53,120,131,98,53,527
68947,598,649,589,622,633,652,549,4292
68948,297,331,235,261,250,303,363,2040
68949,6524,6359,6424,6464,6496,6461,6567,45295
68950,475,446,357,323,305,259,331,2496
68952,87,112,99,94,92,146,172,802
68954,65,94,146,157,142,157,94,855
68955,2025,2091,1950,1987,1968,2028,2025,14074
68956,1329,1304,1281,1289,1323,1221,1215,8962
68957,637,726,684,598,644,650,631,4570
68958,640,691,671,633,660,656,661,4612
68959,3905,4011,3902,3753,3652,3546,4015,26784
68960,162,168,242,216,119,200,183,1290
68961,717,674,764,835,875,980,732,5577
68964,100,99,95,95,90,76,135,690
68966,652,640,688,758,779,781,674,4972
68967,1072,1169,1197,1300,1286,1077,1142,8243
68969,56,60,58,36,26,26,38,300
68970,1392,1382,1401,1426,1384,1379,1342,9706
68971,447,486,522,494,427,437,458,3271
68972,143,185,218,251,202,197,209,1405
68973,423,453,444,394,431,472,463,3080
68974,147,164,134,146,190,229,184,1194
68975,151,201,164,120,88,104,160,988
68976,364,256,255,198,258,284,316,1931
68977,372,354,334,330,335,340,342,2407
68978,2223,2261,2324,2159,2287,2216,2377,15847
68979,1984,1998,2054,2049,2211,2052,1888,14236
68980,419,371,388,449,444,499,388,2958
68981,363,303,313,248,245,241,314,2027
68982,717,771,749,654,661,777,649,4978
69001,9161,9341,9297,9142,9177,9196,9449,64763
69020,478,382,373,392,403,438,397,2863
69021,1284,1377,1404,1466,1384,1338,1348,9601
69022,1623,1540,1624,1575,1647,1604,1570,11183
69023,306,339,319,433,339,405,440,2581
69024,1320,1224,1290,1350,1299,1287,1195,8965
69025,1121,1204,1190,1082,1138,1192,1220,8147
69026,213,237,158,182,173,156,220,1339
69027,73,82,93,93,137,124,133,735
69028,776,642,680,844,866,870,731,5409
69029,408,365,361,378,341,288,316,2457
69030,250,383,309,302,379,414,324,2361
69032,479,550,507,466,455,455,498,3410
69033,2607,2470,2607,2521,2513,2445,2577,17740
69034,1041,994,1079,1140,1117,1132,908,7411
69036,60,47,29,42,32,55,126,391
69037,99,73,70,46,50,58,115,511
69038,486,531,498,524,512,571,449,3571
69039,51,63,50,65,88,62,139,518
69040,693,708,753,774,642,614,634,4818
69041,155,140,130,115,62,68,161,831
69042,66,69,64,63,33,44,36,375
69043,452,495,442,446,483,523,549,3390
69044,699,725,794,748,837,800,825,5428
69045,1228,1169,1181,1178,1265,1207,975,8203
69046,141,151,177,156,154,162,194,1135
69101,29525,29656,29813,29745,29848,29944,29904,208435
69120,1053,935,935,1025,907,928,931,6714
69121,392,406,446,479,449,401,400,2973
69122,685,741,745,729,665,631,619,4815
69123,861,865,824,919,925,906,935,6235
69125,426,462,432,409,444,386,346,2905
69127,922,954,1087,993,944,886,739,6525
69128,189,189,267,322,360,410,302,2039
69129,1259,1226,1247,1265,1334,1383,1368,9082
69130,5218,5262,5300,5411,5443,5408,5307,37349
69131,583,489,493,512,477,534,561,3649
69132,186,137,143,162,195,130,117,1070
69133,432,485,503,430,440,360,386,3036
69134,404,376,386,353,273,246,364,2402
69135,87,107,112,67,73,104,65,615
69138,4311,4548,4442,4313,4199,4284,4489,30586
69140,1846,1834,1766,1839,1918,2088,1775,13066
69141,374,300,306,308,295,323,385,2291
69142,94,98,113,93,124,95,137,754
69143,1301,1335,1285,1354,1311,1412,1460,9458
69144,76,180,169,208,185,221,202,1241
69145,3194,3158,3084,3143,3116,3162,3214,22071
69146,391,354,281,304,268,350,334,2282
69147,605,555,546,628,676,701,737,4448
69148,128,164,168,141,215,194,217,1227
69149,665,707,679,704,671,679,699,4804
69150,369,475,559,555,526,417,522,3423
69151,885,899,867,838,808,745,815,5857
69152,761,801,805,843,799,816,886,5711
69153,5509,5513,5425,5499,5557,5643,5769,38915
69154,1191,1199,1316,1340,1331,1356,1291,9024
69155,1069,980,1071,1004,1053,949,1034,7160
69156,689,669,687,637,676,815,699,4872
69157,30,21,20,21,29,19,21,161
69161,83,83,101,74,57,72,81,551
69162,7916,8037,7994,7972,8017,7783,7765,55484
69163,859,864,781,828,842,816,873,5863
69165,1889,1819,1924,1964,1863,1869,1789,13117
69166,651,688,680,682,768,736,600,4805
69167,336,334,323,278,249,299,441,2260
69168,246,200,203,178,187,165,271,1450
69169,635,621,599,605,679,657,651,4447
69170,307,346,389,338,376,356,372,2484
69171,8,11,11,11,38,32,26,137
69201,3997,3955,3999,3903,3877,3776,4005,27512
69210,2403,2465,2495,2478,2447,2452,2484,17224
69211,328,300,359,307,315,346,311,2266
69212,276,298,309,361,374,344,248,2210
69214,217,188,256,244,247,188,203,1543
69216,106,149,149,167,209,211,232,1223
69217,422,456,363,482,525,566,533,3347
69218,171,149,152,186,134,179,260,1231
69219,225,174,95,156,131,117,80,978
69220,17,26,39,56,42,36,59,275
69221,195,179,193,205,169,167,222,1330
69301,10064,10130,10289,10189,10154,10333,10125,71284
69331,23,24,37,33,40,18,59,234
69333,303,251,195,223,252,234,239,1697
69334,2226,2055,2103,2305,2314,2286,2351,15640
69335,25,19,22,5,18,37,53,179
69336,2332,2523,2521,2540,2560,2732,2466,17674
69337,7199,7121,7438,7390,7528,7501,7365,51542
69339,1606,1729,1506,1490,1384,1405,1462,10582
69340,142,222,197,171,185,168,121,1206
69341,10573,10628,10786,10734,10835,10921,11165,75642
69343,2382,2477,2477,2583,2480,2461,2538,17398
69345,505,501,504,546,510,419,455,3440
69346,628,581,609,516,491,548,592,3965
69347,1138,1156,1149,1113,1227,1269,1249,8301
69348,1564,1558,1419,1415,1512,1349,1503,10320
69350,355,359,284,307,334,395,383,2417
69351,227,151,139,129,113,111,235,1105
69352,734,769,817,760,772,778,619,5249
69353,26,14,15,18,10,15,37,135
69354,103,104,137,107,126,101,97,775
69355,173,129,138,159,136,93,115,943
69356,1820,1925,1975,1905,2028,1987,1882,13522
69357,3568,3592,3616,3609,3748,3881,3567,25581
69358,1880,1765,1638,1684,1616,1759,1907,12249
69360,1427,1341,1364,1451,1438,1465,1361,9847
69361,18068,18122,18112,18225,17910,17599,17999,126035
69365,73,56,24,21,31,51,44,300
69366,283,392,350,297,299,343,253,2217
69367,256,214,162,268,204,167,259,1530
70001,40519,39980,38969,38844,38019,37816,37996,272143
70002,19970,19092,18609,18453,18657,18760,18879,132420
70003,40982,40500,39774,39446,39449,40258,40150,280559
70005,25446,25213,25073,25071,24552,25014,24339,174708
70006,16684,16687,16146,16064,16355,14588,15703,112227
70030,3958,4208,4367,4674,4281,4504,4585,30577
70031,1349,1241,1362,1204,1239,1452,1316,9163
70032,4542,4544,4521,4305,3687,3372,3635,28606
70036,1075,976,1115,1057,1150,949,1227,7549
70037,16306,16272,16294,16412,16093,16408,15590,113375
70038,481,517,538,437,771,540,426,3710
70039,2299,1918,1882,2044,2202,1969,2460,14774
70040,928,1085,1194,1415,1677,1905,1604,9808
70041,2468,2470,2324,2153,1843,1684,2381,15323
70043,22345,21311,19375,18019,16663,14426,16760,128899
70047,12507,12447,12722,12943,13175,12934,13006,89734
70049,2483,2548,2187,2175,2455,2410,2481,16739
70050,53,29,22,14,18,0,74,210
70051,2063,1983,2000,1802,1881,1929,2518,14176
70052,3619,3598,3611,3677,3712,3712,3795,25724
70053,16272,16365,16621,16617,16554,16557,16499,115485
70056,41325,41068,39718,39917,38903,38379,39082,278392
70057,4879,4873,4321,4642,4593,4165,4719,32192
70058,38323,40026,40032,39499,39856,39068,39887,276691
70062,16225,16318,16460,17348,17242,16994,17095,117682
70065,52012,51986,52069,50989,50957,51356,51116,360485
70067,2644,2816,3179,3220,3094,3472,2757,21182
70068,33581,33577,33393,34192,34508,35214,34101,238566
70070,13046,13086,12698,12584,12567,13370,12471,89822
70071,3438,3454,3540,3599,3567,3613,3653,24864
70072,54578,54248,55812,56088,56307,57040,56344,390417
70075,5271,5116,5019,4527,4196,3838,4417,32384
70076,222,331,517,390,697,907,292,3356
70079,2948,2994,3044,3093,3110,3243,3067,21499
70080,1649,1575,1627,1041,1232,1439,1556,10119
70082,440,405,325,259,84,87,336,1936
70083,2601,2468,2535,2415,2445,2168,2353,16985
70084,6849,6738,7380,7419,7262,6720,7552,49920
70085,4738,4402,4407,4239,4174,4043,4427,30430
70086,2190,2174,2194,2383,2505,2418,1969,15833
70087,8427,8868,9125,8871,8861,8213,8122,60487
70090,7184,7625,7737,7767,7716,7633,7671,53333
70091,307,353,313,280,289,184,278,2004
70092,7195,7485,7792,7760,7227,6668,6651,50778
70094,30232,30306,31064,31549,32218,32905,31669,219943
70112,2749,2901,3054,3489,3452,3298,3655,22598
70113,8321,7841,8011,8154,6988,6911,7025,53251
70114,25867,25456,24996,25161,24794,24162,22870,173306
70115,33764,34775,34429,34633,34096,32501,31695,235893
70116,11595,11753,11936,12069,11644,11524,11507,82028
70117,24593,22963,22639,21488,20705,20716,23389,156493
70118,35671,36068,34939,33036,33797,32036,33008,238555
70119,36890,36626,36654,36558,35187,33827,36228,251970
70121,11399,11867,11877,11735,11945,11888,12029,82740
70122,36776,34778,32966,31187,29038,25598,28564,218907
70123,26706,26642,27008,26726,26574,26389,26475,186520
70124,20692,20781,19614,18546,16962,14709,16824,128128
70125,16752,17040,16597,16117,15967,15267,14479,112219
70126,25972,25139,25224,23327,21569,18600,23958,163789
70127,25866,25230,24436,22490,20329,18159,20471,156981
70128,19475,19681,19109,17911,16882,15506,17113,125677
70129,10251,10457,9934,9603,8806,8314,9064,66429
70130,14055,13743,14271,13870,12780,12287,14064,95070
70131,33633,31506,29662,29374,28411,27994,29915,210495
70139,0,0,0,0,0,0,0,0
70163,0,0,0,0,0,0,0,0
70301,44380,44529,44266,43699,43984,43922,43037,307817
70339,5663,5706,6066,5983,5933,6395,6033,41779
70340,146,275,148,214,183,144,109,1219
70341,4426,4285,4333,4369,4004,3884,4449,29750
70342,4880,4909,4950,4983,4930,4866,4979,34497
70343,5260,5090,5163,5115,4536,4997,5504,35665
70344,5715,6050,6592,6430,6551,6317,6143,43798
70345,9844,9955,9803,9421,9385,8763,9754,66925
70346,11595,11015,11155,11282,11131,11013,10925,78116
70352,156,148,239,207,177,229,205,1361
70353,1130,955,989,873,1133,973,1402,7455
70354,4683,4360,4342,4490,4506,4584,4931,31896
70355,998,1035,1059,1189,1153,1182,1041,7657
70356,1909,1912,1849,2265,2098,2294,2484,14811
70357,2441,2591,2948,3151,3479,4047,3043,21700
70358,812,1002,1002,854,874,877,1296,6717
70359,8835,9272,8965,8510,7781,7842,8408,59613
70360,28348,28143,27120,26718,27234,27102,26429,191094
70363,26642,26531,26723,27182,27779,26433,26513,187803
70364,30504,30339,30090,29909,30007,30116,30503,211468
70372,2527,2372,2421,2474,2655,2876,2518,17843
70373,6905,6834,6752,6633,6838,6394,7141,47497
70374,7024,7283,7411,7251,6657,7643,7125,50394
70375,70,46,133,131,137,122,125,764
70377,5387,4690,4835,4679,4619,4329,4403,32942
70380,22798,22485,22585,22591,22044,22337,22928,157768
70390,7254,7337,7314,7360,7730,7446,6969,51410
70391,104,129,204,246,301,312,202,1498
70392,8583,8455,8500,8433,8297,8180,8456,58904
70393,774,749,700,476,479,478,774,4430
70394,14878,14608,13944,14606,14540,14551,14328,101455
70395,5132,5200,5632,5112,4607,4351,4658,34692
70397,877,1192,969,1645,1301,1654,1365,9003
70401,18506,19508,20048,20681,21553,21190,20415,141901
70402,1911,1827,1295,1054,799,533,1514,8933
70403,28493,27783,26187,26041,26102,26596,26011,187213
70420,7735,7964,8403,9243,9229,8499,7345,58418
70422,15211,15881,14757,15082,14037,13607,13797,102372
70426,5987,6258,6486,6649,6663,6637,6342,45022
70427,19235,19817,19577,19880,20125,20701,20033,139368
70431,5748,5040,4633,4860,4692,4669,5366,35008
70433,35042,34323,32686,31031,31693,31267,31133,227175
70435,17797,18728,18425,17629,17136,16979,16603,123297
70436,513,539,505,679,709,564,629,4138
70437,9586,8955,8415,7927,7398,6676,7918,56875
70438,18507,17948,18006,17868,17575,17421,18540,125865
70441,4577,4791,4745,4796,5279,4777,5112,34077
70442,161,122,158,203,341,468,277,1730
70443,9291,9671,9502,9318,9573,9801,10232,67388
70444,10109,9551,9927,9745,9037,9523,10160,68052
70445,10114,10528,10375,10898,10232,10005,10840,72992
70446,7245,6941,6756,6357,6101,6065,5877,45342
70447,11984,10730,11040,10900,10625,10695,10150,76124
70448,25729,25136,25396,24901,24692,24156,24851,174861
70449,3428,3587,3742,3849,3853,3466,3611,25536
70450,2964,2893,3078,2955,3152,2769,2884,20695
70451,21,20,53,52,37,45,182,410
70452,11976,11214,11657,11667,11831,11953,13163,83461
70453,822,838,925,1059,1108,1270,1045,7067
70454,28767,27694,27690,26413,25461,24971,24954,185950
70455,772,956,1209,1229,1258,1154,1474,8052
70456,2346,2274,2851,2980,3255,3151,2850,19707
70458,37227,36710,36068,35971,35004,35454,35077,251511
70460,22970,23611,22166,22106,22464,22440,22096,157853
70461,28211,28396,28744,28194,28002,27220,27818,196585
70462,5695,5711,5715,5224,5157,5189,5699,38390
70463,195,221,227,115,53,67,126,1004
70464,655,658,718,623,638,580,312,4184
70465,784,598,506,661,563,472,776,4360
70466,9284,8560,8826,8670,8737,8434,8512,61023
70471,21952,21409,21523,21429,21186,21179,21383,150061
70501,31249,30221,30155,29360,29462,29451,31358,211256
70503,30867,29838,29071,28097,27577,27569,27816,200835
70506,43389,43589,44296,43797,43584,42464,41163,302282
70507,16994,17544,16617,16755,16013,16407,16558,116888
70508,37248,36907,36156,36238,35141,34496,34810,250996
70510,26137,26078,25850,25353,25473,24966,25313,179170
70512,10380,10790,10198,10199,10858,10860,9780,73065
70513,223,174,150,105,68,61,124,905
70514,2237,2309,2058,2188,2377,2436,2545,16150
70515,3389,3554,3865,3694,4098,4503,3838,26941
70516,615,751,692,1059,1433,1722,1546,7818
70517,27721,26569,26369,26453,25431,24580,26500,183623
70518,13675,13158,12921,12761,12154,11897,12297,88863
70519,178,218,228,132,151,323,222,1452
70520,19305,19005,19078,19164,18760,18706,18405,132423
70523,625,606,602,625,644,551,906,4559
70524,324,397,518,492,367,302,314,2714
70525,13900,13410,13669,13480,12930,12080,13150,92619
70526,19014,19330,19670,20062,19008,19014,19206,135304
70528,2612,2650,2659,2388,2520,2273,2333,17435
70529,11606,12034,11249,11564,11449,11612,11752,81266
70531,1350,1454,1319,1177,1210,1285,1261,9056
70532,2555,2542,2430,2720,2515,2644,2685,18091
70533,6977,6931,6723,6952,7046,7504,7385,49518
70534,1057,1083,916,1039,1043,1094,899,7131
70535,18162,17881,18277,18022,18459,18730,18215,127746
70537,562,473,594,550,556,592,541,3868
70538,13683,14106,14399,14767,15563,15538,14844,102900
70541,391,337,442,381,335,326,432,2644
70542,3667,3493,3539,3458,3738,3807,3435,25137
70543,4611,4511,4401,4304,4108,3568,4077,29580
70544,12286,11682,11661,11619,11837,11623,11677,82385
70546,16062,16045,16362,16119,16722,16768,16425,114503
70548,10888,9891,10249,10028,10315,10245,10353,71969
70549,4146,4191,4164,4125,3907,3978,3948,28459
70550,48,471,431,323,377,420,174,2244
70552,1802,1740,1854,1639,1599,1535,1819,11988
70554,5379,5868,5861,5832,5571,5415,5582,39508
70555,7876,8347,8274,8508,7691,7747,7372,55815
70556,346,318,391,278,292,444,331,2400
70558,0,0,0,93,112,143,134,482
70559,2629,2647,2566,2278,2591,2284,2943,17938
70560,41454,42450,42337,42529,42664,42729,42022,296185
70563,18589,18734,18610,18592,18419,18300,18502,129746
70570,38535,38363,38195,39387,40667,41089,38987,275223
70575,97,80,33,36,35,45,55,381
70576,1171,1239,1448,1633,1329,1473,1526,9819
70577,4389,4457,4367,4641,4699,4093,4645,31291
70578,17028,16603,16755,16425,16086,16642,16122,115661
70580,183,40,33,75,71,164,179,745
70581,767,711,590,817,617,803,929,5234
70582,18988,19391,19400,19483,19741,20392,19781,137176
70583,11450,11037,11219,10468,10756,10711,11693,77334
70584,7626,7907,8169,7534,7175,6785,7358,52554
70585,228,206,195,207,231,231,235,1533
70586,20377,20177,19796,19688,20131,19621,20313,140103
70589,3231,3198,3090,3011,3005,3249,3283,22067
70591,5607,5619,5347,5233,5546,5283,5299,37934
70592,22879,22467,20658,19749,19785,18552,18878,142968
70601,32441,32791,32108,31403,31251,31313,32384,223691
70605,35392,34830,34830,34320,34234,33405,32741,239752
70607,26298,26232,26005,26446,25818,24819,25560,181178
70611,20446,20320,20170,19313,18777,18968,19256,137250
70615,13501,12555,12954,12721,12838,13112,14335,92016
70630,1530,1246,1021,1231,1321,1703,1440,9492
70631,581,741,732,821,876,1469,962,6182
70632,617,575,604,425,355,311,371,3258
70633,7736,7086,7270,7449,7868,7726,7604,52739
70634,25723,25397,25294,24766,24595,24623,25125,175523
70637,664,710,614,785,718,894,654,5039
70638,840,864,936,866,842,696,937,5981
70639,516,493,531,578,540,446,684,3788
70640,288,369,297,303,254,322,301,2134
70643,192,254,194,326,280,323,352,1921
70644,191,233,242,218,160,248,308,1600
70645,1257,1211,1284,1265,1256,1362,1262,8897
70646,867,743,509,625,755,536,750,4785
70647,8724,8999,8742,8862,8645,8833,8703,61508
70648,8376,8259,8508,8535,8229,7976,8026,57909
70650,293,300,432,418,405,500,435,2783
70651,226,196,234,204,119,102,500,1581
70652,2252,2172,2338,2219,2082,2198,2203,15464
70653,3124,3131,3034,3056,2892,3010,3111,21358
70654,334,119,77,131,150,182,155,1148
70655,3180,3337,3519,3136,3273,3240,3002,22687
70656,3707,3782,3439,3569,4085,4108,4023,26713
70657,4984,5283,5255,5201,4630,4077,4315,33745
70658,1175,1086,1314,1263,1214,1119,955,8126
70659,1814,1565,1435,1407,1299,1356,1482,10358
70660,2132,2599,2880,3228,3600,3570,2612,20621
70661,2292,2474,2217,2189,2178,2279,2309,15938
70662,324,287,312,483,468,566,411,2851
70663,27437,27497,27962,28184,28195,27464,28150,194889
70665,11187,11155,11184,10933,11057,10983,10743,77242
70668,7080,7001,6789,6727,6723,6611,6424,47355
70669,10245,10142,10169,10024,10085,10115,10131,70911
70706,22702,21316,22041,22040,21809,22009,20752,152669
70710,4420,4194,4004,3812,3676,3530,3593,27229
70711,5125,5794,5578,5440,5583,5371,5266,38157
70712,3496,3852,4185,4446,4848,5332,479,26638
70714,20095,20042,19703,20194,20166,20082,19803,140085
70715,1483,1623,1582,1709,1334,1263,1433,10427
70719,4729,4549,4400,4409,4203,4260,4460,31010
70721,972,1065,857,1161,838,780,701,6374
70722,5671,5702,5937,6026,5752,6768,5713,41569
70723,1547,1936,1945,1884,1726,1701,1759,12498
70725,1716,1918,2124,1932,2001,1845,1826,13362
70726,54988,54813,53882,52962,52037,51219,50583,370484
70729,952,1065,976,986,1128,911,1032,7050
70730,3847,3841,3277,3686,3452,3358,3499,24960
70732,1178,1155,1079,1093,1030,979,1178,7692
70733,1648,1681,1602,1649,1732,1902,1621,11835
70734,7018,7332,7302,7207,7249,7244,7554,50906
70736,692,623,636,663,471,582,518,4185
70737,42200,41358,40679,39141,38135,37025,38643,277181
70739,14515,14284,14697,13844,13688,12586,12486,96100
70740,1451,1412,1355,1295,1500,1655,1305,9973
70743,105,171,235,215,200,271,350,1547
70744,6152,5572,5883,6099,5356,4808,6181,40051
70747,168,165,157,93,71,76,180,910
70748,6268,6322,6657,6440,6523,6035,6657,44902
70749,1609,1357,1614,1381,1223,1240,1554,9978
70750,1621,1605,1694,1598,1644,1592,1951,11705
70752,782,806,1013,970,975,830,806,6182
70753,1010,940,843,975,1353,1221,870,7212
70754,11543,10796,10121,9013,8766,8967,10170,69376
70755,2490,2339,2083,2221,2291,1949,2186,15559
70756,487,425,386,354,208,138,393,2391
70757,3060,3204,3196,3207,4000,3967,3177,23811
70759,1467,1281,1380,1368,1495,1675,1528,10194
70760,6163,6338,6589,6478,6496,7099,6993,46156
70761,548,684,728,951,1088,1051,897,5947
70762,808,880,767,732,782,758,926,5653
70763,4279,3701,3643,3539,3383,3686,3816,26047
70764,16604,16851,17492,17881,17335,17155,17584,120902
70767,14977,14947,15097,14864,14831,14960,14914,104590
70769,40014,39323,37709,37603,36601,35526,36084,262860
70770,2997,3030,2841,3543,3356,3308,2923,21998
70772,873,927,899,777,662,856,784,5778
70773,84,149,188,230,206,214,143,1214
70774,11370,11365,10785,10644,10673,10633,10076,75546
70775,11646,11106,10947,10705,10358,9852,14720,79334
70776,6003,5793,5824,5238,5502,5682,6043,40085
70777,4244,4403,4769,4600,4791,4356,4269,31432
70778,3243,2599,2704,2331,2101,2211,2291,17480
70780,1143,1104,1180,1293,1298,1054,1015,8087
70782,242,374,286,297,269,329,299,2096
70783,2641,2906,2676,2943,2804,2921,2604,19495
70785,21820,21932,21094,20861,20462,19855,20979,147003
70787,0,83,67,74,100,118,127,569
70788,4234,4243,3996,3975,4243,4100,4051,28842
70789,673,621,646,547,571,521,750,4329
70791,26709,26011,25462,24783,24659,24422,24918,176964
70801,32,33,13,10,9,8,13,118
70802,24988,26505,27780,27332,26737,26631,27267,187240
70803,1066,1085,1010,1057,936,1150,1335,7639
70805,28668,28968,29180,30474,30119,30466,29909,207784
70806,28211,28250,28269,28020,28253,28301,28706,198010
70807,19484,18984,19365,19910,20626,20914,20377,139660
70808,32360,31899,32448,32149,33223,33337,32504,227920
70809,24721,24399,23888,23397,23909,23890,25050,169254
70810,39064,38644,37335,37296,37064,36353,37980,263736
70811,12295,13082,13002,13647,14342,14584,13676,94628
70812,10930,10798,11195,11358,11328,11352,11206,78167
70814,15042,15520,15938,15321,14478,13790,14514,104603
70815,29212,29958,30142,29419,30382,31893,30075,211081
70816,43451,44051,43540,43144,43002,42248,43194,302630
70817,34414,32533,32441,32327,30598,30512,31192,224017
70818,9763,9828,9391,9536,9397,9816,9649,67380
70819,5429,4657,4696,4756,4891,4048,5040,33517
70820,21111,20713,19600,18708,17050,16206,17222,130610
70836,0,0,0,0,0,0,0,0
71001,4591,4482,4467,4579,4564,4386,4531,31600
71003,1130,1377,1260,1450,1463,1297,989,8966
71004,647,626,507,443,546,557,644,3970
71006,12300,12010,12410,12601,11939,11356,12158,84774
71007,1193,846,981,1158,1333,1091,1141,7743
71008,644,621,688,731,955,991,739,5369
71016,1912,1811,1659,1876,1883,2018,2070,13229
71018,1577,1390,1308,1317,1256,1370,1622,9840
71019,8656,8489,8508,8621,8682,8711,8555,60222
71021,693,524,470,617,597,581,772,4254
71023,3262,3185,3284,3250,3581,3633,3632,23827
71024,1776,1829,1823,1522,1441,1311,1420,11122
71027,1616,1839,2005,2145,2148,1649,1585,12987
71028,1491,1496,1574,1467,1486,1839,1666,11019
71029,128,149,162,130,147,200,219,1135
71030,1820,1719,1582,1478,1082,1090,1537,10308
71031,1355,1312,1248,1012,1006,1028,1064,8025
71032,1918,1884,1991,2017,1981,1828,2164,13783
71033,3414,3405,3416,3424,3329,3253,3510,23751
71034,294,377,367,354,413,389,313,2507
71037,18983,19564,20198,19425,19165,19143,19325,135803
71038,4337,4248,4118,4304,4547,4837,4064,30455
71039,1175,1692,1775,2194,2205,2307,1934,13282
71040,9270,8978,9127,8868,8786,8679,10268,63976
71043,623,628,633,729,672,603,546,4434
71044,690,646,655,632,625,580,657,4485
71045,590,587,858,829,788,716,663,5031
71046,1030,1317,1372,1491,1831,1897,1351,10289
71047,11177,11614,11205,11839,12196,12937,12203,83171
71048,52,81,65,95,128,84,104,609
71049,3066,3337,3469,3351,3119,3185,3460,22987
71051,2193,2501,2258,2732,2538,2742,2409,17373
71052,10120,10133,10264,10370,10224,10566,10259,71936
71055,19627,19900,20044,20291,20654,20534,20268,141318
71060,3300,2951,2871,2600,2410,2603,3089,19824
71061,1655,1650,1474,1415,1513,1708,1712,11127
71063,634,503,621,662,824,703,748,4695
71064,4053,4350,4278,4019,3897,4118,4096,28811
71065,1338,1201,1196,1199,1169,1356,1232,8691
71067,3687,3814,3296,3751,3701,3258,3297,24804
71068,3333,3537,3515,3512,3689,3489,3627,24702
71069,563,507,549,545,598,700,812,4274
71070,1964,2089,2065,2079,2048,2119,1833,14197
71071,2728,2882,2751,2922,2650,2521,2685,19139
71072,1393,1394,1343,1467,1330,1293,1530,9750
71073,2938,2744,2571,2195,2195,2265,2319,17227
71075,6318,6318,6756,6544,6540,6533,6416,45425
71078,6649,6224,5669,5361,5608,5730,5546,40787
71079,436,554,447,384,357,221,272,2671
71082,5510,5474,5392,4953,4895,4776,5119,36119
71101,7175,7688,8005,8737,8032,8508,8197,56342
71103,7969,8078,8270,8449,7673,7211,7813,55463
71104,14236,13591,13710,14466,15093,14948,14802,100846
71105,21822,22625,22844,22793,22299,21560,21907,155850
71106,35826,36106,35257,35163,34755,34316,34814,246237
71107,32301,32632,33704,34019,34475,33533,33800,234464
71108,19478,20100,19477,19036,18572,19893,20388,136944
71109,21975,21936,21336,21512,22215,22815,22154,153943
71110,4515,3854,3558,3129,2962,2764,2793,23575
71111,43211,41841,40700,39900,38999,38459,38456,281566
71112,32973,32625,32289,31483,31498,30926,31358,223152
71115,15889,15259,14602,14460,14342,13904,14506,102962
71118,25988,26128,27032,26102,26071,25417,24761,181499
71119,11492,11803,11957,12404,12463,12333,11562,84014
71129,12817,12808,14159,13164,13315,13012,13391,92666
71201,21079,20229,20107,19721,19957,19737,20319,141149
71202,31794,31873,32075,31078,30580,31061,29044,217505
71203,37793,37436,36536,36950,36563,36438,37105,258821
71209,183,166,119,113,96,142,154,973
71219,1162,1121,1071,1123,1175,1255,1288,8195
71220,22766,23119,23197,23428,23325,23652,23266,162753
71222,3271,3185,3512,3797,3569,3728,3481,24543
71223,302,379,357,374,424,457,523,2816
71225,7007,7078,7745,7900,7505,6690,7068,50993
71226,1871,1864,1896,1761,1783,1523,1638,12336
71227,4021,4216,4159,3673,3606,3495,3635,26805
71229,1476,1356,1551,1686,1970,1756,1662,11457
71232,6515,6475,6575,6506,6596,7065,6581,46313
71233,245,191,247,235,207,235,305,1665
71234,3855,4101,3877,3621,3496,3467,3992,26409
71235,4468,4247,4326,3974,3875,3886,4280,29056
71237,2272,2198,2091,2048,1973,1694,1578,13854
71238,3150,3339,3145,2365,2767,2972,2807,20545
71241,9747,9768,9826,9385,10034,9832,9982,68574
71243,203,173,158,114,145,155,194,1142
71245,4911,5011,4735,4620,4483,4412,4718,32890
71247,908,1027,1002,1102,1226,1064,1175,7504
71250,176,107,60,60,21,0,220,644
71251,9132,9122,8953,9169,9168,9252,9051,63847
71253,263,282,375,368,426,407,255,2376
71254,6694,6655,6535,6564,6449,6430,6759,46086
71256,696,831,857,882,972,1091,688,6017
71259,1586,1734,1825,1936,1790,1680,1697,12248
71260,3181,3294,3399,3584,3861,3735,3177,24231
71261,1239,1376,1428,1437,1423,1417,1684,10004
71263,7923,7803,7933,7926,7853,8321,8275,56034
71264,1231,1137,1174,1095,1136,1052,1045,7870
71266,1149,1386,1467,1572,1678,1460,1699,10411
71268,2317,2300,2669,2486,2358,2278,2819,17227
71269,13049,12948,12872,12809,12671,12498,12757,89604
71270,31123,30986,30931,31181,30816,30977,30887,216901
71272,1686,1677,1818,1985,2175,2372,1893,13606
71275,2648,2732,2577,2673,2553,2407,2453,18043
71276,206,275,269,357,434,462,289,2292
71277,2068,1937,1743,1736,1412,1514,1758,12168
71279,66,72,69,66,70,0,45,388
71280,4036,3678,3670,3424,3246,3186,3647,24887
71282,10925,11030,11099,11222,11153,11063,11070,77562
71286,486,528,605,529,680,800,615,4243
71291,31873,32657,32517,34018,33803,33306,32644,230818
71292,20105,20079,20447,19974,19821,20357,21541,142324
71295,14281,14472,14803,14624,14517,14715,14343,101755
71301,22981,22941,23128,22796,22830,22709,22859,160244
71302,14847,15442,15632,15682,15647,15592,15049,107891
71303,22119,21684,21258,20766,20376,19982,21015,147200
71316,39,41,17,27,73,102,37,336
71322,6957,6810,7032,6994,6888,6905,6969,48555
71323,1029,950,842,958,958,1017,989,6743
71325,1223,1149,1232,1410,1337,1386,1321,9058
71326,972,932,1110,1109,1004,1220,1164,7511
71327,6172,6055,5911,6315,5942,5876,5454,41725
71328,7257,7176,7617,7637,7843,7967,7414,52911
71331,1037,1130,1025,841,919,741,1036,6729
71333,550,661,619,681,799,826,666,4802
71334,9937,9836,9765,9747,10080,9597,9839,68801
71336,1314,1366,1354,1361,1516,1443,1650,10004
71339,173,12,35,141,160,147,130,798
71340,1614,1675,1683,1612,1802,1819,1710,11915
71341,3004,3027,3326,2874,3672,3333,3069,22305
71342,7817,7763,8222,8516,8322,8265,7533,56438
71343,7312,7711,7755,7752,7706,7734,7678,53648
71345,39,89,99,124,113,145,69,678
71346,2856,3031,3068,2688,2697,2867,3040,20247
71350,4615,4552,4257,3971,3409,3440,4124,28368
71351,10483,10537,10957,11031,10838,10764,11502,76112
71353,1973,2021,1686,1646,1589,1625,1664,12204
71354,1744,1748,1830,1854,1739,1997,1699,12611
71355,2760,3028,3043,3387,3419,3433,2764,21834
71356,973,685,835,812,705,797,648,5455
71357,2032,2055,2328,2291,2462,2531,2149,15848
71358,1157,1241,1244,1018,849,782,1111,7402
71360,36005,35885,35132,34973,35443,35248,35361,248047
71362,1592,1662,1709,1813,2024,2107,2169,13076
71366,1523,1626,1569,1595,1669,1733,1974,11689
71367,1688,1611,1313,1190,1108,1270,1278,9458
71368,1442,1278,1489,1525,1538,1394,1459,10125
71369,2834,2897,2773,2669,2842,2986,3222,20223
71371,2244,2187,1753,1627,1639,1679,2151,13280
71373,6867,6994,6918,7069,7018,7125,7358,49349
71375,1238,1212,1111,1219,1058,1035,1129,8002
71377,84,93,109,78,51,47,112,574
71378,2407,2409,2320,2567,2560,2365,2536,17164
71401,215,222,87,0,0,0,117,641
71403,4491,4239,4403,4514,4721,4491,4584,31443
71404,643,570,564,588,651,824,797,4637
71405,6173,5979,5667,5687,5799,5808,5592,40705
71406,178,195,426,367,362,320,216,2064
71407,763,877,753,653,667,1056,933,5702
71409,6083,5956,6345,6769,6736,6952,6874,45715
71410,130,141,118,134,94,94,124,835
71411,2979,2696,2549,2757,2798,2753,2875,19407
71414,144,159,145,171,186,154,238,1197
71416,842,1010,974,988,1020,1046,842,6722
71417,4859,4799,4414,4717,5153,4762,4932,33636
71418,6409,6410,6164,6289,6512,6623,6295,44702
71419,2354,2617,2710,2694,2531,2774,2444,18124
71422,1777,1745,1560,1616,1589,1428,1542,11257
71423,5069,4828,4820,4932,4632,4845,4538,33664
71424,930,1327,1411,1610,1601,1909,1225,10013
71425,258,235,254,296,124,176,214,1557
71426,261,245,183,207,210,262,229,1597
71427,293,224,147,228,298,394,413,1997
71429,2723,2527,2478,2501,2568,2750,3179,18726
71430,2972,2917,3017,3485,2764,2492,2576,20223
71432,1238,1253,1242,1085,1295,1115,1053,8281
71433,4300,4254,4230,4078,3913,3873,4367,29015
71435,3567,3557,3775,3896,3947,4052,3979,26773
71438,1675,1672,1591,1363,1416,1450,1626,10793
71439,1740,1683,1584,1729,1731,1849,1897,12213
71441,640,628,570,536,523,448,618,3963
71446,23550,24102,23905,23446,23082,21855,22762,162702
71447,1694,1371,1301,1309,1249,996,1469,9389
71449,9628,9651,9727,9455,9446,9267,9696,66870
71450,1162,1194,1037,1269,1329,1340,1070,8401
71452,97,88,37,37,42,33,57,391
71454,2342,2249,2496,2780,2639,2535,2527,17568
71455,87,119,100,270,256,236,227,1295
71456,1062,1011,899,902,990,1007,1223,7094
71457,27492,27718,28313,27634,27356,27668,27809,193990
71459,11625,12075,12247,12356,11631,11755,11902,83591
71461,2355,2337,2507,2568,2558,2617,2577,17519
71462,1428,1343,1377,1222,1016,1029,1432,8847
71463,10188,10239,10129,10155,10331,10629,10801,72472
71465,2743,2973,2940,2857,2975,2852,3139,20479
71466,867,501,523,750,555,355,591,4142
71467,7780,7884,8072,7643,7241,7245,7998,53863
71468,1026,982,911,886,917,868,868,6458
71469,2303,2835,2889,3022,3108,3006,2792,19955
71472,287,305,330,80,183,405,287,1877
71473,443,420,308,389,455,385,495,2895
71474,533,716,827,731,692,760,663,4922
71479,832,734,699,709,610,665,738,4987
71480,1194,1119,1119,1124,1226,1326,1324,8432
71483,10265,10500,11033,11237,11612,11734,11294,77675
71485,1848,2001,2213,2289,2085,2179,1804,14419
71486,5828,5721,5629,5824,5909,5476,4940,39327
71601,15416,16596,17269,17718,17252,17472,17327,119050
71602,16110,16249,16153,16472,17430,17689,17982,118085
71603,32376,32448,33058,34047,34785,35251,34343,236308
71630,590,572,573,553,489,434,405,3616
71631,451,489,594,652,666,624,673,4149
71635,12306,12021,12545,12463,12601,12610,12348,86894
71638,3650,3598,3696,3714,3754,3740,3794,25946
71639,5838,6003,6027,6090,6106,6106,6579,42749
71640,2929,3231,3154,3465,3437,3665,3227,23108
71642,707,639,595,508,648,677,648,4422
71643,930,975,1204,1413,1801,1574,1109,9006
71644,5425,5038,4319,4256,3903,3588,4264,30793
71646,6295,6656,6288,6607,6502,6483,6756,45587
71647,1954,1820,1884,2006,2080,2318,2111,14173
71651,162,186,172,160,172,121,150,1123
71652,1172,1097,988,1145,1087,980,1159,7628
71653,4941,4859,5048,4828,4929,5094,5152,34851
71654,4535,4573,4667,4761,4760,4808,4671,32775
71655,15070,15318,15406,15510,15542,15275,15387,107508
71658,596,732,829,733,803,754,728,5175
71659,132,157,132,119,78,78,104,800
71660,806,793,970,797,836,998,963,6163
71661,339,441,430,349,324,482,450,2815
71662,171,179,166,154,192,148,82,1092
71663,733,639,621,816,725,583,732,4849
71665,6046,6053,6134,6215,6252,6242,6054,42996
71666,10,20,19,51,49,122,79,350
71667,7303,7665,8110,7995,7899,8447,8267,55686
71670,1338,1296,1473,1575,1394,1459,1403,9938
71671,8723,8890,8745,8595,8638,8569,8665,60825
71674,580,668,658,621,868,1008,738,5141
71675,2028,2009,1965,1996,1941,1981,1824,13744
71676,581,606,586,532,679,765,684,4433
71677,230,211,206,168,178,158,185,1336
71701,19401,19308,19586,19886,19657,20037,20286,138161
71711,46,30,15,11,11,10,106,229
71720,2143,2357,2623,2921,3047,3090,2498,18679
71722,68,69,80,94,57,92,87,547
71724,322,401,365,347,363,388,431,2617
71725,549,586,617,583,603,698,555,4191
71726,1265,1337,1261,1071,1081,1182,1435,8632
71730,31663,31963,32328,32016,32302,31885,32213,224370
71740,1426,1309,1377,1620,2077,2085,1735,11629
71742,5824,6162,6038,6321,6296,6014,5980,42635
71743,3979,3874,4169,4478,4222,4057,4090,28869
71744,2785,2898,3318,3217,3436,3352,3224,22230
71745,305,298,240,258,284,304,264,1953
71747,858,919,905,909,1009,1127,1097,6824
71749,2238,2348,2329,2374,2372,2592,2595,16848
71751,1109,1149,1052,970,1094,908,939,7221
71752,804,881,775,898,972,1007,1052,6389
71753,16863,17203,17593,17225,17172,17302,16848,120206
71758,367,390,336,330,377,349,450,2599
71759,536,642,612,797,733,863,600,4783
71762,2406,2214,2428,2533,2335,2572,2501,16989
71763,1685,1486,1520,1314,1370,1541,1666,10582
71764,1842,1785,1845,2051,2128,2058,1880,13589
71765,1975,1771,1828,2253,2369,2260,2156,14612
71766,764,677,639,630,640,657,670,4677
71770,3844,3773,3144,3283,3205,2974,3526,23749
71772,12,16,0,0,13,39,34,114
71801,16806,16903,17039,16845,17077,17124,16745,118539
71820,122,154,133,115,198,83,103,908
71822,8868,8717,8775,9118,8890,9019,8925,62312
71823,43,46,41,51,59,52,83,375
71825,586,656,900,686,697,931,645,5101
71826,1361,1428,1370,1367,1267,1107,1315,9215
71827,625,583,662,769,802,865,817,5123
71832,11159,10888,10919,10950,10933,10820,11253,76922
71833,2092,2204,2131,2235,2364,2309,2280,15615
71834,1473,1482,1673,1385,1297,1173,1491,9974
71835,1467,1366,1237,1219,1177,1142,1334,8942
71836,2759,3056,2957,2935,2987,3163,2856,20713
71837,4860,4831,5451,5586,5886,6007,5227,37848
71838,1043,872,966,944,901,898,1148,6772
71839,306,325,405,410,358,423,280,2507
71841,955,878,903,903,781,883,913,6216
71842,2113,2256,2115,2300,2393,2448,2241,15866
71845,1996,2097,2205,2186,2358,2403,2387,15632
71846,3056,3242,3360,3053,2901,2744,2652,21008
71847,663,796,572,769,698,645,673,4816
71851,2078,2162,2405,2481,2333,2495,2241,16195
71852,9809,9855,9712,9978,9829,9753,10102,69038
71853,271,237,321,233,309,166,365,1902
71854,37027,37014,36008,36134,35908,35663,36438,254192
71855,658,598,511,526,492,582,708,4075
71857,5273,5566,5869,5905,5935,5725,5894,40167
71858,2168,2005,1853,1824,1908,2030,1710,13498
71859,355,513,492,466,518,463,477,3284
71860,2619,2856,3071,3153,3113,3383,2633,20828
71861,2119,1939,1785,1635,1443,1504,2258,12683
71862,453,502,601,680,703,707,771,4417
71865,144,161,266,234,228,259,194,1486
71866,435,377,379,334,456,423,725,3129
71901,30431,29990,30270,29728,29073,30140,29491,209123
71909,14566,14876,15248,15043,14978,15489,15508,105708
71913,44513,44123,43047,43180,44188,42952,43436,305439
71921,3868,3944,3857,3566,3615,3456,3652,25958
71922,97,100,152,192,211,252,129,1133
71923,15200,14970,14978,14970,15406,15481,15637,106642
71929,4425,4437,4442,4522,4827,4796,4487,31936
71933,988,983,1591,1748,1518,1359,1616,9803
71935,554,702,678,779,796,888,808,5205
71937,1862,1879,1848,2169,2504,2750,2026,15038
71940,1672,1677,1568,1485,1429,1401,1652,10884
71941,2289,2143,2396,2329,2145,2202,2098,15602
71943,4781,4826,4987,5080,4549,4712,4821,33756
71944,874,790,774,838,867,1006,773,5922
71945,1294,1495,1626,1625,1619,1691,1437,10787
71949,2828,2752,2778,2605,2467,2155,1989,17574
71950,1060,1030,931,826,813,879,875,6414
71952,223,212,295,181,126,128,145,1310
71953,14530,14759,14517,14271,13920,13458,14882,100337
71956,1910,1915,2074,2169,1599,1679,1882,13228
71957,3101,3086,3098,3004,3078,2962,3133,21462
71958,2475,2357,2428,2227,2469,2647,2525,17128
71959,597,653,664,753,835,762,754,5018
71960,1381,1517,1437,1442,1739,1794,1383,10693
71961,929,967,1159,1259,1121,1166,1003,7604
71962,875,988,981,1181,829,917,792,6563
71964,4345,4096,3781,4202,4092,4236,3926,28678
71965,357,281,210,190,187,159,315,1699
71968,3677,4147,4553,4205,4732,4564,4717,30595
71969,314,367,296,315,303,271,376,2242
71970,852,864,957,951,1062,1139,792,6617
71971,704,519,438,587,660,660,513,4081
71972,278,225,298,323,302,279,309,2014
71973,1482,1340,1472,1442,1374,1377,1424,9911
71998,459,453,385,372,562,591,321,3143
71999,760,774,649,503,404,253,706,4049
72001,486,470,418,447,392,446,566,3225
72002,17369,16319,15302,14801,13534,13343,14134,104802
72003,879,908,939,906,1014,1058,746,6450
72004,1379,1277,1339,1130,1049,1271,1311,8756
72005,145,159,155,146,96,90,248,1039
72006,2785,2782,2803,2530,2587,2767,2603,18857
72007,7537,7240,6821,6065,6174,5485,6708,46030
72010,7429,7210,7019,6656,6582,6524,6577,47997
72011,4021,4354,3935,4406,4349,4273,4074,29412
72012,12694,13039,12766,12758,11750,11486,11986,86479
72013,2220,2192,2048,1944,1903,2012,2197,14516
72014,77,84,64,66,104,121,60,576
72015,30457,29757,29037,28277,27398,26622,27307,198855
72016,3234,3102,2933,3086,3203,2968,3268,21794
72017,833,866,818,788,743,693,726,5467
72019,24153,23987,23713,23996,23497,22352,23346,165044
72020,3820,4018,4083,4134,4072,4105,4295,28527
72021,3947,3919,3934,4025,3980,4091,4348,28244
72022,16497,16318,15685,15247,14822,14353,14270,107192
72023,36854,36811,36621,35496,34805,34158,35026,249771
72024,3384,3416,3638,3551,3444,3666,3777,24876
72025,751,726,817,857,668,657,847,5323
72026,325,245,446,449,436,437,393,2731
72027,1440,1611,1535,1743,1710,1503,1417,10959
72029,1828,1711,1701,1776,1879,1826,1912,12633
72030,631,758,688,676,723,609,705,4790
72031,7312,7146,6935,7336,7376,7691,7683,51479
72032,32818,32534,31963,31710,31455,30292,31436,222208
72034,49957,48726,47533,45971,44598,43069,44723,324577
72035,1544,1523,1618,1713,1830,1932,1083,11243
72036,745,687,750,757,770,677,817,5203
72037,14,49,36,41,46,40,28,254
72038,47,46,31,44,47,42,74,331
72039,2209,2297,2492,2402,2338,2304,2131,16173
72040,2852,2869,2945,2949,3157,3124,2867,20763
72041,1417,1341,1374,1424,1335,1335,1457,9683
72042,5127,5135,4939,4987,5209,5082,5161,35640
72044,771,816,816,906,900,828,881,5918
72045,1207,1142,1325,1181,1442,1630,1151,9078
72046,4774,4917,4596,4741,4767,5027,4470,33292
72047,871,922,939,880,1027,875,969,6483
72048,47,37,42,36,64,37,114,377
72051,784,815,636,482,637,588,622,4564
72055,950,804,802,816,784,869,849,5874
72057,897,926,900,1160,1135,1490,1070,7578
72058,16040,15983,16075,15923,15769,15676,15911,111377
72059,0,42,34,26,37,30,37,206
72060,395,338,394,298,364,373,666,2828
72061,107,126,138,149,166,153,250,1089
72063,1875,1743,1637,1597,1704,1781,1683,12020
72064,2359,2404,2458,2556,2523,2567,2451,17318
72065,5126,5143,4921,4550,4350,4569,5207,33866
72067,2546,2757,2945,2974,3153,2953,2726,20054
72068,431,499,509,472,470,496,424,3301
72069,1562,1716,2042,2018,2046,2239,1369,12992
72070,1796,1819,1997,1802,1957,2180,1813,13364
72072,448,458,458,564,568,623,544,3663
72073,1040,1027,1045,966,884,1030,1139,7131
72074,132,131,117,96,114,120,167,877
72076,39118,39359,39283,38910,39062,38304,37979,272015
72079,606,750,819,766,773,911,786,5411
72080,410,567,749,1048,941,938,662,5315
72081,6597,7240,7689,7852,8147,7728,7798,53051
72082,1891,2218,2079,1922,1889,1933,1935,13867
72083,261,219,209,260,238,212,237,1636
72084,1472,1662,1700,1582,1522,1426,1229,10593
72085,168,227,228,222,310,263,220,1638
72086,9984,10102,10745,11085,11111,10848,10727,74602
72087,2337,2341,2101,1946,2305,2155,2051,15236
72088,2627,2662,2481,2523,2683,2450,2391,17817
72099,665,662,556,488,450,498,616,3935
72101,2923,3063,3158,3413,3356,3414,3378,22705
72102,3159,2730,2427,2299,2238,2037,2873,17763
72103,12816,13181,13044,12925,13679,12483,13078,91206
72104,23597,23641,23384,22915,22641,22826,23354,162358
72106,5239,5417,5637,5630,5409,5794,5376,38502
72107,247,344,379,342,352,288,339,2291
72108,44,38,30,26,18,13,73,242
72110,10835,10955,11913,11924,12132,12035,11498,81292
72111,1291,990,1029,982,1193,1205,1362,8052
72112,11286,11174,11416,11646,11966,11752,11467,80707
72113,23716,22999,22098,21787,20977,20075,21273,152925
72114,12814,13264,13864,12218,12197,11818,12658,88833
72116,22553,21920,21638,21979,21287,21633,21431,152441
72117,14458,13494,12874,12858,12668,12537,12684,91573
72118,22208,23271,23272,23950,24062,22980,22592,162335
72119,0,0,60,79,82,84,5,310
72120,31719,31281,30921,30523,30617,31204,31610,217875
72121,2966,2709,2651,2428,2463,2510,2704,18431
72122,886,783,926,881,976,986,927,6365
72123,408,459,428,373,398,483,450,2999
72125,871,818,894,952,1285,1159,905,6884
72126,3785,3889,3625,3696,3402,3478,3674,25549
72127,2591,2598,2140,2084,1852,2037,2149,15451
72128,855,864,854,802,829,882,814,5900
72129,1241,1240,1280,1286,1218,1273,1409,8947
72130,805,738,493,388,365,337,560,3686
72131,4871,4923,4755,5010,4657,4839,4631,33686
72132,3661,3569,3314,2878,2894,2745,3242,22303
72134,254,353,375,442,408,463,315,2610
72135,2471,2604,2595,2528,2620,2923,2623,18364
72136,1176,1221,1333,1727,1684,1665,1772,10578
72137,2612,2328,2250,2158,2077,2290,2555,16270
72139,234,218,239,281,264,219,216,1671
72140,474,423,380,296,225,260,305,2363
72141,639,489,688,566,790,717,625,4514
72142,2432,2631,2857,2733,2734,2823,2499,18709
72143,36945,36782,36330,36293,35967,35583,35169,253069
72149,0,0,0,0,0,0,0,0
72150,12161,11777,11575,11717,11772,11372,12006,82380
72152,288,277,379,351,261,348,429,2333
72153,2472,2567,2628,2410,2394,2449,2572,17492
72156,525,684,576,587,389,433,639,3833
72157,1406,1257,1261,1191,1254,1483,1607,9459
72160,10076,10539,10765,10774,10710,10754,10736,74354
72165,15,15,0,0,55,56,111,252
72166,186,251,252,307,297,258,260,1811
72167,1361,1483,1813,1970,1954,1736,1719,12036
72168,2285,2193,2074,2283,2135,1881,1834,14685
72169,159,179,179,161,113,112,203,1106
72170,197,213,187,164,231,279,202,1473
72173,9328,9300,9117,9614,9564,9249,9078,65250
72175,303,347,317,276,287,344,354,2228
72176,9329,9438,8972,9013,8734,8472,8141,62099
72179,532,608,586,398,316,296,450,3186
72181,14,40,22,45,22,49,62,254
72201,763,888,954,947,880,1021,1024,6477
72202,11307,10905,11208,10704,11005,9929,9978,75036
72204,30234,29696,30480,31266,31309,30874,32505,216364
72205,24149,23798,23038,22278,21503,21852,23000,159618
72206,24000,24377,24965,24699,25203,26019,25624,174887
72207,10427,10092,10544,10278,10640,10012,10344,72337
72209,30751,30592,31624,31758,32605,33800,32376,223506
72210,15061,15083,14479,14704,15020,15433,14258,104038
72211,23345,23415,21740,22015,21748,21255,21288,154806
72212,12970,13181,13865,13597,12691,13135,12705,92144
72223,22887,22139,21410,20887,19033,18694,19890,144940
72227,11131,11683,12153,12538,12283,11436,11462,82686
72301,25246,25305,25652,25889,26006,26117,26069,180284
72311,103,146,143,172,180,165,135,1044
72315,23344,23927,23917,24120,24162,24160,23966,167596
72320,1599,1521,1398,1369,1445,1352,1847,10531
72321,150,151,157,147,89,88,154,936
72322,186,230,356,282,307,230,195,1786
72324,2115,2058,1948,2048,2203,2113,1978,14463
72325,24,36,30,26,48,50,43,257
72326,1677,1647,1699,1925,1785,1835,2267,12835
72327,1780,1684,1507,1485,1253,1237,1732,10678
72328,28,31,48,13,15,19,64,218
72329,249,143,136,105,55,0,80,768
72330,758,670,721,762,811,732,756,5210
72331,3230,3341,3566,3393,3467,3686,3184,23867
72332,44,43,68,106,109,142,104,616
72333,775,800,860,850,796,925,667,5673
72335,19521,19462,19613,19580,19693,19773,20121,137763
72338,0,0,17,15,62,93,52,239
72339,127,163,156,143,150,140,204,1083
72340,127,81,82,58,68,79,90,585
72341,230,208,185,307,399,391,222,1942
72342,5132,5101,5267,5356,5363,5447,5532,37198
72346,489,522,623,685,738,783,697,4537
72347,659,644,731,689,762,756,711,4952
72348,2602,3061,3121,2880,3156,3253,2594,20667
72350,1199,1294,1276,1296,1304,1357,1226,8952
72351,683,614,609,655,685,642,835,4723
72353,30,101,111,102,253,276,114,987
72354,2487,2538,2530,2373,2300,2530,2470,17228
72355,2153,2329,2546,2526,2679,2846,2768,17847
72358,1396,1494,1567,1396,1581,1792,1690,10916
72359,459,520,449,495,652,569,430,3574
72360,6185,6258,6250,6261,6258,6226,6466,43904
72364,15982,15974,15970,16185,15747,15156,15831,110845
72365,2937,2970,2960,2902,3183,3275,3146,21373
72366,2072,1956,2052,2424,2570,2329,2543,15946
72367,101,112,124,116,119,80,108,760
72368,965,1154,1228,1346,1314,1524,1228,8759
72370,7958,8240,8395,8505,8569,8796,8606,59069
72372,2154,2073,2331,2285,2118,2149,1945,15055
72373,1262,1234,1361,1585,1563,1327,1329,9661
72374,1054,836,828,935,965,996,876,6490
72376,1516,1679,1532,1608,1764,1856,1977,11932
72377,15,16,17,18,67,49,36,218
72379,27,51,37,61,85,91,50,402
72383,42,39,35,0,0,0,53,169
72384,732,719,764,837,1048,1143,953,6196
72386,1828,1783,1591,1702,1763,1715,1777,12159
72389,316,314,302,249,249,224,204,1858
72390,8382,8900,8657,8575,8731,8991,9107,61343
72392,405,421,351,393,337,335,481,2723
72394,712,763,705,774,677,647,625,4903
72395,1118,1138,1126,957,922,939,1017,7217
72396,13136,13324,13380,13312,13251,13726,13734,93863
72401,56896,56614,55536,55197,54654,53465,53767,386129
72404,25331,24613,24510,23665,22548,22511,23482,166660
72410,387,349,323,544,581,592,498,3274
72411,2321,2335,2338,2297,2229,2059,2294,15873
72412,711,842,719,581,700,655,633,4841
72413,513,506,646,658,622,612,598,4155
72414,453,417,461,360,474,425,443,3033
72415,1432,1310,1360,1312,1220,1292,1346,9272
72416,5926,6233,6706,7000,6239,6193,5783,44080
72417,4386,4177,3670,3904,3897,3432,3568,27034
72419,1385,1432,1570,1622,1631,1713,1748,11101
72421,707,577,483,322,326,328,554,3297
72422,4741,4802,4924,4974,5214,5132,4979,34766
72424,68,72,45,67,75,68,94,489
72425,344,373,311,373,484,311,446,2642
72426,175,173,204,218,206,194,196,1366
72427,258,174,176,193,191,204,174,1370
72428,65,78,51,61,74,73,95,497
72429,404,397,365,370,428,397,427,2788
72430,420,429,413,369,383,360,411,2785
72431,518,465,513,464,462,404,401,3227
72432,6453,6052,6327,6560,6333,6206,6462,44393
72433,3154,2965,3230,3168,2899,2812,3067,21295
72434,1950,2045,1997,1857,1972,1706,2108,13635
72435,452,442,471,530,557,469,505,3426
72436,861,944,837,893,792,652,942,5921
72437,3808,3472,3215,3007,2863,3119,3272,22756
72438,2499,2311,2203,2587,2560,2402,2574,17136
72440,239,211,194,226,211,299,255,1635
72441,76,82,87,85,83,106,94,613
72442,4332,4307,4759,4652,4931,4917,4886,32784
72443,3103,3202,3344,3325,3139,3004,2986,22103
72444,1634,1471,1342,1426,1642,1893,1821,11229
72445,80,66,85,65,92,136,91,615
72447,2026,2007,2003,1937,1940,1923,1964,13800
72449,198,217,243,217,283,292,213,1663
72450,37696,36932,36413,36018,36186,36108,36033,255386
72453,155,145,137,122,141,124,198,1022
72454,4964,5061,4942,5242,5220,5380,5127,35936
72455,12513,12454,12672,12920,12889,12623,12518,88589
72456,483,384,432,626,695,582,585,3787
72457,130,147,117,135,164,124,132,949
72458,827,782,925,745,682,733,755,5449
72459,1736,1609,1594,1527,1346,1515,1329,10656
72460,696,859,536,573,581,752,832,4829
72461,3720,3891,4087,3566,3424,3863,3789,26340
72462,351,357,418,340,416,438,408,2728
72464,57,48,54,64,52,34,98,407
72466,1417,1606,1655,1677,1699,1516,1481,11051
72467,271,276,218,217,569,542,303,2396
72469,1026,1261,1079,1197,1197,1002,1124,7886
72470,212,215,210,150,142,113,319,1361
72471,921,837,1056,1049,1079,1043,1108,7093
72472,9183,9465,9510,9476,9536,9524,9447,66141
72473,2459,2581,2436,2604,2538,2552,2376,17546
72476,6741,7006,7006,6901,7220,7207,7155,49236
72478,323,442,442,417,322,376,390,2712
72479,1468,1622,1728,1788,1739,1740,1489,11574
72482,1085,1080,998,1121,1068,1127,1241,7720
72501,25612,25510,25349,24776,24666,24427,25099,175439
72512,2648,2322,2434,2299,2224,2321,2234,16482
72513,2848,3190,3065,2879,2816,2863,2856,20517
72515,0,27,24,18,27,183,63,342
72517,223,472,560,615,623,658,487,3638
72519,3259,3006,2982,3038,2747,3047,3150,21229
72520,369,408,392,518,560,211,309,2767
72521,5074,4990,4929,4806,4827,4715,4814,34155
72522,457,503,546,545,467,504,405,3427
72523,1182,1085,1207,1083,1166,1051,1091,7865
72524,306,280,196,267,325,386,376,2136
72526,246,259,175,157,140,75,154,1206
72527,513,641,656,558,487,770,583,4208
72528,69,44,104,99,52,24,65,457
72529,4421,4378,4379,4552,4771,5153,4726,32380
72530,1502,1760,1884,1886,1726,1635,1987,12380
72531,1010,669,663,648,383,498,800,4671
72532,1438,1688,1923,2172,2156,2227,1712,13316
72533,498,556,581,535,499,456,416,3541
72534,1937,1655,1406,1669,1473,1569,1320,11029
72536,375,319,329,316,314,353,429,2435
72537,595,484,529,508,474,568,805,3963
72538,181,422,481,456,550,669,432,3191
72539,180,208,202,106,115,113,253,1177
72540,349,325,281,219,172,64,149,1559
72542,3917,3828,3904,3628,3517,3726,3826,26346
72543,12058,11979,12263,12643,12599,12650,12535,86727
72544,571,360,386,591,643,705,636,3892
72546,203,182,215,246,273,312,181,1612
72550,669,800,753,844,901,819,985,5771
72553,75,69,72,69,67,32,69,453
72554,2546,2638,2969,2854,3230,3472,2923,20632
72555,128,136,104,139,150,120,182,959
72556,2984,2915,2660,2838,3154,3069,3375,20995
72560,8952,8797,8808,8783,8872,8860,8754,61826
72561,807,845,870,919,995,1062,981,6479
72562,2310,2430,2464,2592,2463,2273,2238,16770
72564,581,672,616,686,563,424,546,4088
72565,670,707,763,930,883,1064,999,6016
72566,691,542,480,527,970,569,624,4403
72567,302,195,351,399,298,275,262,2082
72568,1332,1226,1385,1362,1753,2001,1662,10721
72569,444,269,213,465,394,536,468,2789
72571,315,389,368,356,282,180,369,2259
72572,190,213,209,221,396,406,228,1863
72573,214,195,252,257,228,245,278,1669
72576,4445,4335,4083,4331,4294,4202,3868,29558
72577,462,550,700,697,716,804,700,4629
72578,177,221,214,342,375,257,212,1798
72579,1217,1177,1271,1043,1121,1129,1287,8245
72581,1108,1217,1057,1091,990,1021,1030,7514
72583,1817,1790,1826,1645,1394,984,1679,11135
72584,657,779,817,817,559,469,568,4666
72585,494,395,336,196,209,71,216,1917
72587,131,193,168,140,180,217,134,1163
72601,30184,30240,30185,30604,30823,31041,30163,213240
72611,1621,1650,1695,1801,1849,1929,1696,12241
72616,10545,10471,10175,10107,10187,10158,10441,72084
72617,155,171,164,199,171,151,198,1209
72619,2301,2107,2057,2042,1859,1886,1936,14188
72623,1042,800,910,795,588,509,648,5292
72624,275,287,373,460,541,522,594,3052
72626,1201,1164,1301,1414,1489,1403,1243,9215
72628,839,796,782,943,847,811,803,5821
72629,389,386,460,413,405,394,629,3076
72630,235,164,189,181,223,179,197,1368
72631,4120,4201,4241,4586,4314,4130,3709,29301
72632,4063,4265,4542,4176,4060,4307,4449,29862
72633,1775,2025,1895,1893,1672,1713,1833,12806
72634,4697,4511,4672,4963,4969,4818,4670,33300
72635,3833,3525,3266,3513,3516,3673,3624,24950
72636,11,28,27,19,46,50,24,205
72638,7430,7188,6937,6784,6862,6768,7186,49155
72639,715,867,899,920,834,840,683,5758
72640,185,277,288,363,512,615,385,2625
72641,2602,2657,2490,2636,2623,2683,2585,18276
72642,1787,1935,1967,1839,1745,1820,1979,13072
72644,2823,2629,2528,2419,2412,2153,2268,17232
72645,2093,1802,1782,1506,1334,1283,1867,11667
72648,805,728,711,597,592,468,716,4617
72650,4140,3953,4207,4361,4354,4528,4362,29905
72651,1313,1570,1354,1224,1165,1145,1206,8977
72653,27546,27912,28294,28482,29003,29279,28560,199076
72655,460,463,476,396,398,468,457,3118
72658,2223,2545,2406,2128,1925,1615,1685,14527
72660,621,567,722,715,577,547,524,4273
72661,424,347,433,307,398,391,580,2880
72662,2770,3006,2981,2674,2862,2669,2986,19948
72663,520,549,543,500,358,418,361,3249
72666,150,179,217,172,193,234,275,1420
72668,354,506,619,564,479,550,521,3593
72669,52,89,180,188,170,201,107,987
72670,128,122,91,131,117,129,99,817
72672,272,297,247,247,321,329,279,1992
72675,1312,1312,1199,1197,1313,1193,1399,8925
72677,394,444,470,485,484,648,525,3450
72679,49,36,42,16,47,49,48,287
72680,613,689,735,769,737,864,807,5214
72682,592,599,504,149,150,148,194,2336
72683,327,294,295,248,121,131,211,1627
72685,1352,1423,1536,1413,1374,1337,1365,9800
72686,48,127,139,173,270,265,182,1204
72687,5920,5835,5889,6355,6531,6283,6461,43274
72701,41996,41869,41076,40760,40259,40308,39782,286050
72703,31581,30718,30557,30112,29075,28327,28261,208631
72704,24943,23827,22578,21113,21114,19989,21336,154900
72712,49310,46387,44755,42380,41015,39234,40933,304014
72714,12351,12582,12481,12202,11895,11651,11880,85042
72715,16068,15400,15210,14998,14832,14300,15051,105859
72717,970,840,888,780,732,827,1071,6108
72718,2315,2137,2144,2069,1754,1707,1465,13591
72719,10646,9988,9563,9247,9295,8835,8975,66549
72721,441,491,510,378,295,185,391,2691
72722,3605,3734,3692,3171,2866,2957,3138,23163
72727,6334,6050,5935,5996,5958,5180,5658,41111
72729,192,165,109,146,91,148,280,1131
72730,7749,8847,8554,7935,7717,7634,7585,56021
72732,4205,4197,3991,4581,4652,4755,4716,31097
72734,7814,7485,7072,7481,7373,6844,7322,51391
72736,6284,6298,6164,5202,5773,6121,6208,42050
72738,2422,2518,2654,2783,2603,3073,2419,18472
72739,508,344,100,532,599,518,473,3074
72740,9141,8958,9127,9034,9475,9340,9543,64618
72742,477,441,291,276,286,404,545,2720
72744,5400,5259,5138,4749,4403,4344,5343,34636
72745,12488,11728,11552,11159,10501,10674,11376,79478
72747,201,108,101,181,159,375,152,1277
72749,101,104,95,104,69,53,84,610
72751,6872,6608,6338,5972,6025,5728,6434,43977
72752,356,282,429,372,348,307,293,2387
72753,8770,8282,7993,7924,7581,7581,7936,56067
72756,40187,39811,39762,39202,37803,37053,38455,272273
72758,39323,38516,37376,36055,35583,33749,33487,254089
72760,393,343,259,281,192,249,342,2059
72761,22294,21964,21907,22615,21688,22151,21211,153830
72762,37994,36261,35142,35924,34481,35038,35342,250182
72764,55486,55598,54340,52101,51840,49927,50230,369522
72768,1102,1185,1104,1251,1416,1130,1306,8494
72769,690,675,1268,1229,1434,1264,1162,7722
72773,1098,1116,1046,1052,1120,985,953,7370
72774,5621,6050,6270,6573,6328,6092,6121,43055
72776,599,705,603,720,613,586,574,4400
72801,19859,19233,19467,18252,17903,17849,18685,131248
72802,21390,21052,21275,21872,21886,22082,20973,150530
72821,2121,2198,2076,2109,1774,1853,2048,14179
72823,6155,6392,6459,6424,6365,6365,6765,44925
72824,1600,1611,1568,1817,1902,1886,1876,12260
72826,58,46,59,69,38,34,47,351
72827,124,68,103,151,106,98,187,837
72828,40,99,98,82,138,70,114,641
72830,15356,15269,15330,15319,15308,14627,14896,106105
72832,1006,1000,1072,1031,1163,1216,923,7411
72833,4593,4421,4356,4297,4269,3999,4384,30319
72834,11044,11200,11208,11140,11025,11028,10565,77210
72835,737,725,720,759,908,755,923,5527
72837,7382,7957,7558,7752,8084,7527,7845,54105
72838,48,133,107,158,163,279,115,1003
72839,295,313,302,205,48,97,242,1502
72840,2120,2081,2136,2062,2146,2255,2149,14949
72841,125,156,213,276,322,365,227,1684
72842,1099,1161,1315,1252,1360,1515,1478,9180
72843,2660,2678,2518,2399,2384,2165,2274,17078
72845,1244,1214,971,1186,1096,1222,1216,8149
72846,4140,4192,4207,4052,4213,3962,3913,28679
72847,2678,2650,2457,2688,2485,2447,2850,18255
72851,806,782,666,549,568,615,572,4558
72852,130,127,111,191,233,483,315,1590
72853,1914,2082,1912,2007,1944,1762,2217,13838
72854,780,753,744,681,628,576,703,4865
72855,5660,5716,5803,5640,6091,6497,6314,41721
72856,475,485,566,528,490,513,464,3521
72857,1441,1329,1584,1544,1437,1461,1430,10226
72858,3831,3612,3368,3296,3078,3089,3178,23452
72860,593,478,454,287,290,433,375,2910
72863,1547,1443,1454,1515,1568,1788,1582,10897
72865,1729,1809,2171,2051,1562,1603,1366,12291
72901,22201,22148,22995,22822,22591,22747,21591,157095
72903,26213,26841,26837,25475,25725,25530,26148,182769
72904,21517,21051,20130,21217,21287,21217,21893,148312
72908,13499,13639,13494,13556,13648,13377,13378,94591
72916,7833,7654,7507,7521,7022,6781,7131,51449
72921,13955,14446,14471,14208,13828,13953,13787,98648
72923,4821,4830,4819,4834,4787,4700,4735,33526
72926,603,597,568,425,464,537,545,3739
72927,8875,9038,8995,8775,8937,8632,8701,61953
72928,599,526,528,526,827,807,755,4568
72930,339,382,403,357,267,266,320,2334
72932,1957,2182,2069,2048,2045,1973,1597,13871
72933,5441,5186,4843,4551,4486,4891,4999,34397
72934,793,724,1441,1446,1395,1358,1047,8204
72935,421,465,485,495,477,467,577,3387
72936,14355,14805,14674,14990,15064,15717,14527,104132
72937,3484,3476,3767,3916,3568,3662,3858,25731
72938,1410,1455,1476,1646,1649,1446,1391,10473
72940,2837,2651,2427,1943,1804,1738,2515,15915
72941,5686,5792,5795,5906,5940,5590,5251,39960
72943,2276,2391,2359,2471,2392,2429,2646,16964
72944,3555,2917,2615,2934,2768,2663,2919,20371
72945,215,242,245,334,391,337,314,2078
72946,3536,3516,3216,3359,3516,3586,3654,24383
72947,4613,4921,4979,5047,4800,4975,4433,33768
72948,385,316,369,384,429,416,518,2817
72949,8907,8946,9452,10084,10331,10238,10177,68135
72950,323,314,417,491,473,409,409,2836
72951,981,1115,1167,1314,1153,952,988,7670
72952,2941,3297,3098,2961,2785,2743,2945,20770
72955,252,228,180,226,196,300,438,1820
72956,34520,33117,32870,32685,33058,32585,34074,232909
72958,7354,7576,7741,7531,7909,7874,8117,54102
72959,3043,2871,2857,2920,3052,3207,2786,20736
73002,957,1017,1068,1082,994,1110,1062,7290
73003,23764,22255,21004,20721,20114,19843,20617,148318
73004,1020,836,753,770,677,752,857,5665
73005,9599,9819,9584,9386,9188,9270,9541,66387
73006,3373,3282,4014,3993,3775,3849,3718,26004
73007,2105,2100,2055,2048,1709,1807,2178,14002
73008,20437,20338,20192,19867,19752,19640,19800,140026
73009,1289,1214,1189,1243,1348,1492,1264,9039
73010,19057,18730,18277,17738,17462,16673,17563,125500
73011,402,401,436,469,424,423,416,2971
73012,33160,31034,29429,27462,26300,24678,25851,197914
73013,49641,48423,47166,46457,44714,44542,43933,324876
73014,2106,1865,1751,1642,1424,1210,1431,11429
73015,3030,2901,2854,2772,2752,2702,2877,19888
73016,1751,1620,1559,1591,1618,1539,1850,11528
73017,1722,1732,1892,1940,1796,1737,1780,12599
73018,20244,20208,19993,20032,20368,20318,19936,141099
73019,0,0,64,77,80,88,0,309
73020,22562,22357,22063,21499,21085,20757,20810,151133
73021,247,353,300,271,320,312,352,2155
73024,797,686,632,600,618,609,637,4579
73025,12148,13160,12300,12018,11334,11699,11579,84238
73026,10574,10841,11093,11224,11341,11059,10437,76569
73027,1400,1637,1546,1406,1612,1625,1493,10719
73028,3710,3464,3607,3432,3272,3208,3454,24147
73029,1625,1674,1606,1723,1700,1749,1818,11895
73030,4370,4305,4319,4317,4306,4322,4464,30403
73032,260,295,319,311,314,337,222,2058
73033,418,464,434,443,482,482,387,3110
73034,45033,43280,43082,41918,40829,37924,39872,291938
73036,20271,19860,19303,18888,18618,18306,18595,133841
73038,1882,1972,1987,2178,2309,2208,2032,14568
73040,1766,1667,1716,1765,1895,1853,1976,12638
73041,244,285,277,332,373,384,366,2261
73042,1099,1017,994,1002,1012,1047,1073,7244
73043,161,130,181,157,152,94,125,1000
73044,21713,21660,21431,20834,20126,20311,20226,146301
73045,10529,10224,10187,10052,10286,10324,10378,71980
73047,5069,5072,5206,5024,4847,4259,4774,34251
73048,2197,1976,2007,1924,1993,1997,2020,14114
73049,6333,6255,6359,6257,5682,5749,5910,42545
73050,834,884,879,824,816,807,1370,6414
73051,9892,10030,10167,10072,9987,9915,10264,70327
73052,6562,6466,6266,6332,6310,6250,6315,44501
73053,720,768,750,719,692,806,745,5200
73054,3935,3846,3668,3802,4073,4033,4189,27546
73055,9910,9991,9959,9950,9749,9631,9942,69132
73056,496,559,580,654,590,486,441,3806
73057,2293,2374,2382,2581,2338,2375,2384,16727
73058,304,297,272,396,450,477,332,2528
73059,2604,2485,2542,2493,2535,2942,2924,18525
73061,1781,1840,1770,1791,1695,1699,1596,12172
73062,1401,1334,1562,1527,1435,1374,1396,10029
73063,695,740,691,663,654,651,691,4785
73064,22545,22274,21945,21415,20869,20394,20611,150053
73065,7521,7012,6977,6686,6619,6457,6546,47818
73066,323,235,516,446,344,472,417,2753
73067,2276,2146,2173,2024,2068,2148,2161,14996
73068,12225,11840,11333,11175,11061,10951,11707,80292
73069,24757,24735,24385,24706,24109,24038,23912,170642
73071,40061,39603,38924,36983,36741,36344,36711,265367
73072,47331,46381,45544,45246,43536,42016,42797,312851
73073,618,665,688,575,624,614,541,4325
73074,1053,1083,1121,1087,1121,978,1190,7633
73075,9278,9455,9456,9469,9628,9711,9519,66516
73077,6780,6822,6868,7096,7171,7103,7135,48975
73078,9486,8827,8395,8185,7917,7532,7786,58128
73079,540,688,638,624,667,686,643,4486
73080,9438,9666,9614,9658,9522,9543,9276,66717
73082,2887,2744,2612,2442,2464,2522,2980,18651
73084,7053,6987,6802,6967,6726,6443,6518,47496
73086,8592,8518,8569,8385,8227,8244,8345,58880
73089,12477,12179,12402,12535,12281,11900,11522,85296
73090,1072,1127,1385,1697,1663,1755,1198,9897
73092,1009,1069,869,954,986,958,908,6753
73093,2848,2882,2915,2754,2804,2774,2612,19589
73095,1955,1995,2140,1991,1865,1705,1895,13546
73096,14438,14288,14060,13689,13100,12466,13037,95078
73097,100,110,97,238,221,309,187,1262
73098,4517,4394,4340,4446,4725,4769,4227,31418
73099,64418,63219,61147,59634,58595,56950,57492,421455
73102,5308,4795,4238,3418,2666,2301,3858,26584
73103,4763,4557,4549,4734,4350,4472,4315,31740
73104,2234,2127,1974,1915,1732,1757,1664,13403
73105,5693,5731,5925,5647,5708,5375,5210,39289
73106,13017,13242,13269,13179,12672,12792,13581,91752
73107,26458,26766,26810,27412,26099,26770,26561,186876
73108,14641,15104,15120,15221,15465,14771,15350,105672
73109,21718,21092,20056,20599,20515,20465,20594,145039
73110,34158,33644,33642,33142,32904,32521,32666,232677
73111,10837,11289,11414,11516,11386,11628,11781,79851
73112,32114,31408,30801,30958,31396,31634,30943,219254
73114,18372,18864,18987,18551,18482,16949,17422,127627
73115,21449,21286,21126,20783,20843,20487,20541,146515
73116,9465,10033,9601,9674,9644,9937,9241,67595
73117,5595,5318,5292,5621,5157,5375,5191,37549
73118,14072,13764,13743,13748,13485,13418,13571,95801
73119,33016,33298,32311,31135,29958,30553,31347,221618
73120,36336,35881,35985,35891,35981,35758,34824,250656
73121,3218,3240,3294,3328,3369,3361,3053,22863
73122,13849,13667,13962,14330,14429,14402,13164,97803
73127,25856,25230,24937,23997,24183,23306,24077,171586
73128,4934,4749,4822,4165,3814,3548,4200,30232
73129,18534,19564,19108,20304,19820,19871,20126,137327
73130,20236,20032,19535,19494,19303,19219,19439,137258
73131,3331,3358,3257,3037,3099,2977,3145,22204
73132,27509,27756,27227,26708,26977,26820,26432,189429
73134,4634,4997,4991,3998,4315,4004,4312,31251
73135,22049,21595,21031,19692,20187,20462,20529,145545
73139,18087,18054,18566,17600,17543,16972,17253,124075
73141,2580,2611,2660,2764,2835,2767,2727,18944
73142,12781,11999,11142,10477,10141,10605,10707,77852
73145,3117,2821,2493,2517,2362,2444,2859,18613
73149,5038,4763,4868,4848,4797,4471,4643,33428
73150,4582,4323,4282,4432,4447,4516,4609,31191
73151,1525,1577,1522,1511,1630,1606,1446,10817
73159,32273,30946,30416,30951,29988,30090,30350,215014
73160,57199,56179,55366,54420,53446,51873,53666,382149
73162,29086,29056,29518,28988,29304,28007,27758,201717
73165,6437,6414,6487,5972,6064,5991,5809,43174
73169,2308,2082,1981,1892,1665,1724,1782,13434
73170,37866,37382,36792,36146,35244,34676,35343,253449
73173,2126,1792,1594,1457,1360,1047,1299,10675
73179,4699,4218,3578,3378,3112,2768,3082,24835
73401,36146,35830,35838,35411,35020,34845,34927,248017
73425,26,49,53,99,116,121,84,548
73430,1335,1225,1265,1279,1278,1269,1176,8827
73432,1124,1083,1028,947,915,938,974,7009
73433,2917,2916,2758,2608,2509,2346,2761,18815
73434,531,501,524,524,557,568,699,3904
73437,83,60,80,87,45,35,107,497
73438,3592,3629,3687,3966,3883,3798,3708,26263
73439,7521,7659,7666,7504,7393,7379,7400,52522
73440,304,225,208,237,232,369,398,1973
73441,113,139,163,208,288,297,165,1373
73442,333,381,523,651,679,733,428,3728
73443,3727,3672,3554,3222,3384,3224,3585,24368
73444,98,123,117,109,70,192,156,865
73446,8254,8130,8090,8119,8149,7927,8042,56711
73447,1349,1176,1248,1172,1286,1177,1205,8613
73448,6157,6195,6159,6039,5910,5676,5784,41920
73449,2789,2534,2688,3210,3251,3578,2987,21037
73450,1362,1533,1384,1363,1283,1276,1248,9449
73453,514,532,428,477,477,421,661,3510
73455,588,654,580,601,604,586,673,4286
73456,2119,2044,2151,2134,2156,2284,2082,14970
73458,894,961,925,1006,1001,913,952,6652
73459,1149,1108,1062,980,1059,1246,1132,7736
73460,4656,4707,4690,4630,4568,4536,4747,32534
73461,743,703,785,840,1023,1044,795,5933
73463,3441,3616,3647,3714,3678,3784,3501,25381
73481,982,1041,1031,906,910,1018,978,6866
73487,165,146,106,148,148,167,232,1112
73491,777,796,842,862,966,991,721,5955
73501,20390,20482,20450,20086,19794,19559,20935,141696
73503,10664,10654,10118,10398,10468,10697,10996,73995
73505,49672,50150,51391,50737,50015,49611,49809,351385
73507,23322,23845,23592,23623,24220,23720,22847,165169
73520,134,123,114,110,124,105,149,859
73521,21316,21605,21793,21812,21834,21546,21636,151542
73526,2277,2035,2061,2095,2016,2082,2133,14699
73527,5676,5566,5202,5167,4638,4679,5184,36112
73528,618,606,610,557,558,463,680,4092
73529,5435,5245,5036,4968,4968,5181,5344,36177
73530,473,521,562,525,489,445,442,3457
73531,398,446,459,392,392,441,401,2929
73532,409,466,466,513,575,637,600,3666
73533,28123,28308,28225,28243,28199,27847,28434,197379
73537,606,588,669,638,571,683,643,4398
73538,5802,5859,5162,4807,4494,4390,4675,35189
73539,228,213,235,177,178,141,218,1390
73540,611,667,384,447,478,423,439,3449
73541,2774,2922,3057,2879,2937,2990,3106,20665
73542,4427,4448,4398,4443,4485,4492,4659,31352
73543,1707,1568,1663,1928,1865,1858,1859,12448
73544,266,290,262,242,189,255,268,1772
73546,1130,1090,1156,1239,1265,1290,1232,8402
73547,2447,2351,2291,2269,2311,2327,2319,16315
73548,442,488,567,513,363,437,519,3329
73549,236,315,344,406,426,468,296,2491
73550,2337,2340,2405,2504,2541,2451,2512,17090
73551,30,25,40,68,125,123,65,476
73552,1562,1709,1629,1568,1404,1385,1612,10869
73553,88,33,31,23,33,39,46,293
73554,3310,3527,3482,3466,3515,3495,3614,24409
73555,210,245,224,278,300,337,214,1808
73556,155,141,140,173,149,145,166,1069
73557,288,231,204,302,259,285,427,1996
73559,687,604,585,604,631,481,540,4132
73560,736,779,668,609,605,731,829,4957
73562,627,649,688,782,660,659,772,4837
73564,417,481,497,483,509,539,551,3477
73565,986,1081,1008,1018,939,1063,1092,7187
73566,1935,1915,1938,1662,1759,1852,1674,12735
73567,803,664,643,672,625,631,860,4898
73568,1094,1251,1367,1155,1286,1230,1182,8565
73569,557,518,625,655,716,641,537,4249
73570,1072,1147,1180,1112,1083,1147,1128,7869
73571,177,202,178,126,142,97,87,1009
73572,3782,3611,3552,3752,3698,3776,3699,25870
73573,2585,2587,2414,2472,2457,2385,2551,17451
73601,10530,10515,10241,10194,9810,9822,10299,71411
73620,953,990,990,1140,1206,1350,1194,7823
73622,178,176,238,200,234,246,266,1538
73624,2208,2321,2376,2408,2472,2545,2142,16472
73625,615,638,559,619,600,623,554,4208
73626,978,866,801,777,825,897,1136,6280
73627,622,644,533,461,533,678,628,4099
73628,1666,1672,1775,1849,1932,1887,1583,12364
73632,3437,3461,3349,3432,3415,3393,3433,23920
73638,283,235,122,116,133,163,142,1194
73639,536,522,502,536,605,503,602,3806
73641,721,768,787,850,898,822,762,5608
73642,164,202,163,140,157,177,187,1190
73644,14884,14746,14465,14247,13995,14017,14147,100501
73645,1615,1656,1385,1320,1414,1476,1538,10404
73646,426,506,484,401,316,284,384,2801
73647,712,630,654,634,731,595,519,4475
73650,1111,1058,1124,1015,983,933,1020,7244
73651,4060,4216,4175,4345,4283,4323,4268,29670
73654,672,758,849,856,911,939,866,5851
73655,787,776,723,735,708,785,864,5378
73658,198,299,330,306,340,290,260,2023
73659,167,203,175,206,233,216,160,1360
73660,376,398,380,389,357,320,430,2650
73661,472,447,482,441,467,481,420,3210
73662,6498,6611,6912,6964,6790,6256,6093,46124
73663,1338,1159,1199,1177,1215,1257,1332,8677
73664,1117,1114,1155,1167,1095,1174,1184,8006
73666,271,234,200,189,132,147,180,1353
73667,599,618,592,576,562,578,517,4042
73669,1650,1746,1821,1768,1825,2077,1675,12562
73673,280,210,337,352,330,332,319,2160
73701,24571,25094,25850,25205,25071,25154,24808,175753
73703,29658,28832,27884,27783,27282,26862,27951,196252
73705,322,315,298,276,267,257,267,2002
73716,516,450,420,413,411,463,510,3183
73717,6890,6869,6768,6691,6675,6658,6846,47397
73718,641,599,604,539,622,497,501,4003
73719,35,28,33,36,30,71,83,316
73720,170,224,240,261,278,216,265,1654
73722,569,516,581,511,554,531,427,3689
73724,980,906,1022,1188,1092,1134,1190,7512
73726,606,627,644,599,527,501,472,3976
73727,205,211,235,197,120,131,267,1366
73728,1801,1867,1875,1842,1832,1839,1861,12917
73729,568,605,577,567,590,663,578,4148
73730,816,717,711,826,773,590,734,5167
73731,90,104,136,123,167,167,171,958
73733,318,261,226,229,172,255,221,1682
73734,998,955,974,993,912,944,1067,6843
73735,657,690,623,641,618,647,684,4560
73736,561,524,414,400,327,337,356,2919
73737,3393,3370,3295,3307,3258,3241,3367,23231
73738,1107,1022,1071,1218,1202,1306,1134,8060
73739,366,310,235,292,276,200,369,2048
73741,1719,1701,1659,1731,1759,1780,1614,11963
73742,4347,4409,4423,4167,4387,4203,3824,29760
73743,217,175,144,132,117,113,122,1020
73744,176,180,232,226,247,194,267,1522
73746,16,9,9,8,8,0,37,87
73747,387,346,340,294,291,365,285,2308
73749,381,425,422,443,414,409,448,2942
73750,7140,7121,7083,7081,6838,7113,7025,49401
73753,365,321,419,466,552,470,468,3061
73754,1199,1242,1139,1115,1184,1073,1078,8030
73755,772,821,908,719,741,857,905,5723
73756,270,263,272,225,238,199,352,1819
73757,200,192,176,209,203,210,178,1368
73758,114,144,162,156,199,165,197,1137
73759,1606,1533,1606,1597,1428,1593,1468,10831
73760,396,440,458,501,534,487,470,3286
73761,437,495,495,520,436,388,395,3166
73762,2160,2219,1912,2102,2096,2144,2156,14789
73763,1496,1335,1397,1420,1461,1548,1623,10280
73764,122,113,117,157,166,155,144,974
73766,1233,1221,1159,1109,1228,1160,1096,8206
73768,1797,1761,1641,1675,1485,1445,1568,11372
73771,445,421,426,450,483,510,495,3230
73772,4669,5000,4341,4780,5193,5721,6119,35823
73773,1799,1965,1955,1724,1768,1806,1744,12761
73801,14987,15196,15181,15358,15362,15262,15228,106574
73832,1003,920,886,912,963,1007,929,6620
73834,1671,1757,1781,1819,1808,1613,1643,12092
73835,262,354,356,346,363,280,309,2270
73838,288,345,472,488,537,622,462,3214
73840,770,786,801,760,713,647,691,5168
73841,1313,1397,1436,1272,1246,1208,1482,9354
73842,536,475,483,507,443,419,494,3357
73843,868,950,971,909,923,958,883,6462
73844,232,270,283,250,195,204,269,1703
73848,2220,2055,2004,1946,1941,2093,2156,14415
73851,102,96,101,41,35,48,80,503
73852,3019,2713,2353,2273,2129,2193,2051,16731
73853,582,487,473,393,342,366,379,3022
73855,78,86,80,74,102,117,106,643
73857,717,676,672,693,573,551,623,4505
73858,1558,1529,1572,1626,1590,1534,1666,11075
73859,1591,1525,1646,1621,1590,1437,1459,10869
73860,1684,1657,1586,1519,1427,1426,1337,10636
73901,177,151,122,94,101,99,156,900
73931,574,646,605,682,698,504,510,4219
73932,2271,2292,2151,2030,1985,2117,2092,14938
73933,1487,1579,1601,1607,1650,1724,1697,11345
73937,220,205,175,163,154,138,173,1228
73938,710,557,624,805,808,839,781,5124
73939,1585,1665,1881,1634,1578,1713,1695,11751
73942,13847,13398,13236,13033,12582,12447,12953,91496
73944,465,495,427,377,490,486,388,3128
73945,2995,3260,3363,3485,3456,3142,2889,22590
73946,80,91,104,66,63,35,45,484
73947,431,405,434,522,521,513,472,3298
73949,1440,1477,1439,1571,1521,1590,1688,10726
73950,1461,1616,1739,1745,1746,1748,1736,11791
73951,1237,1381,1211,1085,1034,953,1141,8042
74001,315,367,393,430,347,334,367,2553
74002,1988,2016,2271,2362,2437,2516,2333,15923
74003,14813,14794,14546,14410,14677,14704,14249,102193
74006,26484,26135,26111,25699,25577,25160,25750,180916
74008,25888,25196,24290,23270,22875,21850,22461,165830
74010,11004,10750,10786,10713,10870,10362,10501,74986
74011,26475,26539,25986,25096,25233,24944,25448,179721
74012,61534,60213,59336,58607,56789,55591,57526,409596
74014,37549,36943,36352,35943,35588,34266,34579,251220
74015,8696,8431,8298,8709,8722,9026,8064,59946
74016,6021,6198,5934,5746,5798,5687,6005,41389
74017,28004,27905,27807,26981,26960,27050,28057,192764
74019,18459,19100,18848,18676,18715,18961,17648,130407
74020,7214,7283,7354,7451,7313,7314,7294,51223
74021,18865,18618,18037,17960,18108,17541,17359,126488
74022,1968,1931,1838,1913,1920,1865,1760,13195
74023,11400,11589,12038,11987,11952,12227,11741,82934
74026,942,952,940,1054,1220,1024,896,7028
74027,976,964,869,782,878,1038,1015,6522
74028,1765,1777,1763,1653,1676,1610,1881,12125
74029,5076,5275,5359,5243,5173,5141,5128,36395
74030,3733,3751,3625,3637,3705,3719,3864,26034
74032,2022,2418,2123,2253,2135,2171,2219,15341
74033,10956,10579,10758,10515,10052,9766,10163,72789
74034,146,131,120,188,180,175,150,1090
74035,4248,4359,4436,4273,4320,4271,4565,30472
74036,7047,6810,6441,6433,5851,5935,6734,45251
74037,16660,16433,15629,15397,15301,15185,15159,109764
74038,2094,2073,2365,2266,2162,2246,2254,15460
74039,3913,3910,3940,3716,3936,3757,3770,26942
74041,2331,2295,2329,2174,2240,1953,2057,15379
74042,479,503,582,705,736,571,540,4116
74044,7549,7533,7574,7382,7089,7156,7406,51689
74045,355,443,408,444,478,414,311,2853
74046,93,80,138,120,145,131,115,822
74047,6812,6942,6491,6543,6300,6523,7163,46774
74048,6231,6143,6110,5991,5846,5732,6092,42145
74050,373,325,398,266,346,480,323,2511
74051,1847,1876,1896,1954,2252,2404,1904,14133
74052,1101,1230,1348,1378,1294,1298,1180,8829
74053,4780,4475,4429,4441,4251,4043,4315,30734
74054,852,749,777,810,813,912,844,5757
74055,42764,41296,40813,39650,38410,36809,38680,278422
74056,5432,5351,5291,5548,5171,5257,5720,37770
74058,4095,4153,4102,4024,4184,4345,4259,29162
74059,5262,5247,4993,5274,5023,5347,5476,36622
74060,492,649,632,709,690,692,586,4450
74061,2063,2073,2110,2108,1812,1919,2095,14180
74062,869,898,864,890,1023,990,1123,6657
74063,31061,30727,30458,30376,30276,29879,29808,212585
74066,32338,32088,31284,31116,30213,29979,31060,218078
74068,57,61,51,57,60,93,111,490
74070,14926,14771,14303,14363,13961,13474,13928,99726
74071,135,93,154,122,117,160,180,961
74072,1863,1944,1848,1971,1824,1903,1816,13169
74073,5718,5750,5723,5864,5825,5708,5118,39706
74074,31550,30524,29542,29179,29187,28469,29184,207635
74075,25099,24616,24729,24001,23637,23300,23866,169248
74078,2377,2458,2817,2670,2427,2233,2295,17277
74079,4357,4403,4357,4198,4408,4200,4504,30427
74080,2936,3068,3232,2908,2742,2460,2829,20175
74081,1748,1676,1761,1848,1717,1610,1837,12197
74082,60,59,75,92,113,110,107,616
74083,1020,986,1113,1054,1132,1229,1031,7565
74084,604,633,576,548,576,551,628,4116
74085,2336,2444,2485,2368,2300,2366,2588,16887
74103,2066,1995,1925,1911,1925,1995,2692,14509
74104,11975,12255,12369,12572,12608,12404,12724,86907
74105,25348,25853,26321,26582,26844,27855,26547,185350
74106,18225,18157,17432,17046,16698,16139,17648,121345
74107,19867,19836,19630,19635,19867,20137,19458,138430
74108,7154,7077,6922,6695,6720,6776,7490,48834
74110,14700,15460,14896,14291,14111,14305,14862,102625
74112,20581,20827,20872,21170,20870,21065,20684,146069
74114,16125,16141,16006,15795,15890,15644,15778,111379
74115,23331,23376,23787,23572,23746,24229,22941,164982
74116,4197,4138,4198,4359,4366,4382,3890,29530
74117,124,147,205,150,180,194,87,1087
74119,3365,3486,3426,3680,3688,3590,3561,24796
74120,4950,5063,5250,5625,5172,4944,4940,35944
74126,10110,9797,9972,10079,10332,10478,10598,71366
74127,16279,16570,16502,16626,16837,16821,17151,116786
74128,12416,12595,12323,12344,12351,12253,12676,86958
74129,19299,19205,19156,18461,18207,18638,18976,131942
74130,1950,1867,1926,2295,2124,2250,2065,14477
74131,3241,3207,3291,3240,3202,3088,2775,22044
74132,8604,8459,8096,8128,7489,7418,7543,55737
74133,45377,44901,44226,44107,43765,43606,43414,309396
74134,16719,15907,16937,16739,16237,15525,15083,113147
74135,20943,21190,21418,21322,21332,21234,20651,148090
74136,31717,31271,30811,30767,30765,30580,30703,216614
74137,27874,27389,26814,26797,26494,26300,25737,187405
74145,18604,18350,18131,18445,18325,17946,17402,127203
74146,15927,14964,14692,13845,13934,13476,15498,102336
74301,11794,11888,12181,12297,12121,12105,11840,84226
74330,3410,3384,2975,2993,2863,2971,2884,21480
74331,6634,6548,6568,6726,6858,7247,7258,47839
74332,1555,1591,1528,1558,1680,1718,1972,11602
74333,1160,1245,1185,1170,1214,1133,1221,8328
74337,5442,5428,5590,5214,5133,5134,5060,37001
74338,5480,5462,5303,5138,5345,5462,5480,37670
74339,2563,2572,2643,2609,2608,2901,2606,18502
74340,218,197,168,182,190,197,311,1463
74342,2947,2842,2988,2471,2532,2177,2927,18884
74343,3126,3104,2864,2859,2921,2789,3100,20763
74344,14954,14433,14480,14327,14166,13863,14412,100635
74346,7976,8249,7756,8376,8381,8318,7864,56920
74347,2604,2882,2999,2870,2855,3184,2593,19987
74349,273,330,344,350,314,347,318,2276
74350,795,799,797,793,807,900,862,5753
74352,6267,6033,6946,7016,7430,7588,6803,48083
74354,18217,18124,18207,18409,18189,18067,18126,127339
74358,237,234,212,242,250,271,270,1716
74359,591,669,706,664,730,828,656,4844
74360,13,15,30,75,158,325,31,647
74361,16517,16903,16722,16773,16689,16248,16293,116145
74363,2952,3024,3096,2971,2862,2800,2892,20597
74364,1842,1709,1776,1977,1809,1639,1750,12502
74365,4595,4499,4417,4345,4572,4647,5110,32185
74366,1404,1489,1372,1430,1567,1543,1474,10279
74367,407,381,492,527,488,492,587,3374
74368,93,85,71,40,45,29,117,480
74369,2055,1980,1908,1936,1820,1808,1803,13310
74370,3603,3739,3911,3868,3923,3704,3537,26285
74401,17400,17683,17638,18086,17983,18467,17476,124733
74403,30226,30585,31203,30957,30808,30352,30709,214840
74421,4544,4434,4370,4501,4566,4570,4607,31592
74422,640,696,552,580,612,576,824,4480
74423,874,849,678,776,961,1046,872,6056
74425,1336,1266,1122,1007,891,847,1240,7709
74426,9725,9876,9678,9531,9764,9640,9891,68105
74427,1005,912,1030,907,1036,1029,1383,7302
74428,1241,1165,1175,1217,1046,1124,882,7850
74429,15511,14915,14723,14257,13857,13992,14445,101700
74430,471,462,495,551,595,691,588,3853
74431,925,920,967,970,1010,1137,918,6847
74432,9711,9788,10057,9966,9920,9207,9730,68379
74434,9126,9063,9442,9844,9561,9685,9067,65788
74435,2989,2807,2988,2932,2716,2921,3185,20538
74436,5149,5011,4677,4714,4390,4068,5078,33087
74437,10450,10398,10458,10321,10321,10147,10448,72543
74438,152,148,179,265,290,272,163,1469
74441,5375,5516,5236,5332,5435,5489,5362,37745
74442,801,836,971,965,1001,1081,920,6575
74445,3216,3191,3297,3024,2862,2871,3226,21687
74446,475,528,494,585,608,543,558,3791
74447,16859,16919,17014,17249,17287,17384,17275,119987
74450,1904,1946,1967,1803,1823,1748,1948,13139
74451,4240,4407,4525,4249,4479,4227,4283,30410
74452,377,384,501,457,391,532,473,3115
74454,3057,3364,3259,3088,2826,2627,3179,21400
74455,3031,2943,2660,2477,2555,2453,3158,19277
74456,197,161,185,231,217,205,247,1443
74457,470,413,480,466,575,695,608,3707
74458,127,71,97,99,109,108,147,758
74459,93,79,74,75,79,62,86,548
74460,142,238,254,312,286,329,283,1844
74462,7679,7731,7458,7741,7744,8205,7875,54433
74463,2087,2043,2043,2058,2135,2195,2033,14594
74464,31820,31369,30559,30274,29809,29133,30111,213075
74467,15085,14943,15124,15564,15713,15622,14995,107046
74468,258,269,250,258,257,251,263,1806
74469,2514,2426,2478,2460,2321,2284,2531,17014
74470,1741,1694,1577,1542,1376,1308,1693,10931
74471,1707,1659,1763,1656,1888,1822,1800,12295
74472,736,665,621,579,547,464,554,4166
74477,0,0,0,0,0,0,5,5
74501,28223,28589,28835,29180,29528,29407,29073,202835
74521,165,126,161,222,221,236,217,1348
74522,260,253,237,253,220,240,344,1807
74523,5924,6038,5892,5702,5818,5769,6048,41191
74525,9759,9921,9864,9823,9678,9555,10112,68712
74528,225,219,164,175,173,174,174,1304
74530,185,181,246,240,171,200,214,1437
74531,992,1035,942,891,867,973,1062,6762
74533,741,727,782,818,814,866,849,5597
74534,186,191,243,255,245,248,250,1618
74535,81,61,131,221,230,206,126,1056
74536,1632,1634,1765,1850,1877,1848,1760,12366
74538,4152,4156,4091,3967,4036,3985,4200,28587
74540,183,204,164,159,165,286,172,1333
74543,460,453,476,513,452,509,370,3233
74546,702,734,698,700,725,708,824,5091
74547,3467,3367,3309,3347,3108,3316,3463,23377
74549,86,74,94,94,99,90,76,613
74552,1084,1066,1191,1052,1001,916,1058,7368
74553,1224,1111,1057,1057,1100,1103,1384,8036
74554,1830,1880,2136,2261,2198,2264,1744,14313
74555,778,770,663,739,735,767,861,5313
74556,393,392,421,470,461,521,422,3080
74557,488,491,479,502,437,455,464,3316
74558,439,457,481,513,517,566,455,3428
74560,583,577,523,559,647,581,635,4105
74561,2066,2240,2330,2137,2270,2238,2175,15456
74562,872,833,809,741,727,770,937,5689
74563,2112,2345,2251,2274,2204,1975,2042,15203
74565,687,648,612,568,619,546,707,4387
74567,70,99,114,135,168,119,242,947
74569,1055,930,1007,992,1035,1263,633,6915
74570,1008,1114,1022,1096,1123,980,1089,7432
74571,3579,3475,3750,3906,3643,3752,3765,25870
74572,723,737,717,745,669,641,712,4944
74574,1134,1090,1037,1124,1180,1153,1080,7798
74576,147,126,157,159,153,139,210,1091
74577,215,239,232,259,365,357,271,1938
74578,6217,6262,6526,6400,6535,6850,6822,45612
74601,19481,19991,19996,20015,20057,19986,20257,139783
74604,12442,11977,12126,12108,12217,12275,12301,85446
74630,799,722,719,660,684,603,702,4889
74631,7535,7597,7562,7652,7593,7740,7709,53388
74632,600,603,646,530,517,507,578,3981
74633,408,445,504,602,582,582,471,3594
74636,283,279,275,247,234,155,268,1741
74637,1829,1930,2128,2181,2323,2574,1899,14864
74640,299,358,306,307,373,326,312,2281
74641,614,653,583,585,594,602,715,4346
74643,380,423,403,453,535,609,615,3418
74644,506,475,475,497,462,426,478,3319
74646,256,288,332,276,279,334,233,1998
74647,3659,3572,3602,3712,3768,3697,3765,25775
74650,722,635,666,692,678,702,693,4788
74651,756,799,737,690,689,721,743,5135
74652,865,831,799,714,738,779,897,5623
74653,3823,3850,3883,3947,3957,3932,3892,27284
74701,24013,23864,23204,22204,22344,21715,22365,159709
74720,471,559,612,655,699,663,608,4267
74722,280,295,281,236,307,260,286,1945
74723,1505,1588,1643,1695,1554,1371,1729,11085
74724,449,401,404,504,456,371,377,2962
74726,2439,2377,2071,2073,2142,1914,2398,15414
74727,1876,1828,2023,2043,2067,1994,2038,13869
74728,11341,11292,11418,11262,11269,11038,11343,78963
74729,3101,3020,3091,3115,3182,3025,2741,21275
74730,4767,4612,4803,4350,4269,4422,4259,31482
74731,1229,1784,1873,2172,2128,2102,1747,13035
74733,3434,3009,3143,3091,2537,2502,2853,20569
74734,1229,1247,1279,1182,1103,1133,1087,8260
74735,1471,1584,1667,1630,1504,1645,1549,11050
74736,1161,1128,1167,1134,1103,1024,1178,7895
74738,597,575,541,653,645,896,560,4467
74740,2224,2040,1964,2255,2365,2468,2288,15604
74741,959,890,820,940,911,976,972,6468
74743,8563,8595,8536,8351,8386,8204,8537,59172
74745,9959,10062,9932,9691,9558,9578,9912,68692
74747,151,129,161,147,129,155,153,1025
74748,696,675,557,572,549,493,642,4184
74750,359,479,504,497,457,466,364,3126
74753,48,50,18,19,0,0,52,187
74754,274,251,212,242,162,142,385,1668
74755,102,79,70,76,84,48,83,542
74756,792,872,963,968,987,899,870,6351
74759,1319,1265,1236,1307,1374,1378,1358,9237
74760,372,300,243,244,243,289,295,1986
74761,77,90,88,74,72,68,70,539
74764,3585,3731,3767,3911,4024,4092,3473,26583
74766,1385,1327,1368,1388,1357,1530,1595,9950
74801,22445,22206,22236,21920,21857,21995,21657,154316
74804,20662,20488,20506,20308,20069,20184,19631,141848
74820,31527,31460,31242,31149,31144,30661,30802,217985
74824,1494,1480,1472,1603,1449,1383,1253,10134
74825,2156,2100,2241,2211,2023,2204,2170,15105
74826,1075,1019,1081,1100,1054,1158,1252,7739
74827,388,391,442,420,472,553,387,3053
74829,1495,1493,1428,1446,1427,1475,1521,10285
74830,256,284,276,279,236,280,229,1840
74831,778,759,744,815,856,857,923,5732
74832,839,886,889,845,1084,1023,936,6502
74833,809,684,675,684,615,578,703,4748
74834,7496,7225,7317,7148,6839,6825,7590,50440
74836,204,198,180,126,36,110,171,1025
74837,242,296,396,424,510,494,310,2672
74839,709,682,669,719,708,651,770,4908
74840,1926,1865,1904,1760,1622,1608,1924,12609
74842,130,103,124,90,94,120,135,796
74843,315,350,334,351,335,327,340,2352
74844,375,361,342,271,261,291,371,2272
74845,516,554,640,669,670,645,494,4188
74848,8295,8186,8289,8387,8321,8119,8326,57923
74849,3206,3364,3307,3256,3158,3158,3132,22581
74850,292,362,351,383,436,459,283,2566
74851,10214,10100,9804,9712,9785,10001,9805,69421
74852,1401,1376,1170,1265,1479,1586,1347,9624
74854,1845,1582,1604,1609,1724,1749,1897,12010
74855,4898,5160,4967,5258,5354,5280,4639,35556
74856,779,746,773,827,890,831,782,5628
74857,8413,8157,7930,7746,8076,8163,9288,57773
74859,5995,6059,6003,6250,6269,6254,6221,43051
74860,1726,1778,1947,1928,2192,2128,1653,13352
74864,5566,5380,5417,5329,5248,4929,5274,37143
74865,1828,1754,2027,2072,1981,1969,1711,13342
74867,809,1016,1036,1077,1150,1053,1045,7186
74868,13713,13666,13537,13138,12771,12488,13152,92465
74869,824,868,825,979,691,672,710,5569
74871,2198,2330,2184,2198,2155,2088,2415,15568
74872,3637,3527,3565,3664,3712,3547,3692,25344
74873,11597,11909,11961,12363,12327,11895,11821,83873
74875,1310,1410,1275,1405,1318,1393,1165,9276
74878,1520,1474,1621,1537,1517,1386,1565,10620
74880,2233,2328,2330,2211,1993,1994,2239,15328
74881,4867,4508,4489,4053,4064,4039,4509,30529
74883,2529,2489,2489,2279,2448,2551,2526,17311
74884,5804,5765,5851,6092,5900,5979,6024,41415
74901,1912,1915,1954,1927,1984,2116,1992,13800
74902,4067,4041,4079,4077,4098,4107,4095,28564
74930,2094,2180,2001,1910,1901,1853,2155,14094
74931,1217,1394,1332,1443,1644,1751,1411,10192
74932,2576,2500,2535,2569,2666,2691,2286,17823
74935,187,145,165,153,148,135,174,1107
74936,1209,1230,1253,1276,1608,1630,1153,9359
74937,5745,5898,5963,5975,5662,5335,5959,40537
74939,1251,1310,1434,1433,1499,1530,1455,9912
74940,2724,2493,2372,2442,2632,2706,2697,18066
74941,2735,2706,2769,2748,2529,2588,2713,18788
74942,170,177,197,208,219,207,193,1371
74943,108,141,123,93,91,108,112,776
74944,1144,1155,1184,1195,1273,1215,1272,8438
74945,470,435,434,538,560,603,497,3537
74946,143,137,132,149,130,168,137,996
74948,12202,12672,12521,12616,12709,12553,12788,88061
74949,312,289,268,315,332,310,308,2134
74951,1276,1323,1509,1530,1581,1650,1504,10373
74953,11742,11946,11502,11747,12020,11841,11632,82430
74954,4750,4700,4709,4631,4838,4887,4590,33105
74955,14983,15093,15093,14782,14688,14266,15344,104249
74956,1969,2055,2234,2269,2198,1990,1905,14620
74957,1129,1127,1055,945,960,1004,1170,7390
74959,7192,6970,6638,6603,6303,6573,6736,47015
74960,13841,13439,13371,13339,12814,12995,13643,93442
74962,4866,4661,4916,5214,5153,5541,5092,35443
74963,525,600,624,734,763,678,608,4532
74964,2561,2494,2632,2721,2444,2579,2834,18265
74965,4899,5342,5573,5511,5737,5632,5170,37864
74966,3538,3501,3837,3653,3720,3745,3719,25713
75001,14421,14128,13766,13214,13033,12510,12414,93486
75002,68863,68347,66679,65900,64067,62175,63140,459171
75006,50038,49620,48583,47590,46557,45931,46364,334683
75007,54312,53513,52541,51405,51735,50921,51624,366051
75009,10220,9409,9196,8975,8342,8418,8785,63345
75010,25738,24529,23752,24035,22848,22756,21607,165265
75013,37548,35568,33889,31388,29971,28059,30347,226770
75019,40863,40610,40021,39551,39212,38797,38666,277720
75020,22256,22325,22286,22343,22525,22691,21872,156298
75021,8288,7995,8264,8306,8004,8212,8036,57105
75022,24035,23626,23143,22884,22449,22132,22545,160814
75023,49254,47787,46431,46733,46339,46001,45452,327997
75024,40964,40843,39839,38889,37708,35478,36039,269760
75025,52806,53483,52758,51924,51202,50894,50926,363993
75028,46037,45225,44588,43753,42878,42198,42226,306905
75032,31174,30877,30494,29965,29088,28271,27986,207855
75034,90512,85700,80917,75490,71123,66738,72723,543203
75035,60745,56427,53620,51444,48691,45684,47553,364164
75038,29218,29643,29282,28161,27393,26696,27802,198195
75039,16088,14724,13410,12197,10932,9438,11032,87821
75040,61947,60948,60638,59792,59244,59208,59406,421183
75041,32672,32098,32153,30684,29793,29202,30700,217302
75042,39362,40264,39230,40185,39193,38626,37881,274741
75043,60025,60452,59179,58120,57596,57259,58094,410725
75044,40854,40623,41222,41578,42012,41234,40811,288334
75048,23329,22585,21790,20930,20215,19310,20328,148487
75050,41660,41765,40819,40652,39994,39375,41041,285306
75051,40929,42711,42546,41345,40023,38989,39285,285828
75052,92546,91137,90611,89743,89829,87647,88996,630509
75054,9875,7366,6919,6256,4769,4244,5053,44482
75056,55373,53186,51534,49514,48266,46421,47852,352146
75057,14382,13749,13800,13749,13194,12911,12900,94685
75058,2759,2872,3286,3238,3145,3075,2982,21357
75060,48578,47538,47608,46409,46617,45866,45980,328596
75061,54122,53328,53303,53233,52243,52571,53442,372242
75062,48724,47347,46469,46200,46027,44774,44537,324078
75063,37317,38233,36670,36425,35443,35826,35090,255004
75065,12037,11537,11369,11033,11029,10764,10748,78517
75067,66493,66088,63167,61816,60477,59936,60982,438959
75068,49620,46216,42162,38950,36021,32804,34934,280707
75069,36631,36245,35321,34471,34635,33267,34108,244678
75070,88939,85063,82195,78837,74753,70901,74734,555422
75071,45875,43547,41096,38811,36928,35077,36090,277424
75074,48763,47916,47436,46606,45573,43797,44622,324713
75075,36385,35558,34345,33884,33529,33509,33262,240472
75076,7440,7542,7327,7541,7666,6959,7378,51853
75077,35782,35890,36658,36560,36773,36361,35330,253354
75078,17214,15080,13229,11683,10823,9685,10592,88306
75080,48315,47897,46820,45616,44601,44061,44009,321319
75081,37383,35269,34579,34286,34138,33574,34156,243385
75082,23315,23014,22417,21670,21336,21075,21182,154009
75087,31900,31253,30632,29630,29292,27499,28145,208351
75088,25288,25827,26083,26237,25394,25285,24712,178826
75089,32605,31461,30352,29640,29539,28701,30251,212549
75090,24002,23860,23908,23833,23298,22844,23724,165469
75092,23632,23404,22633,22382,22803,22971,22839,160664
75093,48006,47883,48249,46990,46690,47905,47187,332910
75094,22683,22159,21541,20536,20029,19605,20579,147132
75098,52063,50835,49571,48611,46887,44861,48197,341025
75101,620,607,664,584,589,671,646,4381
75102,1310,1261,1173,1261,1118,1076,1322,8521
75103,13456,13487,13037,13103,13526,13873,12851,93333
75104,47875,47571,46818,45935,45349,44213,45373,323134
75105,153,135,148,205,283,295,301,1520
75109,4154,4308,4047,4191,4330,4044,3658,28732
75110,28631,28648,28247,27901,27458,28034,28132,197051
75114,5350,4874,4555,4548,4467,4410,4660,32864
75115,51664,51147,50619,49839,48860,47656,48877,348662
75116,20031,20465,20404,20135,19635,19403,19669,139742
75117,3732,3505,3423,3307,3205,3069,3722,23963
75119,26956,26853,26631,25867,25687,25723,26601,184318
75124,4241,4083,4376,4052,4160,4253,4446,29611
75125,6048,5739,6170,6959,6904,7046,6691,45557
75126,39766,37042,35767,33914,31825,30324,33396,242034
75127,1781,1862,1763,1459,1629,1581,1593,11668
75132,1483,1093,1014,521,391,268,294,5064
75134,21960,21397,21077,19910,20153,19872,20276,144645
75135,6655,6312,5545,5223,4944,5124,5910,39713
75137,19568,19102,18911,18865,18955,18795,18861,133057
75140,6718,6843,6857,6889,6811,7409,6958,48485
75141,5796,5672,5358,5347,5258,4964,5374,37769
75142,18791,18020,18240,18690,18920,19111,18982,130754
75143,14570,15970,16175,15932,16073,15587,14619,108926
75144,3431,3083,3369,3482,3394,3296,3291,23346
75146,18734,18887,18217,18567,17432,16598,17993,126428
75147,6947,7716,8376,8475,7897,8020,6602,54033
75148,5918,5987,6408,6436,6706,6842,5842,44139
75149,56367,56366,56970,58427,56253,56358,56065,396806
75150,60986,60810,60450,58143,58538,57354,58730,415011
75152,5281,5185,5376,5908,5577,4801,4606,36734
75153,461,452,687,701,665,750,605,4321
75154,39438,38440,37193,36411,35067,34546,36041,257136
75155,2870,2795,2762,2670,2673,2614,2579,18963
75156,15263,14920,14918,14633,14538,14516,14580,103368
75157,281,303,305,292,382,399,310,2272
75158,4106,4171,3955,4291,4359,4883,4139,29904
75159,19001,18861,18800,18379,18322,17403,18339,129105
75160,24251,24830,23779,23068,23102,22285,23627,164942
75161,6743,6953,6642,6610,6859,6507,6165,46479
75163,2231,1837,1813,1643,1899,1863,2285,13571
75164,607,602,557,423,457,435,671,3752
75165,41162,40835,39270,38526,38251,37086,37966,273096
75166,3934,3657,3606,3723,3381,3131,3070,24502
75167,10178,10372,10285,9891,9842,9516,8436,68520
75169,13365,13292,13911,14334,14813,14507,14644,98866
75172,4034,4050,3964,4015,3965,4034,3956,28018
75173,4040,4203,4618,4601,5175,4845,4353,31835
75180,24099,24011,23706,23360,22861,22497,23031,163565
75181,27771,27929,27085,26200,26498,25987,25908,187378
75182,5871,5677,5455,5292,5085,4838,5118,37336
75189,24651,23167,22418,22192,20634,20505,22406,155973
75201,13562,12009,11154,10213,9331,8380,9409,74058
75202,2236,2206,2063,2133,2005,2060,1666,14369
75203,16441,15549,15207,15514,16232,16370,15721,111034
75204,29467,28672,27366,26586,26207,26200,26279,190777
75205,24076,24050,23669,23384,24116,23658,23061,166014
75206,38559,38826,37523,37198,36320,36579,36248,261253
75207,8469,8932,9455,9561,9738,9631,9648,65434
75208,29767,30139,31426,31299,32077,30743,30171,215622
75209,14114,14430,14775,15312,14971,14215,13653,101470
75210,8133,7365,6683,6125,5927,5795,7482,47510
75211,77608,76261,75924,73530,73775,72169,73146,522413
75212,26245,26043,26059,25756,24997,24693,24884,178677
75214,34082,33815,33516,33460,32293,32662,32950,232778
75215,15145,14645,14490,14118,14430,13931,14648,101407
75216,51466,51133,49312,49342,47558,47031,49416,345258
75217,82582,82353,83121,82664,82842,82620,80324,576506
75218,22282,22264,23153,22743,22103,22708,21665,156918
75219,22914,22237,21335,21700,20965,20636,22124,151911
75220,43253,44450,44617,43762,43459,43840,41891,305272
75223,13975,13573,12988,12583,13191,12878,13947,93135
75224,34728,35655,35345,34640,33942,34635,34034,242979
75225,21231,21001,20958,20770,20047,20380,20892,145279
75226,4032,3571,3582,3265,2811,3091,3506,23858
75227,57604,57876,56847,56594,56150,55374,55029,395474
75228,74362,73579,71851,70699,68605,65998,66551,491645
75229,32677,32806,32986,33371,32820,32711,31571,228942
75230,27144,27052,26444,27027,26717,26779,26934,188097
75231,39754,37979,35600,34227,34306,35249,37052,254167
75232,29188,29155,27953,27317,26426,27546,28682,196267
75233,16104,15373,14915,14431,14633,14053,14043,103552
75234,31728,30682,29594,29180,28726,28640,28794,207344
75235,18138,18914,18923,18864,19334,18493,17177,129843
75236,17762,16406,16087,15264,15081,15073,15949,111622
75237,19634,19312,18795,17203,17952,17038,17101,127035
75238,32714,31362,30242,30594,29853,29204,30483,214452
75240,26213,26603,27234,27050,25813,24639,24296,181848
75241,29117,29362,29658,29586,28162,27978,27066,200929
75243,65351,61406,60064,56910,55747,55142,55406,410026
75244,13127,13351,13400,13170,13247,13253,13266,92814
75246,2547,2895,2499,2604,3022,3018,2770,19355
75247,661,629,538,546,509,447,468,3798
75248,36308,35236,34828,34902,34911,34614,33395,244194
75249,15767,14496,13795,14172,13684,12900,13373,98187
75251,2602,2876,2991,2945,2910,2625,2331,19280
75252,26075,25749,25482,24898,25129,24680,24112,176125
75253,20881,19514,19016,18370,16873,18287,18450,131391
75254,25785,25375,24953,24138,24097,24277,23253,171878
75270,0,0,0,0,0,0,0,0
75287,53116,52559,51145,50416,49403,49560,49004,355203
75390,0,0,0,0,0,0,0,0
75401,18589,18219,18729,18566,18743,18903,18552,130301
75402,16311,17047,15930,16029,15846,15777,15920,112860
75407,15633,15932,15117,14871,14085,14203,14120,103961
75409,13485,13056,12077,11488,11766,11495,11831,85198
75410,5126,4452,4347,4259,4018,3879,4334,30415
75411,1168,1276,1148,1257,1165,1273,1118,8405
75412,413,525,667,742,916,994,778,5035
75413,196,224,242,235,243,242,305,1687
75414,3226,3262,3172,3424,3265,3196,3136,22681
75415,154,174,209,190,168,207,144,1246
75416,2857,2444,2648,2762,3178,3220,2893,20002
75417,2648,2479,2543,2400,2502,2476,2456,17504
75418,13917,14076,14084,13672,13918,13738,14411,97816
75420,931,1084,991,924,873,878,1076,6757
75421,961,1018,1104,1112,941,1001,1003,7140
75422,2955,2726,2572,2659,2783,2533,2883,19111
75423,2742,2788,2915,3135,3238,3077,2982,20877
75424,3809,3638,3649,3548,3113,3198,3297,24252
75426,5144,5064,5095,4802,4576,4817,5301,34799
75428,10527,10428,10372,10233,10183,10037,10089,71869
75431,2135,1922,2013,1761,1862,2089,2052,13834
75432,3603,3516,3513,3503,3372,3174,3323,24004
75433,2810,2839,2785,2908,2917,2770,2773,19802
75435,1513,1797,1770,1526,1482,1283,1185,10556
75436,1969,2035,1849,2076,2041,1938,1876,13784
75437,1328,1286,1302,1258,1264,1198,1078,8714
75438,941,931,886,932,970,1092,972,6724
75439,939,1179,1179,1017,957,809,868,6948
75440,6404,6429,6722,6721,6759,6754,6350,46139
75441,109,90,57,98,118,154,142,768
75442,10010,9740,9960,9078,9379,9167,8858,66192
75446,3575,3252,3488,3488,3048,2982,3180,23013
75447,1126,1063,1091,1144,1072,888,1080,7464
75448,602,570,476,493,530,458,655,3784
75449,1327,1221,1199,1315,1094,1149,1186,8491
75450,190,344,412,391,347,453,331,2468
75451,1014,905,655,804,823,983,1211,6395
75452,4612,4524,4456,4671,4634,4497,4090,31484
75453,3333,3333,3315,3040,3112,2975,3255,22363
75454,8125,7109,6471,5800,5288,4729,5699,43221
75455,28609,28835,28519,28492,27801,27772,28293,198321
75457,6081,6340,6271,6116,5883,6256,6522,43469
75459,4880,4694,4779,4541,4104,4286,4326,31610
75460,22293,22422,22319,22753,23183,23550,23592,160112
75462,11761,11895,11804,11650,11313,11149,11350,80922
75468,881,672,561,679,676,990,888,5347
75469,448,425,463,418,545,601,371,3271
75470,430,433,327,243,179,79,288,1979
75471,1299,1276,1413,1204,1185,1301,1424,9102
75472,3804,3690,3610,3652,3679,3696,3548,25679
75473,3897,3967,4393,4350,4303,3959,3855,28724
75474,15967,15049,15127,14631,14438,14545,14882,104639
75475,189,140,129,228,141,165,129,1121
75476,1121,1084,1144,1067,1433,1679,1304,8832
75477,950,895,943,893,816,732,977,6206
75478,877,1034,878,1046,1232,1084,932,7083
75479,1756,1707,1658,1743,1876,2083,1849,12672
75480,1938,1675,1972,2001,2123,2093,1646,13448
75481,366,428,397,425,534,486,395,3031
75482,24895,24834,24951,25000,24593,24557,24385,173215
75486,2555,2527,2394,2260,2365,2349,2346,16796
75487,1587,1354,1314,1221,1560,1268,1541,9845
75488,834,987,954,1069,1068,914,1161,6987
75489,968,902,1009,1033,1082,1072,993,7059
75490,2267,2225,2422,2332,2263,2639,2211,16359
75491,5492,5436,5404,5214,4884,4490,4801,35721
75492,462,421,384,486,518,501,516,3288
75493,513,609,657,582,712,598,611,4282
75494,9759,10033,9927,10010,10106,10323,10862,71020
75495,7318,7034,6761,6737,6906,6807,7095,48658
75496,3063,3450,3614,3460,3401,3534,3351,23873
75497,3876,3476,3077,3406,3253,3126,3350,23564
75501,36039,36417,36260,36752,36888,37083,36298,255737
75503,25255,24978,24879,24633,24032,23923,24379,172079
75550,859,907,932,993,950,972,808,6421
75551,11187,11268,10479,10547,10738,10584,11007,75810
75554,1739,1661,1602,1727,1970,1903,1806,12408
75555,1400,1328,1517,1560,1559,1851,1611,10826
75556,1137,1100,1078,920,1084,1045,1133,7497
75558,1771,1555,1736,1733,1545,1189,1636,11165
75559,5104,5294,5593,5922,6141,6307,5568,39929
75560,807,936,970,1088,998,1014,1088,6901
75561,5280,5298,5393,5337,5463,5599,5395,37765
75562,56,34,107,77,71,342,176,863
75563,4896,4751,4461,4511,5089,4953,4282,32943
75565,292,301,379,390,371,353,361,2447
75566,669,594,779,882,951,868,782,5525
75567,5346,5010,5198,4321,4543,3945,4225,32588
75568,2476,2508,2987,2634,2826,2737,2876,19044
75569,3144,3069,3050,2987,2951,2889,2874,20964
75570,11063,11077,10681,10583,9953,9446,11518,74321
75571,2948,2721,2806,2869,2911,3158,2846,20259
75572,3999,3801,4009,3980,3558,3189,3491,26027
75573,55,38,35,31,57,182,181,579
75574,1808,1828,1834,2130,2169,2239,1868,13876
75601,16083,16925,17102,16078,16353,16452,15849,114842
75602,22016,22756,22237,22367,22369,22339,23286,157370
75603,5679,5829,5741,5842,5833,5951,5456,40331
75604,31860,31428,30851,31332,31398,31180,29934,217983
75605,29242,28911,28847,28650,27400,26302,27823,197175
75630,2330,2242,2697,2566,2546,2902,2588,17871
75631,3021,2796,2620,2627,2290,2403,2787,18544
75633,14119,14874,15002,15253,15197,14876,13977,103298
75638,6127,6572,6330,6176,5790,5756,6036,42787
75639,2790,2839,2681,2707,2795,2801,3460,20073
75640,4678,4185,4220,4052,3528,3938,4652,29253
75641,208,269,231,227,264,206,223,1628
75642,27,66,57,138,217,269,229,1003
75643,2420,2353,2437,2230,2145,2103,2074,15762
75644,12700,12012,11248,11485,11325,10862,11444,81076
75645,9504,10029,10278,10136,10306,10737,9778,70768
75647,12249,12537,12853,13431,13418,14060,13196,91744
75650,9005,7764,8030,7972,8508,8586,8611,58476
75651,2423,2608,2891,2905,2395,2155,2189,17566
75652,17178,17324,16438,16185,16335,16419,16638,116517
75654,12340,11970,12318,12300,12139,12868,12417,86352
75656,4483,4771,4859,4933,4523,4514,4804,32887
75657,7871,8021,7754,7960,8013,7816,8246,55681
75661,3176,2931,2703,2601,2131,2031,2807,18380
75662,26015,25335,25238,24768,24080,23611,24536,173583
75667,936,1033,989,989,1016,1128,1021,7112
75668,2022,1927,1828,1974,2233,2163,1993,14140
75669,641,605,580,651,785,795,606,4663
75670,17335,18184,18783,18448,18981,18732,17290,127753
75672,16291,16310,16599,17080,16710,17042,17097,117129
75681,2292,2195,2582,2539,2321,2051,2562,16542
75682,489,518,582,616,610,541,473,3829
75683,4040,4351,4190,3993,4003,3758,3914,28249
75684,7896,8288,8765,8114,7614,7043,7548,55268
75686,13096,12987,13486,12977,12981,13123,12985,91635
75691,2810,2817,3180,3554,4319,4301,4219,25200
75692,4967,4688,4776,4682,4929,4822,5098,33962
75693,7005,6951,6734,6743,6819,6772,6869,47893
75701,35065,35865,35448,35348,35443,35214,34373,246756
75702,28508,27962,26684,26684,26345,26553,27069,189805
75703,39482,37336,37410,36801,36854,36491,37166,261540
75704,9074,9152,9456,8714,7941,7925,8684,60946
75705,2413,2185,2435,2111,2404,2241,2168,15957
75706,10501,9069,9362,9500,10165,9729,8771,67097
75707,14938,14916,14997,14906,14536,13453,13711,101457
75708,7236,7540,7255,6463,6242,6784,7156,48676
75709,4923,4761,5028,5392,5280,5012,5062,35458
75750,3602,3952,3511,3594,3363,3104,3937,25063
75751,17093,17029,16839,17235,17098,17142,17253,119689
75752,7198,7104,7058,6647,6713,6349,6986,48055
75754,6166,5752,5443,5784,5623,4971,5783,39522
75755,5766,5778,5997,5896,5978,5142,5719,40276
75756,4634,4353,3774,3752,3672,3897,4002,28084
75757,11774,11246,11118,10662,10495,10331,10022,75648
75758,8261,8229,8303,8613,8489,8371,9072,59338
75759,68,88,133,148,170,155,141,903
75760,2533,2277,2592,2255,2224,2334,2614,16829
75762,12756,12579,12664,12900,12686,12773,12466,88824
75763,5875,5843,6237,6499,6866,7453,6005,44778
75764,177,144,120,111,61,71,233,917
75765,7423,7616,7927,8101,8125,8333,7607,55132
75766,26393,26495,26430,25952,25611,25820,26388,183089
75770,3022,3376,3640,3327,2962,3073,2776,22176
75771,20775,21403,19213,18912,18104,17321,18361,134089
75773,13031,12816,12310,12343,12443,12171,12791,87905
75778,3027,3255,3349,3534,3695,3878,3254,23992
75779,183,124,145,161,144,122,122,1001
75780,428,377,436,187,205,68,312,2013
75783,7568,7759,7943,7486,7527,7306,7219,52808
75784,841,1002,976,704,654,597,658,5432
75785,10729,10882,10797,11457,11917,11502,11263,78547
75788,123,221,257,172,167,122,126,1188
75789,6823,6942,7243,6998,6861,6847,7593,49307
75790,4905,4607,4327,4109,3630,3678,4203,29459
75791,13679,13691,13476,13459,13014,13175,13125,93619
75792,2847,3217,3375,3346,3429,3187,3518,22919
75801,16152,16187,16507,16186,16841,16862,16799,115534
75803,23198,23446,23523,24714,24637,24415,22397,166330
75831,5554,5772,6119,5920,5850,6014,5386,40615
75832,124,121,48,41,39,38,66,477
75833,3865,3849,3720,3392,3291,3018,3324,24459
75835,10847,11041,11152,11514,12216,13047,12012,81829
75838,669,570,624,671,690,314,666,4204
75839,4930,4766,5081,5204,5615,5932,5069,36597
75840,7043,6965,7061,7111,7053,6791,7076,49100
75844,6573,6238,6350,6166,5987,5886,5718,42918
75845,3493,3878,4656,4486,4548,4064,3259,28384
75846,2850,2848,2777,2938,2940,2771,2718,19842
75847,1773,1819,2027,1948,1993,1894,1859,13313
75848,120,82,108,105,121,120,92,748
75849,86,97,119,200,196,280,75,1053
75850,767,763,657,691,507,767,671,4823
75851,4504,4787,4541,4529,4073,3572,5050,31056
75852,5122,5161,5053,4773,4386,4224,3762,32481
75853,734,1028,1264,1236,1086,1473,963,7784
75855,2366,2213,2316,2308,2490,2460,2369,16522
75856,90,175,115,221,209,242,196,1248
75858,15,34,51,51,38,38,43,270
75859,1870,2044,2078,2140,2324,1932,1923,14311
75860,6185,6212,6229,6142,6205,6591,6644,44208
75861,8592,8288,7120,6119,5166,3948,9017,48250
75862,9696,9108,8439,8552,8412,8649,10091,62947
75901,31725,30698,30494,29847,28785,29355,29036,209940
75904,33573,34062,33150,33824,34585,34316,34004,237514
75925,3998,4173,4261,4449,4609,4570,4179,30239
75926,1054,1195,1157,1136,1219,1333,1070,8164
75928,831,986,1005,1038,1134,973,1411,7378
75929,1532,1777,1803,1630,1553,1630,1599,11524
75930,2073,1921,2156,1833,1545,1912,2023,13463
75931,2192,2450,2464,2321,2323,2275,2631,16656
75932,1828,1701,1716,1738,1546,1841,1437,11807
75933,1106,1048,1345,1358,1193,1190,1599,8839
75934,129,64,30,27,156,136,99,641
75935,13964,14137,14014,14124,13976,14031,13685,97931
75936,766,989,1016,1154,988,952,889,6754
75937,937,889,876,924,723,790,994,6133
75938,2739,2633,2399,2447,2392,2339,2608,17557
75939,4262,4222,4335,4032,3739,4084,3992,28666
75941,9043,9454,10381,10388,9759,9018,9105,67148
75942,171,242,207,289,147,171,115,1342
75943,1495,1409,1250,1305,1170,1261,1262,9152
75944,1461,1518,1566,1288,1250,1282,1301,9666
75946,3084,2979,3253,3474,3446,3327,3578,23141
75948,6096,6064,5978,6188,6068,5834,6281,42509
75949,6965,7157,7203,7130,7480,7619,7976,51530
75951,16034,15362,16180,16139,16120,16165,16134,112134
75954,3503,3311,3256,2977,3098,2820,3280,22245
75956,7819,7562,7005,7281,8201,8378,7623,53869
75959,863,691,763,1080,981,1017,923,6318
75960,963,736,829,858,908,759,913,5966
75961,15345,15519,15199,15085,14883,14647,14910,105588
75962,3180,3129,3217,3432,3526,3594,3029,23107
75964,19252,19135,19060,19648,19780,19021,20097,135993
75965,18994,19330,19038,18589,18454,18399,17591,130395
75966,4578,4602,4257,4236,4425,4921,5371,32390
75968,1565,1777,2028,1938,2012,2066,1766,13152
75969,3919,3815,3712,3401,3281,3300,4116,25544
75972,6345,6420,6230,6410,6996,6768,6620,45789
75973,2403,2325,2181,2565,2740,2781,2599,17594
75974,2845,3003,2935,2898,3056,3055,3126,20918
75975,3859,3658,3919,3678,3309,3464,3699,25586
75976,932,929,991,935,855,898,827,6367
75977,1270,1172,1371,1627,1266,948,750,8404
75978,114,33,38,87,108,92,144,616
75979,11825,11718,11695,11576,11269,10747,11423,80253
75980,2834,2966,2882,2717,2837,2576,2836,19648
76001,30903,30308,31228,31653,31533,31351,30460,217436
76002,33991,33758,32821,30925,30600,29515,30269,221879
76006,24141,23823,23768,23472,23771,22673,22639,164287
76008,15294,15003,14695,14320,13943,13555,13602,100412
76009,20167,20144,20362,19560,19964,19760,19759,139716
76010,59101,58674,57216,56512,54169,52501,55706,393879
76011,23541,22730,22216,22540,22590,23217,21594,158428
76012,26819,26423,26698,25891,24962,24679,25689,181161
76013,31797,30855,30505,31149,31753,33088,30680,219827
76014,35408,34933,34768,35175,34736,33508,34072,242600
76015,16617,16747,16823,16358,15662,14996,16658,113861
76016,30886,31811,31229,31599,31559,31288,30852,219224
76017,45894,45618,43896,42792,43245,43732,44724,309901
76018,29723,28507,28551,27765,27253,28043,26938,196780
76020,27047,26707,26937,26909,27284,26941,27270,189095
76021,35941,35729,34998,34655,33615,33354,33673,241965
76022,12795,12701,12947,12938,13737,13857,13212,92187
76023,5882,5392,5733,5781,6247,5975,5832,40842
76028,66391,64909,62853,62637,60235,57343,59744,434112
76031,17603,17840,17273,17360,16360,17622,17759,121817
76033,25354,24689,24047,24258,24303,24403,24819,171873
76034,25061,24542,23986,23528,23040,22542,22748,165447
76035,1455,1800,1512,1477,1403,1606,1622,10875
76036,24876,23377,22799,22396,21682,21704,22352,159186
76039,33308,33283,33222,32626,32396,32011,32925,229771
76040,31496,30531,30140,29699,28914,29254,27524,207558
76041,407,304,294,174,280,393,434,2286
76043,7578,7453,7434,7420,7377,7011,7071,51344
76044,3769,3749,3840,3777,3908,3739,3866,26648
76048,23299,22754,22773,22835,21471,21468,21989,156589
76049,27135,25854,24815,24179,25069,24476,25130,176658
76050,5593,5789,6066,5939,5912,5838,5875,41012
76051,50484,49599,48524,47488,46496,46152,46320,335063
76052,20371,18187,17688,16537,15990,14927,15995,119695
76053,29968,29809,29449,28767,28663,28476,28421,203553
76054,11917,11620,11328,11250,11222,11565,11764,80666
76055,2521,2744,2941,2857,3224,3248,3084,20619
76058,17735,17298,17787,18323,18491,17539,17123,124296
76059,5133,5119,5124,5171,5187,4799,4881,35414
76060,7294,7404,7109,6994,6993,6840,6764,49398
76061,84,188,153,182,137,196,152,1092
76063,67723,65707,64969,62321,60686,58291,61361,441058
76064,1622,1398,1342,1550,1558,1446,1883,10799
76065,32306,31097,30094,29127,28110,27449,28986,207169
76066,3195,3280,3045,3628,3658,3882,3142,23830
76067,20778,21343,21921,21997,21741,22358,22117,152255
76070,617,656,622,591,628,776,752,4642
76071,3830,3923,4103,3683,3450,3380,3320,25689
76073,5877,5802,5835,5409,5004,4732,5327,37986
76077,447,469,495,477,393,505,590,3376
76078,10682,10292,9017,8959,8822,8306,8572,64650
76082,18118,18247,17910,18598,18253,17956,17748,126830
76084,8389,8108,8319,8223,8398,8530,8327,58294
76085,9524,9250,8502,8061,8351,8492,8787,60967
76086,21462,21408,21038,20863,20448,19970,20196,145385
76087,27561,25926,24901,24842,24364,23164,24746,175504
76088,11298,11694,12135,12097,11762,11239,11499,81724
76092,29155,28371,27930,27236,26778,26254,26669,192393
76093,1629,1849,2182,2036,2517,2577,2095,14885
76102,9389,9377,9370,9122,8438,8642,8111,62449
76103,13685,14475,14124,14330,14863,14362,14572,100411
76104,17603,17415,16179,16020,15869,15912,17446,116444
76105,21626,21329,21917,21626,21607,21655,22194,151954
76106,38010,37706,37672,36761,36950,35004,35389,257492
76107,28298,27418,26882,25810,25642,25530,25917,185497
76108,41303,41264,40093,38783,37836,37041,38227,274547
76109,21988,22376,22337,21764,21488,21527,21710,153190
76110,30322,30399,30751,31023,31957,32256,30434,217142
76111,22665,23262,22239,21029,20891,19859,21685,151630
76112,40917,40416,39449,39447,38016,38361,38993,275599
76114,25632,25016,25198,25051,24302,23958,24741,173898
76115,20618,21060,20903,21695,20902,20581,20696,146455
76116,49081,47834,46903,46488,47726,47789,46746,332567
76117,30825,31439,32261,31010,31203,30786,30645,218169
76118,16002,15290,14865,14699,14184,13712,13866,102618
76119,47704,46223,44513,42440,41877,40228,42761,305746
76120,17811,18024,18275,17578,16463,16167,15283,119601
76123,30668,30939,30360,30398,30175,29948,29722,212210
76126,21214,20752,20450,20261,19646,19271,19395,140989
76127,1974,2007,2020,1964,1968,2025,2003,13961
76129,2968,2932,2802,2749,2735,2747,2833,19766
76131,35462,33894,32079,31311,29512,26828,28374,217460
76132,26545,25975,25376,24747,24978,24244,24709,176574
76133,51375,50642,50397,50558,48069,47394,48394,346829
76134,27439,26311,26249,24297,23985,22904,23704,174889
76135,22878,22217,21019,20550,20209,21055,20684,148612
76137,59092,57085,55272,54345,53252,53876,54911,387833
76140,29684,29406,28699,27671,26381,26084,26340,194265
76148,24228,23867,23723,23959,23919,23869,23331,166896
76155,4965,4104,3781,3643,3136,2617,3115,25361
76164,15612,16652,17501,17739,18541,18899,16748,121692
76177,7527,6470,6003,5306,4542,3848,4891,38587
76179,55052,52684,50790,49578,47335,44736,48058,348233
76180,35872,35085,34498,33674,33325,32820,33444,238718
76182,30635,30016,29432,29602,28996,28601,28209,205491
76201,27138,27162,26461,26557,27210,27410,27107,189045
76205,21219,20911,19792,18680,17732,17274,18510,134118
76207,13309,13146,12447,11477,10384,9474,10579,80816
76208,22367,20106,19803,19644,19233,19041,19782,139976
76209,24921,25550,25839,25756,25487,24910,24018,176481
76210,43819,42894,42264,41180,40132,39509,39556,289354
76225,3278,3310,3333,3377,3348,3246,3156,23048
76226,22953,21790,20660,19896,18909,17765,18419,140392
76227,27538,25683,24821,23268,22013,20372,22141,165836
76228,881,1022,1098,1042,1089,1052,1119,7303
76230,9390,9431,9579,9827,9898,10065,9711,67901
76233,3397,3496,3214,3334,3471,3517,3235,23664
76234,15447,15571,15807,15372,14949,15016,15587,107749
76238,426,424,490,397,428,348,431,2944
76239,1089,1168,1191,1050,1214,1209,1087,8008
76240,27007,26822,26968,26332,26257,26049,26120,185555
76244,72474,69564,66072,64081,59597,55083,60388,447259
76245,1673,1655,1814,1508,1714,1933,1780,12077
76247,13191,12728,12070,12283,12566,12498,13098,88434
76248,38437,37069,36056,35660,35003,34181,34647,251053
76249,7918,7783,7167,6777,6537,6498,7194,49874
76250,890,954,953,936,912,963,937,6545
76251,666,642,628,733,787,787,731,4974
76252,2760,2890,3001,3092,3368,3195,2863,21169
76253,268,302,287,218,194,172,230,1671
76255,5435,5575,5466,5352,5336,5524,5411,38099
76258,7041,7015,6210,6022,6093,5812,6659,44852
76259,5163,4883,5021,4831,4847,4581,4618,33944
76261,274,298,321,367,352,287,233,2132
76262,33531,34166,32806,30940,29880,27337,27648,216308
76263,68,88,73,27,43,37,44,380
76264,1453,1358,1300,1259,1084,989,1412,8855
76265,1901,2001,1987,1815,1638,1473,1893,12708
76266,15098,14986,14580,14729,13477,13900,13495,100265
76268,236,176,186,201,156,168,250,1373
76270,1875,1474,1686,1770,1736,1774,1853,12168
76271,1671,1528,1378,1310,1217,1064,1352,9520
76272,4462,4717,4598,4980,5007,4861,4745,33370
76273,9007,8496,8140,8562,8570,9169,9135,61079
76301,15694,16086,16424,17052,17137,17279,16540,116212
76302,13750,13657,13484,13126,13216,12963,13206,93402
76305,4541,4605,4648,4510,4659,4473,4746,32182
76306,15078,14935,15121,15200,15103,15486,15991,106914
76308,19063,19055,18694,19509,19586,20727,19677,136311
76309,13145,13226,13828,13293,13099,12841,13862,93294
76310,18598,18573,18561,18492,18369,17352,17989,127934
76311,7762,7239,6336,5925,6073,6659,7535,47529
76351,1723,1846,1791,1760,1682,1811,2035,12648
76354,11655,11308,11246,11256,11090,11159,11270,78984
76357,663,632,590,626,704,679,712,4606
76360,3322,3384,3477,3457,3537,3763,3502,24442
76363,346,327,266,245,278,353,256,2071
76364,154,187,175,168,188,165,193,1230
76365,4547,4633,4670,4813,5024,5234,4831,33752
76366,2024,2298,2494,2298,2382,2283,2317,16096
76367,15597,15622,15116,14596,14227,13732,13045,101935
76370,243,234,262,266,312,369,299,1985
76371,1702,1683,1675,1633,1531,1536,1606,11366
76372,1243,1093,864,916,945,966,974,7001
76373,216,207,169,281,231,148,162,1414
76374,3910,3880,3978,3916,3883,3716,4162,27445
76377,931,875,827,787,716,772,802,5710
76379,716,693,707,715,755,679,591,4856
76380,3692,3656,3719,3743,3805,3824,3820,26259
76384,12486,12588,12745,12748,12815,12948,12991,89321
76388,246,283,245,303,294,340,203,1914
76389,1293,1286,1203,1332,1277,1252,1329,8972
76401,29037,28168,27015,26435,25657,25320,25702,187334
76402,838,802,860,947,947,1102,847,6343
76424,9207,8894,8915,8961,9016,9150,8992,63135
76426,11622,11146,11204,10901,10625,11131,11302,77931
76427,1036,1074,1074,1225,1040,1102,804,7355
76429,171,141,187,131,101,70,258,1059
76430,2542,2697,2767,2721,2683,2561,2532,18503
76431,3126,3691,3318,3525,3573,3305,3384,23922
76432,1220,1292,1250,1172,1348,1397,1370,9049
76433,1410,1374,1650,1808,1933,1909,1416,11500
76435,605,557,540,569,555,570,612,4008
76436,260,196,108,102,151,96,212,1125
76437,5292,5424,5648,5736,5614,5559,5721,38994
76442,7480,7673,7815,7898,7804,7457,7545,53672
76443,2002,1809,2011,1813,1930,1828,1897,13290
76444,3365,3284,3228,3327,3355,3643,3635,23837
76445,363,234,291,343,349,222,407,2209
76446,8146,8323,8518,8295,8573,8332,9000,59187
76448,5077,5281,5379,5330,5622,5515,5628,37832
76449,2428,2509,2416,2351,2457,2283,2434,16878
76450,13320,13329,13468,13652,13567,13276,13258,93870
76452,83,76,88,76,70,54,75,522
76453,1207,1091,1106,1082,936,981,1125,7528
76454,1500,1488,1578,1406,1524,1871,1688,11055
76455,1235,1231,1027,995,905,971,1014,7378
76457,4088,4260,4604,4501,4106,4052,3960,29571
76458,6056,5958,5982,5962,6220,5899,6261,42338
76459,194,187,155,182,206,184,146,1254
76460,467,493,461,447,376,602,421,3267
76462,2922,2766,3352,3221,3256,3058,2982,21557
76463,433,564,579,624,608,489,481,3778
76464,507,528,452,442,355,380,506,3170
76466,238,178,206,161,251,182,332,1548
76469,48,43,26,20,55,73,96,361
76470,3872,3949,3550,3557,3569,3595,3238,25330
76471,2170,1987,1974,2020,1703,1687,1906,13447
76472,1512,1604,1627,1282,1532,1612,1499,10668
76474,260,253,300,288,318,300,281,2000
76475,844,789,833,824,961,1056,977,6284
76476,2555,2799,3023,2789,2899,3107,2637,19809
76481,156,233,311,184,224,298,208,1614
76483,977,976,993,840,885,995,1063,6729
76484,923,890,972,1021,1044,982,1147,6979
76486,1132,1244,1210,1267,1406,1632,1375,9266
76487,2596,2540,2150,1901,1835,1716,2507,15245
76490,40,35,55,125,94,131,91,571
76491,311,404,399,584,597,623,459,3377
76501,18490,17645,17347,16869,16109,16439,16897,119796
76502,36349,34743,33794,33305,33426,32200,31545,235362
76504,23127,23412,23415,23039,22583,22464,24268,162308
76508,9,9,8,7,5,5,0,43
76511,2849,2753,2499,2409,2062,2000,3317,17889
76513,37275,36703,36203,35001,33555,32076,34172,244985
76518,1554,1410,1536,1542,1481,1371,1581,10475
76519,710,935,737,853,803,589,626,5253
76520,8054,7607,7562,7813,7808,8071,8413,55328
76522,36568,36047,36479,36207,36085,35185,35534,252105
76523,0,0,0,0,0,0,18,18
76524,3505,3169,3500,3494,3014,2555,2867,22104
76525,1013,1059,993,1113,1114,1235,1062,7589
76527,3752,4086,4154,3965,3633,3830,4058,27478
76528,16267,16642,17583,18519,18619,19623,16974,124227
76530,2160,2550,2645,2410,2345,2428,2540,17078
76531,4523,4723,4567,4685,4938,5180,4978,33594
76534,2650,2323,2138,2185,2055,1861,2615,15827
76537,4774,4314,3939,4075,3803,3410,3870,28185
76538,900,828,774,876,884,763,761,5786
76539,8494,8292,8071,8042,7248,7415,7841,55403
76541,18440,17703,17608,18976,18932,19970,19206,130835
76542,48239,45657,44028,40797,39631,37781,40025,296158
76543,29385,29891,30103,29588,29806,30924,30430,210127
76544,28683,31186,32501,33143,35268,35172,29943,225896
76548,28731,28415,27850,26965,26407,25625,26344,190337
76549,49175,49454,48785,48388,45638,41873,44490,327803
76550,12343,11700,11854,11814,12168,11671,11586,83136
76554,2336,2032,1996,1955,1913,1815,2104,14151
76556,1114,1340,1430,1392,1577,1894,1461,10208
76557,4747,4469,4424,4877,4816,4718,5178,33229
76559,5419,5298,5014,4898,4818,4474,5051,34972
76561,957,1056,974,1040,859,979,962,6827
76565,34,33,33,52,27,25,74,278
76566,324,336,345,212,195,252,258,1922
76567,8913,9054,9049,9097,9198,8911,8984,63206
76569,2198,2314,2193,1943,1992,1840,2498,14978
76570,2724,2783,2793,2856,2652,2730,2572,19110
76571,6433,5974,5760,5747,5771,5816,6790,42291
76573,23,35,34,16,45,65,26,244
76574,18502,18281,18135,18037,17775,17213,17661,125604
76577,3309,3313,3305,3349,3468,3413,3046,23203
76578,1482,1360,1381,1709,1714,1659,1766,11071
76579,4067,4305,4240,4628,4693,4989,4258,31180
76596,1323,1330,1164,999,956,781,1274,7827
76597,2832,2786,2354,1971,1430,553,2882,14808
76598,555,574,483,410,390,271,523,3206
76599,2014,2093,1711,1480,1239,942,1956,11435
76621,937,1023,1145,1021,1130,1268,1037,7561
76622,1101,1153,1006,1161,1083,1066,1015,7585
76623,134,160,146,145,165,217,242,1209
76624,2140,2216,2096,2150,2151,2271,2231,15255
76626,1352,1578,1632,1841,1922,2020,1563,11908
76627,1538,1572,1611,1616,1771,1879,1601,11588
76628,59,64,79,91,93,53,111,550
76629,1722,1694,1819,1895,1816,1907,1989,12842
76630,1115,1407,1355,1567,1925,1798,1840,11007
76631,530,466,486,516,478,591,522,3589
76632,1337,1274,1597,1407,1506,1866,1778,10765
76633,5611,6030,5759,6072,5570,5164,4973,39179
76634,6932,6553,6657,6488,7054,7121,7093,47898
76635,1288,1163,1423,1425,1493,1423,1341,9556
76636,1444,1497,1404,1535,1515,1548,1497,10440
76637,549,533,603,587,445,435,536,3688
76638,3134,2907,3183,3083,2960,3593,2837,21697
76639,1409,1308,1551,1449,1588,1575,1584,10464
76640,3159,3055,2481,3183,3279,3530,3005,21692
76641,1767,1799,1852,1724,1809,1630,1674,12255
76642,7151,7007,7256,7273,7268,6964,7057,49976
76643,14128,14022,13905,13724,13494,13277,13554,96104
76645,10717,10962,11179,11339,11357,11004,11039,77597
76648,2806,2916,2570,2565,2669,2829,2302,18657
76649,772,786,791,770,705,623,790,5237
76650,113,103,93,68,48,65,104,594
76651,3216,3153,3335,3247,3011,3134,3300,22396
76652,1194,1178,953,958,895,764,1087,7029
76653,967,907,929,877,1034,1311,1082,7107
76654,150,155,131,115,166,206,151,1074
76655,8950,9352,9349,9000,9183,8412,7831,62077
76656,2408,2604,2632,2595,2711,2527,2276,17753
76657,9399,9301,9075,8970,8830,8594,9307,63476
76660,639,578,504,466,405,338,506,3436
76661,8224,8181,8082,7984,8419,8492,8708,58090
76664,3438,3333,3412,3258,3374,3377,3514,23706
76665,2385,2588,2623,2615,2545,2625,2526,17907
76666,263,256,198,154,190,224,244,1529
76667,11573,11773,11106,11407,11360,11207,11313,79739
76670,1470,1423,1361,1268,1230,1110,1377,9239
76671,1913,1983,2090,2063,2110,2066,1777,14002
76673,1419,1337,1381,1233,1191,1375,1187,9123
76676,314,395,443,409,504,588,413,3066
76678,329,353,238,218,196,285,263,1882
76679,1436,1487,1418,1356,1277,1149,1432,9555
76680,438,378,331,396,399,215,190,2347
76681,668,709,723,574,616,549,873,4712
76682,2610,2620,2493,2675,2365,2414,2660,17837
76685,33,17,3,4,42,72,108,279
76686,244,256,244,237,239,233,285,1738
76687,1642,1836,1594,1825,1522,1674,1466,11559
76689,3469,3577,3610,3721,3415,3414,3996,25202
76690,1059,1001,1036,1012,1055,1384,1197,7744
76691,6383,6487,6356,6165,6093,5820,6454,43758
76692,10177,9664,9930,9848,9318,8956,10115,68008
76693,1467,1444,1501,1504,1414,1946,1651,10927
76701,1977,2175,1866,1715,1412,1409,1826,12380
76704,7984,7896,8044,8097,8135,8135,8007,56298
76705,29679,29340,29392,29007,28312,28413,29155,203298
76706,37062,35794,36191,36055,35500,34149,35015,249766
76707,16308,16390,16422,15501,15812,16168,16697,113298
76708,26220,25969,26046,26028,25038,24557,24476,178334
76710,23967,23294,22653,22659,23155,23873,22686,162287
76711,8710,8614,8611,8042,8190,8159,9042,59368
76712,25388,25662,24738,24080,23492,22910,23506,169776
76798,1586,1565,1736,1835,1922,2018,1862,12524
76801,25078,24653,24725,24687,25035,25471,25552,175201
76802,4967,5250,5666,5294,5342,5193,5075,36787
76820,120,150,136,124,114,78,125,847
76821,4739,4599,4732,5017,4910,4968,4869,33834
76823,3360,3215,3178,3544,3332,3072,2945,22646
76824,15,0,0,0,0,0,35,50
76825,7111,7271,7171,7187,7227,6988,7091,50046
76827,447,519,343,277,258,244,433,2521
76828,299,237,197,163,184,337,199,1616
76831,102,81,82,74,83,38,63,523
76832,651,708,646,568,571,530,559,4233
76834,5507,5697,5754,5796,5744,5793,5908,40199
76836,8,13,13,8,12,60,41,155
76837,3170,3202,3280,3124,3233,3160,3188,22357
76841,19,22,31,28,58,74,61,293
76842,177,117,101,78,87,113,191,864
76844,3804,3758,3737,3685,3730,3678,3550,25942
76845,122,138,201,167,162,203,178,1171
76848,60,75,46,91,82,77,78,509
76849,3880,3994,4067,4005,4153,4057,3944,28100
76852,206,207,222,228,247,235,212,1557
76853,1520,1685,1568,1411,1394,1626,1622,10826
76854,294,201,185,228,189,255,401,1753
76856,3609,3655,3655,3747,3678,3634,3582,25560
76857,1714,1934,1870,2156,2010,2029,1791,13504
76858,272,222,301,333,203,215,254,1800
76859,1976,1988,2052,2035,2064,2110,1982,14207
76861,2175,2317,2393,2282,2076,2108,1995,15346
76862,174,150,115,364,309,265,198,1575
76864,676,707,705,689,677,666,890,5010
76865,73,92,129,153,153,207,160,967
76866,687,649,612,486,465,624,623,4146
76869,138,133,103,22,20,32,125,573
76870,216,230,227,222,190,266,251,1602
76871,704,729,774,927,799,809,784,5526
76872,775,596,662,608,683,872,717,4913
76873,35,30,61,78,81,57,55,397
76874,67,57,59,61,37,35,68,384
76875,733,728,687,655,714,601,668,4786
76877,4279,4343,4366,4447,4515,4527,4558,31035
76878,1775,1719,1611,1766,1804,1757,1685,12117
76882,273,219,291,261,189,161,252,1646
76884,184,187,170,130,212,164,172,1219
76885,178,157,141,113,126,164,154,1033
76887,118,82,78,133,119,114,126,770
76888,94,113,84,67,57,36,110,561
76890,1013,971,969,977,940,925,940,6735
76901,28427,28009,27319,27527,28149,28290,27969,195690
76903,32212,32357,32848,32388,31457,31500,31905,224667
76904,35256,34044,33064,32554,32199,31468,32718,231303
76905,13554,13795,13563,12582,12434,12146,11335,89409
76908,2704,2757,2546,2618,2381,2020,1951,16977
76930,111,139,175,120,160,172,156,1033
76932,3743,3733,3641,3571,3504,3296,3390,24878
76933,1297,1379,1352,1324,1405,1436,1365,9558
76934,1379,1202,1306,1462,1122,948,1296,8715
76935,1328,1480,1452,1466,1587,1503,1606,10422
76936,3171,3224,3255,3268,3253,3237,3377,22785
76937,45,38,42,18,18,23,37,221
76939,56,56,92,94,90,44,51,483
76940,115,121,54,56,18,208,176,748
76941,1474,1433,1374,1436,1361,1280,1348,9706
76943,3659,3565,3761,3719,3560,3753,3693,25710
76945,1668,1581,1638,1625,1536,1677,1665,11390
76949,15,22,21,20,6,12,7,103
76950,3959,3989,4017,4069,4142,4219,4180,28575
76951,1233,1346,1360,1358,1223,1216,1143,8879
76953,50,36,31,29,40,19,74,279
76955,121,99,64,0,0,0,133,417
76957,0,0,0,0,0,0,59,59
76958,164,243,230,279,267,249,310,1742
77002,11861,11922,11630,11602,11473,11528,16793,86809
77003,10097,10438,10760,10617,10215,9782,10508,72417
77004,36879,35739,34079,31593,29853,28743,32692,229578
77005,27707,27187,26187,25752,25740,26122,25528,184223
77006,21849,21795,21144,20573,19856,20489,19664,145370
77007,35185,33029,31987,30868,29545,27651,30853,219118
77008,32588,31868,31418,30807,29424,29776,30482,216363
77009,38019,39260,39361,39725,39050,38686,38094,272195
77010,831,809,724,564,342,198,366,3834
77011,18558,19303,19136,19442,19396,20213,19547,135595
77012,20534,20494,20991,21868,21619,21185,20719,147410
77013,20743,21111,21176,19246,19448,19566,17602,138892
77014,34060,33960,32008,30665,29673,29396,28684,218446
77015,57398,57141,55635,57096,54386,53983,53621,389260
77016,27799,26587,26558,27010,27634,26916,26989,189493
77017,32583,33709,34204,33259,33470,33846,32561,233632
77018,28144,27513,27020,26794,27627,27253,25563,189914
77019,21067,20644,20350,19995,19450,19976,18944,140426
77020,25908,26005,26777,26889,26381,27427,25464,184851
77021,26374,26209,26036,25479,25640,25082,26042,180862
77022,28014,28430,27500,28898,29821,28733,29557,200953
77023,27973,28316,29102,29871,30696,30931,28998,205887
77024,37867,37042,36791,35367,34622,34781,34775,251245
77025,28103,28305,27413,26379,25935,25632,26137,187904
77026,23030,22485,23325,22909,23963,24438,23940,164090
77027,15498,15749,15510,15455,14745,15200,14331,106488
77028,14457,14558,15076,15682,16551,17224,16808,110356
77029,18281,17835,17812,18242,17570,17978,17814,125532
77030,10735,10279,10664,11031,11184,11375,10258,75526
77031,18182,18380,17711,18079,17822,16041,15762,121977
77032,13475,13032,12788,13743,13517,13492,12757,92804
77033,28190,27478,27254,27539,28001,29319,27965,195746
77034,39420,39496,37925,35514,34856,34070,33678,254959
77035,36973,36515,35989,35699,35481,36536,35896,253089
77036,77770,75302,72950,68373,67788,64658,71969,498810
77037,19856,20832,20934,20152,20191,20503,19819,142287
77038,29388,28811,28082,28182,27529,26714,26713,195419
77039,28644,29660,28711,28151,27339,26431,27562,196498
77040,47690,47051,46898,44762,43182,42343,45081,317007
77041,36129,36368,37168,36805,36537,35272,37146,255425
77042,40628,39384,38335,36583,34456,33704,36385,259475
77043,26505,25104,24883,23396,22940,21819,23358,168005
77044,40389,37753,35696,33672,31067,30006,30949,239532
77045,34426,33917,33820,32650,32155,31578,31255,229801
77046,1042,961,967,1122,1106,879,1196,7273
77047,26653,25073,23256,22334,21316,20596,21077,160305
77048,16854,16428,16521,16025,15397,14750,15294,111269
77049,32724,31111,30446,29460,29100,28464,28521,209826
77050,4780,4805,4945,4188,4226,4883,4611,32438
77051,15471,15141,15216,14782,14219,14887,15085,104801
77053,31466,31028,31225,31701,30478,31736,28954,216588
77054,22903,22862,22589,21668,21766,21246,22290,155324
77055,44890,43691,44249,44281,43603,43977,41989,306680
77056,19990,18685,17515,17263,16356,16920,18673,125402
77057,39327,39905,40086,39903,39463,39402,39208,277294
77058,17070,16881,16595,16099,16349,16416,16406,115816
77059,18023,18079,18764,18867,18904,19246,16949,128832
77060,44010,45648,43881,44284,44625,42532,40830,305810
77061,25710,25155,25519,24760,24115,23865,24457,173581
77062,27277,26448,25760,25866,25337,24612,25152,180452
77063,37370,36772,36299,35961,36204,34456,34299,251361
77064,47602,47361,46509,45932,43907,43142,45847,320300
77065,38839,38652,38585,37344,35703,35550,35326,259999
77066,32999,32860,32507,31208,31486,30946,31366,223372
77067,32305,31966,31295,30930,29719,29101,30559,215875
77068,11429,11015,10776,10306,10271,9528,10064,73389
77069,18027,17286,16764,16088,15323,15107,16541,115136
77070,49666,49622,48190,46640,45349,44116,46017,329600
77071,27460,28003,27159,26520,26180,25403,25671,186396
77072,61376,58871,59442,56199,54901,56006,56526,403321
77073,42411,42085,41123,38406,36910,35108,34790,270833
77074,37950,36764,36218,36939,35210,37097,37267,257445
77075,42864,42569,41031,40010,38421,37457,37388,279740
77076,35017,34467,34859,34851,33049,32364,33803,238410
77077,56291,54931,53659,53158,53081,52457,52151,375728
77078,16323,16325,15584,16753,15811,15698,14777,111271
77079,33229,33013,31002,30669,30626,30755,31280,220574
77080,46907,47080,47430,48734,48137,46869,45275,330432
77081,46940,45039,44070,42725,42801,43957,47860,313392
77082,55909,54555,52248,49920,49228,46372,49900,358132
77083,75684,74174,73164,71810,71032,69723,70837,506424
77084,103635,102437,101488,99266,98697,94005,95137,694665
77085,17659,17571,16288,16404,16792,16337,16074,117125
77086,28552,28886,28931,27720,27705,26464,28009,196267
77087,36727,36855,37268,38191,38747,38187,36399,262374
77088,55688,55593,53887,52924,51809,50811,49660,370372
77089,52207,53320,51939,51184,50894,50194,48685,358423
77090,38365,35958,34693,34201,33747,31871,32930,241765
77091,23232,23442,23398,23361,23791,23776,23472,164472
77092,38982,37022,35087,35332,34390,33737,33745,248295
77093,43660,42735,42161,42639,42808,42323,46929,303255
77094,8978,8897,8754,8547,8143,8533,8498,60350
77095,71924,71473,69927,68458,65603,64457,66502,478344
77096,37302,36145,36227,34891,33892,32206,32628,243291
77098,13058,12271,13091,12720,12524,12188,13076,88928
77099,50639,47166,46617,45234,46114,46591,47091,329452
77201,0,0,0,0,0,0,0,0
77301,31443,31826,31796,31060,31298,30639,30769,218831
77302,19111,18798,18364,17868,17637,16079,18118,125975
77303,19357,18608,18641,16929,16629,15679,16710,122553
77304,28069,25794,24426,23192,21155,20486,21314,164436
77306,11673,11250,11363,11456,11973,11498,11931,81144
77316,19367,18954,16134,15465,15082,14570,16036,115608
77318,15294,14100,13588,13133,13446,12851,14281,96693
77320,35914,36150,36047,36855,36204,36111,33678,250959
77326,14,15,16,19,0,0,69,133
77327,21718,21168,21089,20829,19844,19721,20160,144529
77328,15695,16297,17329,15666,15823,14619,13993,109422
77331,6938,6639,6124,6219,6060,6344,6824,45148
77334,313,92,99,98,143,181,141,1067
77335,2333,2395,2567,2447,2860,2742,2350,17694
77336,11806,12044,11699,12022,12116,12345,12471,84503
77338,38300,38017,36257,34410,33298,31596,33971,245849
77339,40950,39863,40683,39840,38532,37917,37512,275297
77340,28798,28664,27340,25784,26017,25674,29809,192086
77342,0,0,284,344,456,586,23,1693
77345,29922,29394,29292,28239,28029,26860,26122,197858
77346,61719,60066,57329,54627,53077,51262,53578,391658
77350,106,126,128,106,96,114,66,742
77351,33786,33363,32683,33044,32780,32590,32517,230763
77354,35023,33853,34551,32363,30449,28654,30215,225108
77355,26515,26329,25855,25007,24317,22900,24010,174933
77356,25458,25579,24851,24694,24116,23211,24498,172407
77357,23491,22077,20806,19992,18831,17823,19987,143007
77358,5419,4801,5225,5242,4763,4733,4993,35176
77359,780,841,948,825,864,493,721,5472
77360,4924,4949,4857,4739,4771,4857,5280,34377
77362,4710,5012,4516,4841,5225,5262,4600,34166
77363,2768,2953,3471,3251,3202,3598,3269,22512
77364,1527,1664,1515,2062,2526,2368,2223,13885
77365,30644,28569,26175,26617,26967,25463,25769,190204
77367,193,256,236,218,210,186,143,1442
77368,184,203,104,151,118,88,152,1000
77369,657,493,719,708,1023,1011,1018,5629
77371,7924,8467,8307,8468,8025,8768,7665,57624
77372,12106,12780,11859,12276,12339,12145,12164,85669
77373,59297,56942,55485,55927,55351,53728,54609,391339
77374,467,417,613,577,418,387,510,3389
77375,46466,45003,43088,41919,40815,39264,39351,295906
77376,327,533,284,320,478,494,617,3053
77377,35698,33849,32199,30791,29269,26964,28708,217478
77378,14961,14855,13804,14151,14590,13588,14685,100634
77379,78058,75775,72742,72579,71184,69492,70544,510374
77380,26952,26757,26091,24771,23584,22879,23136,174170
77381,37011,36928,36388,37028,36405,37640,34961,256361
77382,38138,37616,37274,36764,35585,35228,35369,255974
77384,15601,13573,12393,12443,11768,11624,11857,89259
77385,23022,22785,21500,19546,19572,18958,19534,144917
77386,50067,45501,44686,42574,38004,36478,36407,293717
77388,44345,43339,41866,40175,40457,39818,40384,290384
77389,30006,28542,26174,24561,22627,20329,21255,173494
77396,50196,48587,47623,45778,43861,42873,43317,322235
77401,18667,18510,18130,17874,17522,17452,17491,125646
77406,39300,36907,36023,35276,34513,31325,33682,247026
77407,43315,38424,35057,31973,29180,25554,28595,232098
77412,163,142,110,112,96,51,106,780
77414,22860,23157,22874,23132,23618,23764,23047,162452
77415,105,89,11,12,166,140,46,569
77417,2666,2721,2654,2445,2451,2481,2457,17875
77418,10012,9946,9405,9296,9120,9286,9585,66650
77419,1734,1359,1591,1524,1218,981,1512,9919
77420,2198,2056,1983,1960,1780,1959,2205,14141
77422,13525,12851,13557,13227,12919,13005,13933,93017
77423,10122,10189,9739,9587,9342,9027,9483,67489
77426,2169,2027,1975,2103,1864,1578,2100,13816
77428,0,0,0,0,0,0,61,61
77429,82323,79535,76437,74313,71439,70472,72264,526783
77430,1845,2278,1992,2007,2287,2253,2283,14945
77432,62,63,63,66,66,59,173,552
77433,68478,64493,60324,55563,51200,44962,50539,395559
77434,4609,4803,4655,4701,4910,5021,4816,33515
77435,4733,4641,4532,4462,4465,4237,4539,31609
77436,43,0,0,0,0,0,73,116
77437,16881,17202,17074,17007,16975,16569,17054,118762
77440,0,0,0,0,0,0,37,37
77441,7948,6551,5647,5409,5217,4995,4809,40576
77442,1040,985,979,996,774,710,1137,6621
77443,268,17,72,66,134,114,84,755
77444,793,942,960,999,944,976,784,6398
77445,13124,12760,12662,12526,12165,12191,11977,87405
77446,6004,5819,5609,5403,5156,4842,5217,38050
77447,15417,13616,13186,13542,12555,11941,11872,92129
77448,58,121,177,109,144,614,341,1564
77449,112317,106175,99450,95615,90599,86302,94382,684840
77450,74206,74246,73269,70538,69622,68220,71889,501990
77451,41,50,55,87,63,100,77,473
77453,376,330,329,441,370,211,301,2358
77454,110,188,256,283,356,245,217,1655
77455,2097,1913,2017,1850,1936,2097,2045,13955
77456,1239,1376,1389,1172,1179,1136,1303,8794
77457,506,416,544,544,527,697,651,3885
77458,302,356,328,286,432,465,468,2637
77459,65156,63857,59800,58197,55975,55596,56274,414855
77460,127,111,99,174,91,202,73,877
77461,10996,10525,10435,9695,9294,9257,10679,70881
77464,242,238,256,254,195,299,221,1705
77465,7181,7538,7388,7353,6884,7185,7161,50690
77466,838,761,856,905,1017,918,690,5985
77467,100,70,99,119,85,48,57,578
77468,35,186,192,177,217,275,131,1213
77469,43526,41493,38364,36305,34697,32835,35321,262541
77470,353,313,429,208,250,293,338,2184
77471,37729,38602,36504,35184,35604,35237,35241,254101
77473,91,96,83,76,72,67,97,582
77474,12709,12723,12867,13015,12956,13301,12782,90353
77475,572,460,547,688,767,746,773,4553
77476,200,142,171,177,265,289,313,1557
77477,36787,36162,35608,36043,35342,35520,35897,251359
77478,25240,24568,24084,23853,23541,23862,24739,169887
77479,85514,83179,81466,78289,74399,73498,74514,550859
77480,7503,7642,7910,8074,8069,8668,8097,55963
77481,14,21,3,3,2,27,35,105
77482,2949,2341,2379,1963,2125,1430,2307,15494
77483,345,314,311,481,368,301,311,2431
77484,10716,11512,11370,10898,10921,10630,11068,77115
77485,4306,4153,3816,3790,3637,3316,4054,27072
77486,6704,6825,6973,6738,6538,7195,6851,47824
77488,14183,14388,14597,14797,14659,14673,14148,101445
77489,36344,35839,36336,35540,35577,34375,35554,249565
77493,27273,26013,24577,23628,22695,22815,23104,170105
77494,97515,88077,79117,71613,64378,55808,61600,518108
77498,51793,51716,52693,52545,52084,50259,49906,360996
77502,38186,38390,37570,36712,36263,36035,37995,261151
77503,25259,25083,25348,25103,23914,24154,24251,173112
77504,23939,24052,24369,24922,24514,23968,24529,170293
77505,24088,23481,23427,23550,23243,23232,23223,164244
77506,37423,36436,36225,35875,36710,36795,35977,255441
77507,0,0,0,0,0,0,0,0
77510,14753,14265,14533,13605,14482,14441,13731,99810
77511,47099,46787,46333,46889,46850,45603,46627,326188
77514,4877,4595,4430,4315,4044,3876,4942,31079
77515,31435,30223,30359,30036,29133,28824,30309,210319
77517,5690,5272,5356,6235,5840,6050,5315,39758
77518,9060,8781,8667,7815,7692,7676,8673,58364
77519,1217,1370,1491,1517,1235,1341,1191,9362
77520,37722,38348,37928,37735,37165,37660,36489,263047
77521,56141,53991,53091,50406,49294,46372,49507,358802
77523,20223,19558,18378,18668,18047,17150,17031,129055
77530,30635,30175,30475,30368,30853,31322,31086,214914
77531,15889,15768,15625,15358,15502,15269,15639,109050
77532,29224,28430,28394,27208,26356,24270,26236,190118
77533,794,763,876,827,866,917,1022,6065
77534,2653,3014,3270,2988,2932,3224,2863,20944
77535,32184,32286,30946,31019,30816,31884,31295,220430
77536,32182,32531,31960,31295,30891,30588,30690,220137
77538,860,993,967,1124,1185,1067,934,7130
77539,41991,41925,41090,40368,39360,38505,38806,282045
77541,18288,18426,17826,17535,17486,17137,17412,124110
77545,23065,22710,21080,19868,19440,18279,19431,143873
77546,51204,50798,49979,49255,47815,47725,47636,344412
77547,9999,10027,9957,9782,9975,9798,9735,69273
77550,22549,22615,22134,22759,22252,23314,23043,158666
77551,20501,19905,19640,18649,18629,18689,17753,133766
77554,8228,8283,8599,8591,9309,8905,8863,60778
77560,609,682,668,892,968,856,1005,5680
77561,79,76,78,105,86,59,53,536
77562,10490,10591,10720,10751,10861,10456,10459,74328
77563,9781,9880,9836,9839,9488,9348,9103,67275
77564,2283,1850,1848,1914,1911,1491,1988,13285
77565,7207,6376,6086,5735,5683,5751,5790,42628
77566,29539,29450,28533,28484,28291,28962,28739,201998
77568,15453,15115,14886,14645,14556,14532,14308,103495
77571,37031,36865,36580,36116,35787,35975,35666,254020
77573,82121,79435,75772,73615,71418,69099,71580,523040
77575,16824,16715,16725,15833,15878,16391,15949,114315
77577,1304,1257,1376,1366,1377,1320,1368,9368
77578,17373,16260,15584,14152,13113,12306,12672,101460
77580,218,625,515,319,383,530,312,2902
77581,45938,45341,44451,41813,41981,41754,42383,303661
77583,33236,31098,31353,30837,29698,29494,28531,214247
77584,83719,80638,76495,74761,71277,65756,70228,522874
77585,880,1126,1146,1175,1412,1444,1014,8197
77586,22280,22550,22114,22044,21563,20955,20970,152476
77587,16862,16868,17052,16734,16648,16515,16568,117247
77590,30649,30815,30675,29980,30607,30309,30374,213409
77591,14210,13846,13681,13906,13123,13333,13131,95230
77597,1103,895,694,659,400,477,777,5005
77598,24309,23877,24538,23738,24074,23461,23059,167056
77611,8366,8302,8211,8415,8481,8633,8219,58627
77612,9317,9885,9413,9157,8376,8260,8901,63309
77613,886,944,873,889,740,835,1218,6385
77614,558,789,842,733,502,473,603,4500
77615,923,885,792,828,853,860,1012,6153
77616,656,737,751,904,1035,1064,1136,6283
77617,60,78,79,99,155,207,73,751
77619,15798,15845,15927,15966,16001,16076,16147,111760
77622,1306,1429,1562,1628,1519,1367,1390,10201
77623,588,636,659,816,809,516,448,4472
77624,783,945,1184,1121,1314,1281,856,7484
77625,8791,8266,8542,8253,8030,8315,8489,58686
77627,21145,21442,20998,21368,21746,21533,21454,149686
77629,726,724,666,641,803,595,877,5032
77630,28763,28126,27670,26851,26984,26932,26796,192122
77632,23709,23754,23687,24158,24410,24005,22776,166499
77640,15327,16107,16109,16409,16447,16171,16875,113445
77642,39252,38471,38314,37724,37560,37688,37111,266120
77650,1506,1482,1221,1349,1477,1696,1896,10627
77651,12794,12826,12877,12931,12971,13001,13043,90443
77655,387,353,372,373,319,271,356,2431
77656,17068,17563,17543,17513,17353,16899,17110,121049
77657,21449,21171,20816,20829,20317,19567,20003,144152
77659,4751,4832,4574,4459,4677,5052,4910,33255
77660,1302,1135,1068,1037,1222,1353,1437,8554
77661,950,1064,1194,916,871,768,962,6725
77662,26547,26865,27021,26765,26756,26482,27035,187471
77663,1416,870,996,994,881,963,1353,7473
77664,2401,2467,2695,2705,3228,3541,2681,19718
77665,6047,5759,5805,5391,5424,5111,6446,39983
77701,13770,13746,14115,15345,15453,14912,14674,102015
77702,2832,2611,2920,2470,2583,2608,2893,18917
77703,14241,14444,15151,16358,16240,16007,15006,107447
77705,40389,40747,41368,40901,40192,40587,40475,284659
77706,29237,29194,28326,28088,28379,29298,28258,200780
77707,17778,17324,17176,16379,17055,16691,17080,119483
77708,12184,12029,11746,11237,10889,10918,11518,80521
77713,13848,13693,13019,12368,11736,11158,12788,88610
77801,17113,16606,15768,14197,13826,13623,15449,106582
77802,25306,24949,24870,24125,23804,22955,23288,169297
77803,30119,30078,29528,30759,30378,30166,30252,211280
77807,10582,10775,11256,10882,10895,10492,9699,74581
77808,10248,10539,10641,10990,11008,11000,10634,75060
77830,2939,2708,2747,2966,2646,2357,2534,18897
77831,2917,2910,3281,3591,4139,4245,3426,24509
77833,29566,29341,29033,27984,28399,28032,27492,199847
77835,2053,1970,2165,2313,2059,2395,2351,15306
77836,11594,11742,11680,11459,11722,12200,11896,82293
77837,1856,1837,1736,1865,1697,1732,1587,12310
77840,58696,57172,57281,56154,55364,54719,56171,395557
77845,57501,54902,52609,50799,49208,47590,48938,361547
77853,1316,1180,1238,1094,1027,875,953,7683
77855,24,24,27,78,86,139,238,616
77856,4998,4874,4769,4520,4566,4367,5096,33190
77857,709,829,1010,1038,1019,946,757,6308
77859,7216,7203,6766,6683,6720,6478,6981,48047
77861,2591,2556,2933,2965,2861,2908,2506,19320
77864,6806,6772,6748,6761,6875,6939,7647,48548
77865,1322,1544,1416,1531,1473,1296,1798,10380
77867,58,78,74,111,83,82,105,591
77868,16537,16307,14926,14262,14398,13905,15511,105846
77871,2729,2620,2818,3146,3373,3508,3368,21562
77872,1533,1486,1560,1437,1607,1783,1716,11122
77873,1305,1310,1445,1481,1504,1707,1292,10044
77876,212,199,158,194,67,128,197,1155
77878,486,439,530,597,657,453,475,3637
77879,5262,5005,4778,4842,4399,4245,4670,33201
77880,1525,1345,1256,1637,1596,1500,1879,10738
77901,43478,43462,42140,41648,42032,41407,41548,295715
77904,27356,26343,26397,26187,24884,24613,25002,180782
77905,14166,14349,14324,14453,14365,14395,13981,100033
77950,169,188,220,207,174,160,197,1315
77951,1979,2306,2403,2282,2256,2338,2616,16180
77954,12614,12027,11644,11393,11159,11391,11506,81734
77957,8445,8365,8387,8299,8263,8172,8187,58118
77960,28,30,31,17,0,0,121,227
77961,172,185,168,92,103,111,183,1014
77962,3380,3299,3368,3597,3784,3659,3286,24373
77963,5827,5708,5604,5817,5692,5843,5459,39950
77964,8371,8259,8228,8038,8059,7709,7569,56233
77968,2786,2554,2697,2528,2553,2740,2774,18632
77969,214,183,140,266,200,135,154,1292
77970,383,344,328,336,265,180,295,2131
77971,892,953,897,657,548,663,911,5521
77973,73,76,83,78,54,0,50,414
77974,425,484,594,562,490,443,455,3453
77975,1924,1967,2129,1935,1918,1831,1860,13564
77976,158,151,127,156,156,104,126,978
77977,796,851,816,633,463,372,718,4649
77978,777,703,635,746,716,703,743,5023
77979,17428,17542,17388,17238,17577,17550,17144,121867
77982,1042,923,1153,1244,1195,1058,1253,7868
77983,2463,2496,2350,2259,1868,1816,2209,15461
77984,3947,4074,3986,4127,4247,4521,4295,29197
77987,255,235,211,154,139,131,161,1286
77988,463,340,302,408,570,652,326,3061
77990,750,808,777,669,703,876,699,5282
77991,500,423,328,218,332,421,357,2579
77993,276,268,240,157,268,239,148,1596
77994,435,411,306,297,400,376,321,2546
77995,9195,8892,8604,8777,9222,9258,9567,63515
78001,0,0,0,0,0,0,33,33
78002,7630,8034,8684,9199,8556,8291,8255,58649
78003,8885,8527,7811,8053,8316,8652,8689,58933
78004,1227,1246,1190,1397,1288,1013,1183,8544
78005,536,483,349,359,289,267,817,3100
78006,30781,30227,29052,27971,27475,27105,27558,200169
78007,106,106,21,4,74,225,151,687
78008,228,245,248,303,357,356,345,2082
78009,8827,8539,8433,8347,7958,7308,7255,56667
78010,3354,2892,3335,2930,2663,2623,3386,21183
78011,2127,2198,2157,1944,1652,1616,2082,13776
78012,416,477,400,360,454,397,436,2940
78013,6411,5876,5975,5665,5316,5495,5930,40668
78014,5369,5460,5487,5413,5391,5430,4987,37537
78015,12528,11001,10771,9965,9762,9179,9602,72808
78016,9073,8923,8665,9672,9825,9790,9630,65578
78017,5223,4827,4876,4560,4452,4870,4787,33595
78019,1712,1484,1393,1374,1436,1243,1855,10497
78021,226,168,135,260,268,412,126,1595
78022,4561,4842,4762,4543,4631,4515,4627,32481
78023,29351,28014,27381,26373,26128,23995,24334,185576
78024,1283,1242,1137,1123,1125,1145,1436,8491
78025,3967,4468,4506,4860,4936,5554,4956,33247
78026,5842,5860,5846,6141,5731,5598,5861,40879
78027,798,591,568,506,267,206,459,3395
78028,40103,40001,39536,39160,39183,38126,37620,273729
78029,0,0,0,0,0,0,0,0
78039,1505,1680,1330,1499,1618,1719,1657,11008
78040,42445,42035,41694,41851,41281,41667,42083,293056
78041,45468,45655,45489,44823,45082,45480,44153,316150
78043,43914,44917,44777,45547,43155,41335,42713,306358
78044,377,237,302,169,93,475,648,2301
78045,63151,61072,60005,57801,56056,53653,54713,406451
78046,69262,68006,65821,63240,63268,61775,64548,455920
78050,468,636,656,691,655,629,767,4502
78052,7199,6971,6933,6710,6525,6739,6388,47465
78055,2001,2026,1892,1943,1863,1733,1774,13232
78056,1867,1732,2029,1948,1784,1858,1917,13135
78057,575,832,801,822,962,865,871,5728
78058,1038,897,886,836,1027,979,1256,6919
78059,5788,5851,5649,5301,5192,4943,5387,38111
78060,30,36,17,0,0,0,37,120
78061,12504,12379,12125,11909,11679,11187,11031,82814
78063,9350,9444,10085,9524,9329,9359,9227,66318
78064,15307,14607,14279,13705,13391,14256,14102,99647
78065,10203,10930,11279,11764,12306,12069,10831,79382
78066,407,361,627,771,873,764,591,4394
78067,656,653,450,454,483,567,916,4179
78069,6012,5652,5449,5485,5462,5510,5137,38707
78070,15338,15292,15834,14615,14151,14655,14618,104503
78071,4558,4333,4411,4408,4506,4499,4248,30963
78072,500,619,572,570,604,503,505,3873
78073,8806,7782,7795,7308,7434,7211,8171,54507
78075,131,92,105,117,98,23,123,689
78076,13119,13400,13617,13637,13400,12830,12612,92615
78101,6773,7720,8426,8970,8216,7986,7898,55989
78102,28714,28494,28186,27701,27462,27828,27593,195978
78104,73,140,134,149,199,239,175,1109
78107,407,328,317,171,271,147,360,2001
78108,34800,33517,32581,30204,28572,25797,27770,213241
78109,38320,37524,36915,36384,36406,35052,34603,255204
78112,8562,7665,8000,7557,7724,7386,7941,54835
78113,2680,2801,2616,2569,2548,2426,2435,18075
78114,21846,20907,20101,20039,20411,20307,20103,143714
78116,315,240,265,411,330,358,390,2309
78117,602,778,761,745,743,639,545,4813
78118,3979,3807,3828,3972,3994,3900,3976,27456
78119,7446,7395,7637,7377,7625,7720,7680,52880
78121,12288,11742,11059,10709,10847,10819,11381,78845
78122,447,399,329,200,345,220,418,2358
78123,2334,2382,2550,2648,2362,2291,2397,16964
78124,5884,5839,5369,5688,5199,5466,5609,39054
78125,72,80,76,86,117,89,96,616
78130,67704,64737,62287,61293,59519,58011,59546,433097
78132,25232,23671,22875,20370,20047,18741,19139,150075
78133,18188,16854,15838,15895,15635,15592,16269,114271
78140,3476,3450,3187,3341,3270,3515,3380,23619
78141,515,651,737,817,797,740,596,4853
78142,145,147,126,146,233,168,119,1084
78143,411,470,538,243,80,49,85,1876
78144,29,36,24,8,10,7,45,159
78145,77,91,107,90,102,136,103,706
78146,697,695,766,943,1003,714,771,5589
78147,2066,2155,2110,1855,1867,2101,1919,14073
78148,21288,21040,20736,20354,19855,19463,20139,142875
78150,13,18,19,29,64,71,11,225
78151,1634,1518,1462,1524,1284,1229,1347,9998
78152,2179,2350,2063,2514,2410,2423,2294,16233
78154,37405,35176,33259,31779,30263,28222,30347,226451
78155,46839,47263,47193,46816,46248,45329,45341,325029
78159,943,967,887,870,910,873,1023,6473
78160,4607,4545,4788,5058,4486,4271,4273,32028
78161,706,698,643,788,848,586,864,5133
78162,350,379,414,335,353,310,375,2516
78163,10656,10996,10029,10278,10348,9879,9838,72024
78164,3320,3880,4322,4381,4059,3835,3796,27593
78201,46063,42828,41421,42759,43310,44271,45307,305959
78202,12339,12299,12743,13165,12837,12490,11691,87564
78203,6360,6414,5534,5807,5639,5378,6099,41231
78204,11723,11574,11237,11035,11326,11135,11125,79155
78205,1061,1083,1033,1025,910,898,1453,7463
78207,53093,52990,53969,53946,54100,55890,55514,379502
78208,4518,4234,3860,3436,3384,3582,3736,26750
78209,41329,41008,40942,40298,39744,39195,39197,281713
78210,38705,39258,38685,37627,37215,37733,36865,266088
78211,34166,33922,34074,34415,33239,31577,31944,233337
78212,28433,28478,28437,28615,28318,27730,28415,198426
78213,42932,42370,42289,42263,41789,39730,40396,291769
78214,26119,24791,24061,23611,23641,23334,23341,168898
78215,2302,1901,1622,1155,1216,1296,1150,10642
78216,40127,40327,40171,38846,37759,38287,40267,275784
78217,33635,32897,33014,32596,32145,31439,32165,227891
78218,35106,34606,32846,32206,31813,31808,31917,230302
78219,16239,15392,14805,15141,14620,14670,15225,106092
78220,16092,16255,16461,16752,17109,15940,15965,114574
78221,38289,37743,37923,37086,36057,36032,35990,259120
78222,23433,22365,22243,21220,21321,19328,19408,149318
78223,53720,53478,52249,50536,50158,49879,50637,360657
78224,21219,19866,18984,18121,17728,17945,17601,131464
78225,13983,13959,13629,14076,13917,13806,13025,96395
78226,6071,5704,5916,6003,6603,7029,6648,43974
78227,48079,48807,48457,46489,45046,44603,46077,327558
78228,62868,61940,60256,58783,55936,54558,58811,413152
78229,30821,30897,29893,29591,28647,27531,28804,206184
78230,44447,43388,42443,40063,39047,38896,39089,287373
78231,8258,8098,8132,8190,7843,8220,7906,56647
78232,37986,38057,36503,37279,36367,36521,35120,257833
78233,49076,47707,46836,45987,45726,43270,43710,322312
78234,5857,6568,6684,7100,7146,7300,7126,47781
78235,795,942,801,799,681,806,357,5181
78236,7244,8288,8570,8562,8609,8266,10392,59931
78237,37615,37195,37224,37719,36131,35411,36929,258224
78238,25243,25954,25130,24711,25054,24029,23514,173635
78239,28335,28353,28460,27787,27870,27753,28736,197294
78240,58287,56938,54613,53145,51367,50440,51111,375901
78242,33102,33369,33538,32786,32900,32611,31395,229701
78243,382,340,219,237,253,274,235,1940
78244,30639,31379,31612,30527,31353,29558,30757,215825
78245,68265,64505,62615,60333,57534,55529,56511,425292
78247,52029,52097,51400,49514,49568,50712,49176,354496
78248,14217,14618,14380,14405,14490,14650,13638,100398
78249,54676,54075,52206,50491,48874,46850,49951,357123
78250,59846,58202,56580,55723,55461,55899,54903,396614
78251,57447,56996,54898,51767,51095,48018,49435,369656
78252,9833,8947,8629,7627,7562,6857,7372,56827
78253,38946,36184,32884,31061,28410,27519,29007,224011
78254,52163,51049,48966,47019,44109,42817,44817,330940
78255,13865,13015,12280,12152,10721,9672,10826,82531
78256,9763,8837,7896,7115,6878,6717,6855,54061
78257,5157,4469,4186,4005,3779,3315,3950,28861
78258,45750,43569,42447,41864,40949,40465,40586,295630
78259,25614,23887,22582,22614,21791,20970,22660,160118
78260,28323,28279,26498,25685,24087,23159,24844,180875
78261,15812,15383,14795,13780,13121,12157,13513,98561
78263,4788,4766,4842,4109,4358,4634,4673,32170
78264,10156,10768,11811,12973,13425,13096,12339,84568
78266,6533,6061,5990,5859,5497,5326,5591,40857
78330,896,891,763,774,672,620,878,5494
78332,28326,28138,27738,28128,28841,28888,28710,198769
78335,0,0,0,0,0,0,4,4
78336,11999,12018,11898,11546,11683,11634,11949,82727
78338,63,45,22,0,0,0,37,167
78339,533,641,809,732,792,840,632,4979
78340,476,417,419,457,432,428,379,3008
78341,2345,2255,2365,2568,2711,2537,1760,16541
78342,387,358,437,446,469,434,386,2917
78343,4139,4539,4690,4572,4561,4578,4525,31604
78344,384,389,426,449,501,480,474,3103
78349,465,461,475,537,491,579,505,3513
78351,467,531,550,564,494,515,621,3742
78352,228,273,153,205,237,288,179,1563
78353,256,358,448,627,553,787,433,3462
78355,7121,7030,6931,6832,6954,6850,7081,48799
78357,2965,3055,2954,2950,2989,3050,3161,21124
78358,570,569,567,608,652,609,709,4284
78359,2069,2146,2106,1938,1877,1778,1944,13858
78361,5306,5239,5311,5320,5314,5304,5350,37144
78362,9858,9363,9459,9578,9642,9646,9447,66993
78363,30444,30481,30590,30443,30318,30099,30463,212838
78368,9531,9628,9404,9108,9297,9320,9227,65515
78369,504,433,348,440,373,468,444,3010
78370,5193,4910,4561,4170,4355,3944,4877,32010
78371,384,438,493,383,426,346,404,2874
78372,6447,6522,6075,5523,5618,5237,5452,40874
78373,3982,3915,3834,3717,3685,3557,3585,26275
78374,17541,17652,16930,16608,16609,16648,16620,118608
78375,3028,2973,3106,3163,3158,3259,3352,22039
78376,873,869,859,758,589,600,554,5102
78377,3728,3675,3681,3647,3626,3694,3821,25872
78379,1432,1547,1551,1489,1469,1585,1585,10658
78380,24033,23801,23265,23303,23351,23218,23141,164112
78382,21300,20669,20459,20500,20213,20181,19364,142686
78383,3785,3686,4100,4024,3152,3540,3539,25826
78384,5828,5961,6245,6329,6131,6134,6640,43268
78385,441,438,451,453,366,257,277,2683
78387,9585,9751,10210,10414,9521,10455,9574,69510
78389,1438,1414,1422,1631,1542,1591,1541,10579
78390,5335,5257,5421,5828,6100,5707,5616,39264
78391,291,274,328,322,409,224,325,2173
78393,2245,2262,2265,2431,2521,2449,2379,16552
78401,5135,5196,5188,4728,5022,4551,5391,35211
78402,360,453,492,560,597,647,536,3645
78404,16973,16970,16371,15862,14779,16016,17236,114207
78405,16143,16458,15203,14638,14777,14793,16867,108879
78406,1420,1225,1360,1305,1185,1130,1413,9038
78407,3237,3092,2605,2712,2725,2646,2955,19972
78408,12762,12551,12751,12503,11639,11342,12061,85609
78409,3008,3003,3020,3032,3036,2921,2939,20959
78410,26734,27039,26946,25894,27088,26779,26387,186867
78411,27220,27192,27869,27129,28204,26945,28024,192583
78412,39331,39245,38306,38957,38632,36767,36003,267241
78413,39271,37184,36530,36816,36439,36954,36953,260147
78414,38037,36259,35390,33033,32473,30811,30165,236168
78415,40279,39855,40273,40627,39738,40015,39271,280058
78416,15370,15988,15315,15216,14539,15039,15508,106975
78417,4279,4462,4588,4362,4280,4546,4176,30693
78418,30773,30415,30830,32129,30893,30809,29854,215703
78419,924,959,880,841,689,858,694,5845
78501,63948,63887,62843,61827,62071,61462,61219,437257
78503,23061,22689,22329,21739,20691,20129,21706,152344
78504,52495,51444,50772,49936,49605,48795,48703,351750
78516,36385,36834,38269,38277,36724,37507,33722,257718
78520,63320,63786,62924,61328,59742,58899,59408,429407
78521,93008,92394,91050,90446,90752,90429,93818,641897
78526,45420,45445,45012,45360,44808,44301,42460,312806
78535,553,702,739,630,700,722,581,4627
78536,480,400,401,433,415,369,451,2949
78537,42906,41612,38464,37256,36096,36075,39454,271863
78538,11369,11876,11559,11941,11260,11040,10657,79702
78539,35013,33786,33723,33495,31827,29610,30783,228237
78541,43262,43695,43321,42696,42904,41952,42431,300261
78542,71634,69689,67171,65704,64876,61918,63293,464285
78543,9340,9162,8574,8101,8087,7205,8447,58916
78545,593,443,279,163,276,413,555,2722
78548,685,526,391,604,512,561,675,3954
78549,603,437,418,436,531,783,990,4198
78550,52609,51036,51781,52238,51229,51307,53152,363352
78552,37438,38002,37300,36331,36600,35674,34111,255456
78557,13734,13370,13063,12544,12520,12240,12547,90018
78558,779,970,1231,1033,823,620,882,6338
78559,12170,12444,13215,12410,12238,11882,12751,87110
78560,5074,4699,4557,4230,4180,4038,4368,31146
78561,668,776,574,514,436,627,779,4374
78562,4116,3899,3643,2210,2005,1764,2868,20505
78563,193,119,172,171,152,138,376,1321
78564,181,32,44,19,22,180,270,748
78565,163,213,178,216,322,286,402,1780
78566,18804,18560,17319,17280,17151,16884,16230,122228
78567,619,658,562,455,623,540,533,3990
78569,3923,4096,3944,3817,3583,3685,4039,27087
78570,35123,34508,33437,31747,29612,29003,32525,225955
78572,77819,76488,76020,73998,73032,70982,75221,523560
78573,37894,35717,37066,36251,35169,34647,34890,251634
78574,61187,63392,60976,60589,59525,58570,57071,421310
78575,9615,9259,10238,9290,9255,9177,8056,64890
78576,10420,9989,9968,10255,9541,9111,8775,68059
78577,75407,74619,73531,72047,70528,69102,70840,506074
78578,11955,11871,11709,11312,11245,10790,12516,81398
78579,4654,4324,4146,3933,4576,4541,4580,30754
78580,15363,15095,15474,15613,15469,15161,14963,107138
78582,42212,42431,42130,41646,40729,40216,40455,289819
78583,6854,6790,6134,5799,5779,5886,6623,43865
78584,18573,18283,18159,17893,18225,18344,18128,127605
78585,347,308,237,289,415,442,396,2434
78586,56314,57019,57459,58144,56581,54169,55878,395564
78588,231,250,172,111,219,205,238,1426
78589,40261,39959,38950,37773,37441,36856,38004,269244
78590,312,329,303,341,308,351,289,2233
78591,266,230,347,219,148,187,265,1662
78592,968,988,1124,1050,1069,1002,836,7037
78593,6250,6105,5605,5726,5090,5360,6324,40460
78594,1577,1676,1676,1590,1955,2129,1990,12593
78595,5981,5905,6165,6087,5696,5675,6082,41591
78596,65499,65919,65875,66125,64987,63292,63844,455541
78597,2888,2888,2932,2911,2957,3035,2885,20496
78598,121,70,104,192,297,257,226,1267
78602,27043,25855,25444,26278,25594,24532,25160,179906
78605,5820,5415,5408,5011,4925,4971,4952,36502
78606,5472,5336,5379,5379,5117,5088,5205,36976
78607,74,80,92,101,85,166,166,764
78608,494,462,409,264,268,188,434,2519
78609,1828,1551,1411,1560,1541,1632,2012,11535
78610,30452,29200,26991,25580,24313,22052,23502,182090
78611,12900,13371,13108,13226,13137,13215,12977,91934
78612,12369,11622,12032,10807,11564,11373,11457,81224
78613,75279,73448,70764,68426,65178,63901,65099,482095
78614,466,462,491,492,708,848,456,3923
78615,1040,1045,970,818,814,866,1290,6843
78616,6620,5693,5448,5645,6289,6339,7092,43126
78617,26126,25473,23025,21096,19553,18572,22210,156055
78618,374,312,263,283,255,253,324,2064
78619,3585,3824,3805,3446,3504,3532,3026,24722
78620,15140,14614,14104,14660,14483,14578,14367,101946
78621,22185,21735,22289,21863,21352,22273,21659,153356
78622,265,243,247,201,241,137,296,1630
78623,752,777,638,809,742,701,813,5232
78624,21850,21746,21629,21850,21472,21385,21513,151445
78626,30163,28876,28092,27346,27412,27211,25996,195096
78628,27637,26544,24856,24603,23288,23269,23727,173924
78629,12194,12172,12091,12018,11565,11526,11887,83453
78631,2323,2408,2343,2227,2114,2091,2395,15901
78632,917,1014,930,723,864,748,910,6106
78633,23369,21980,19593,18462,17556,17181,19349,137490
78634,28479,26701,25421,24306,22731,21778,22791,172207
78635,65,13,16,19,107,156,149,525
78636,4024,4066,3966,4014,4103,3633,3749,27555
78638,1935,2257,2538,2272,2060,2115,2005,15182
78639,8258,7991,7861,7334,7142,6881,7334,52801
78640,48804,45772,45136,43427,42080,40699,42954,308872
78641,55933,52984,51247,48854,47490,43655,44295,344458
78642,10416,9879,9867,9341,9175,8498,9467,66643
78643,5810,5912,6016,6081,6484,6567,6139,43009
78644,18558,18282,17276,17542,16820,16772,17081,122331
78645,10290,10274,10312,10148,10012,10308,9773,71117
78648,7746,7824,8238,7866,7971,7899,7683,55227
78650,1729,1985,1937,1746,1622,1549,1599,12167
78652,4919,5355,5408,5117,4687,4256,4466,34208
78653,19328,19072,17968,16917,15783,14631,16375,120074
78654,18086,17860,17607,16916,16771,16851,17553,121644
78655,3431,3574,4006,3917,3684,3694,2739,25045
78656,2455,2309,2194,2118,2445,2529,2271,16321
78657,5376,5741,5946,6236,5959,6058,5509,40825
78659,3093,3118,2870,3140,2799,3052,2903,20975
78660,81698,79067,77046,75038,70407,67630,68789,519675
78661,530,382,333,312,260,152,335,2304
78662,2419,2982,3048,3266,2818,2941,2268,19742
78663,829,750,975,827,783,720,746,5630
78664,60884,59765,58959,57806,54864,51942,52932,397152
78665,43715,41517,38829,36291,33133,31767,35985,261237
78666,75968,72866,68704,66027,63255,61953,63836,472609
78669,10734,9303,8909,8418,8737,8834,8731,63666
78670,152,156,369,367,420,484,168,2116
78671,614,561,609,739,865,785,654,4827
78672,1252,1096,814,994,935,830,931,6852
78675,304,187,169,224,247,204,188,1523
78676,13202,12413,12215,12453,12177,11750,12602,86812
78677,46,100,116,101,112,121,92,688
78681,56086,54923,54517,54141,53229,51409,50606,374911
78701,7401,7051,6188,5915,5642,5084,6841,44122
78702,22617,21477,21855,21655,21032,20643,21334,150613
78703,20815,20530,20061,19860,19873,19579,19690,140408
78704,46474,44668,42770,41999,41709,41616,42117,301353
78705,32414,32346,31735,31282,30532,29247,31340,218896
78712,848,828,557,548,554,544,860,4739
78717,27101,26072,25427,24099,23514,22278,22538,171029
78719,1762,1485,1807,1746,1717,1427,1764,11708
78721,12153,12508,12087,11482,11178,11100,11425,81933
78722,7292,7006,6514,6355,5973,5733,5901,44774
78723,32496,32155,30955,31234,30999,29869,28330,216038
78724,24558,23612,23313,21454,21677,20447,21696,156757
78725,7931,7343,7612,8169,6477,6021,6083,49636
78726,13925,13027,12786,13181,12482,13198,13122,91721
78727,29085,29354,29506,28563,28461,28075,26689,199733
78728,21858,21081,20794,20817,20939,20232,20299,146020
78729,30151,29386,28786,26906,28228,27024,27108,197589
78730,9038,8871,8591,8916,8312,8242,7955,59925
78731,27401,26595,26412,25575,24716,24898,24614,180211
78732,16851,16269,15312,15097,14307,13389,14060,105285
78733,8886,8930,9404,9475,9486,9219,8762,64162
78734,18997,18948,18498,18290,17824,16729,17655,126941
78735,16948,17438,17548,17118,16882,16024,16131,118089
78736,7951,7621,7030,6599,6841,6599,6946,49587
78737,14731,14544,14167,13539,12882,12458,12081,94402
78738,14970,14795,13794,13141,12457,11504,12134,92795
78739,19564,18442,18068,17198,16911,15957,16792,122932
78741,51981,51770,51274,48654,48246,46959,44935,343819
78742,714,748,566,810,901,780,820,5339
78744,47211,46408,45830,44375,43452,41593,42820,311689
78745,61317,59758,58878,57559,54917,55010,55614,403053
78746,27971,27928,27960,27506,26939,26677,26928,191909
78747,19876,18544,16753,15919,14158,13179,14808,113237
78748,47966,46679,44907,41710,40290,37784,40651,299987
78749,36478,36210,35183,34392,34391,33947,34449,245050
78750,29991,28626,27912,27012,27119,26734,26814,194208
78751,14648,14441,13838,14045,14340,14526,14385,100223
78752,19902,20153,19639,18381,17170,16494,18064,129803
78753,56131,55077,53994,52674,52384,51547,49301,371108
78754,21764,19020,16494,15109,13570,13326,15036,114319
78756,8798,8908,8685,8125,8060,7682,7194,57452
78757,23611,23118,23442,22655,22718,22542,21310,159396
78758,46506,46972,45134,45623,45105,43577,44072,316989
78759,41415,40629,40067,39895,39850,40602,38891,281349
78801,22153,21555,21868,21761,22124,22139,21780,153380
78802,462,906,940,1002,614,495,242,4661
78827,1301,1253,1566,1775,1714,1477,1219,10305
78828,98,173,180,202,168,288,258,1367
78829,1376,1180,1186,1151,1108,1251,1207,8459
78830,782,756,562,713,698,714,786,5011
78832,3578,3577,3598,3589,3574,3656,3598,25170
78833,1239,1217,1388,1372,1434,1298,1299,9247
78834,8571,8510,8298,7634,7426,7458,7829,55726
78836,146,146,45,20,31,55,128,571
78837,166,247,195,181,223,269,281,1562
78838,220,181,149,213,175,137,275,1350
78839,8834,8828,8753,8747,8598,8296,8578,60634
78840,48278,48348,48556,48325,48064,47902,48149,337622
78843,400,351,227,197,204,165,336,1880
78850,1208,1151,1341,1297,1240,1330,1145,8712
78851,31,27,13,31,30,41,23,196
78852,55307,54981,54447,53600,53307,52524,53040,377206
78860,162,239,235,293,158,113,229,1429
78861,13675,13828,14054,13006,13545,13465,13701,95274
78870,1181,1192,992,977,897,860,984,7083
78871,7,16,10,18,76,71,45,243
78872,1939,2069,2140,2079,2072,2184,1905,14388
78873,1960,1904,1748,1731,1767,1709,1788,12607
78877,1125,1112,1139,987,642,752,989,6746
78879,221,300,248,300,179,267,264,1779
78880,1850,1710,1842,1842,1870,1808,1682,12604
78881,2284,2336,2165,2039,2048,2149,2335,15356
78883,325,333,278,305,232,99,353,1925
78884,944,971,902,915,873,904,1158,6667
78885,115,108,91,106,89,129,120,758
78886,426,429,604,624,607,586,647,3923
78931,143,153,150,189,130,225,323,1313
78932,520,583,485,481,475,420,757,3721
78933,1092,1125,1233,1347,1325,1021,1433,8576
78934,5636,6040,5950,6349,6535,6508,6712,43730
78935,1706,1788,1301,1144,1206,1366,978,9489
78938,498,483,458,517,646,385,471,3458
78940,2176,2162,2227,2383,2009,2202,2098,15257
78941,2951,2981,2962,2754,2877,2870,2962,20357
78942,8513,8688,8452,8486,8522,8728,8989,60378
78943,121,121,222,298,330,367,352,1811
78944,590,521,618,722,716,561,562,4290
78945,10230,10288,10466,10465,10762,10966,10494,73671
78946,799,910,1040,1007,923,1083,960,6722
78947,4246,4197,4556,4631,5030,4917,4475,32052
78948,834,909,952,865,802,852,850,6064
78949,784,636,505,392,284,411,517,3529
78950,2590,2591,2951,2591,2465,2101,2038,17327
78951,0,0,0,34,38,44,26,142
78953,650,826,861,804,861,663,934,5599
78954,1049,991,1152,1179,1290,1281,1071,8013
78956,5195,5135,5105,5270,5292,5195,5381,36573
78957,9146,9170,8746,8502,8487,8434,9067,61552
78959,2250,2054,2160,2209,1910,1718,1837,14138
78962,5786,5399,5298,4803,4641,4304,4733,34964
78963,1015,1038,958,921,791,711,909,6343
79001,241,289,319,287,224,260,249,1869
79003,232,218,230,233,224,193,162,1492
79005,1659,1748,1686,1692,1627,1701,1735,11848
79007,14314,14304,14403,14388,14381,14467,14542,100799
79009,2011,2171,2222,2334,2117,2133,2166,15154
79010,920,811,696,705,760,632,802,5326
79011,261,267,297,286,268,204,236,1819
79012,1389,1341,1092,1044,1053,883,976,7778
79013,3445,3243,3258,3192,3158,3197,3423,22916
79014,4123,4078,4001,3956,3836,3741,3771,27506
79015,21714,21797,21341,20629,19935,19297,19277,143990
79016,114,112,105,99,91,83,94,698
79018,247,333,356,400,535,568,548,2987
79019,1734,1784,1771,1581,1607,1744,1707,11928
79021,139,118,119,104,132,119,138,869
79022,11424,11309,11308,11126,10744,10600,10741,77252
79024,458,414,426,343,407,367,405,2820
79025,36,51,49,32,44,26,69,307
79027,5093,5009,5109,5080,5049,4983,5223,35546
79029,16543,16726,16459,16333,16191,15674,16177,114103
79031,1339,1250,1290,1346,1362,1432,1425,9444
79032,173,127,120,128,69,102,157,876
79033,87,83,76,60,30,8,109,453
79034,681,692,712,793,741,671,637,4927
79035,4824,4831,4819,4989,5352,5190,5309,35314
79036,5628,5425,5504,5287,5246,5462,5128,37680
79039,916,827,701,727,733,723,779,5406
79040,1606,1600,1599,1583,1746,2098,1839,12071
79041,3326,3488,3708,3784,3310,2992,3194,23802
79042,1235,1270,1246,1330,1124,1160,1169,8534
79043,1531,1519,1586,1722,1587,1420,1487,10852
79044,660,760,609,570,619,579,766,4563
79045,19177,19463,19584,19483,19628,19611,19473,136419
79046,642,542,526,448,458,436,489,3541
79051,36,34,47,30,25,29,29,230
79052,1128,1145,1107,1189,1113,1062,1259,8003
79053,199,184,195,163,107,130,137,1115
79054,472,420,376,360,350,499,594,3071
79056,64,64,62,60,48,38,63,399
79057,1463,1417,1305,1198,1167,1127,1206,8883
79058,0,0,0,0,0,0,10,10
79059,790,776,743,857,926,847,837,5776
79061,439,476,379,482,472,467,316,3031
79062,209,312,315,324,332,248,218,1958
79063,622,656,689,711,625,735,686,4724
79064,2216,2199,2263,2405,2609,2830,2739,17261
79065,21225,21383,21362,21431,21324,21139,20840,148704
79068,3174,3220,3105,2948,3054,3102,3197,21800
79070,10280,10333,10307,10312,10193,10079,9919,71423
79072,27216,27583,27761,28073,28706,28920,28849,197108
79078,255,254,261,326,392,412,377,2277
79079,2619,2466,2463,2392,2483,2731,2646,17800
79080,575,547,662,647,673,620,605,4329
79081,4174,4152,4083,3988,3856,3634,3912,27799
79082,315,327,382,342,423,362,315,2466
79083,2015,2153,2194,2529,2321,2203,2661,16076
79084,2403,2465,2528,2495,2486,2304,2366,17047
79085,19,10,7,53,69,103,53,314
79086,2187,2306,2365,2421,2336,2427,2105,16147
79087,689,749,785,857,855,833,751,5519
79088,5760,5736,5906,5707,5881,5924,5945,40859
79091,217,218,194,155,97,64,147,1092
79092,915,905,923,1109,1076,1065,1106,7099
79093,56,79,28,24,24,34,69,314
79094,70,65,106,104,109,99,75,628
79095,2702,2810,2688,2685,2645,2671,2686,18887
79096,2276,2288,2346,2233,2097,1809,2229,15278
79097,1002,1095,1167,1239,1279,1240,1150,8172
79098,588,592,419,480,423,382,517,3401
79101,2372,2520,2722,2653,2345,2494,2817,17923
79102,9936,9709,9511,9689,9449,9309,9963,67566
79103,11203,11765,11624,11613,11831,11338,10594,79968
79104,6866,6562,6852,7191,7498,7353,7869,50191
79105,0,0,0,0,0,0,6,6
79106,28360,28859,28605,28697,28325,28412,27967,199225
79107,34875,35149,34932,34436,34568,34783,33844,242587
79108,16300,17172,17096,16968,16698,16341,17726,118301
79109,43027,43388,43881,42512,43583,44684,43516,304591
79110,19909,19681,19043,18635,18314,18617,18811,133010
79111,1955,1824,1534,1496,1559,1513,1808,11689
79118,20967,19596,19092,20026,19322,18286,19726,137015
79119,15061,13736,13358,12500,11054,9985,11539,87233
79121,6714,6575,6758,6688,6724,6441,6575,46475
79124,8781,8502,8539,8766,9019,9068,7819,60494
79201,7061,7072,7039,7166,7097,7051,7040,49526
79220,309,307,281,261,174,159,197,1688
79225,1129,1118,909,914,876,912,976,6834
79226,3038,3052,3070,3048,3074,3077,3153,21512
79227,1361,1235,1213,1208,1317,1343,1406,9083
79229,396,312,390,369,391,466,424,2748
79230,122,111,198,189,220,192,158,1190
79231,85,0,21,17,10,41,45,219
79233,104,105,185,217,175,212,180,1178
79234,76,72,120,100,81,95,110,654
79235,3692,3709,3730,3747,3758,3763,3833,26232
79236,246,238,258,275,188,241,262,1708
79237,482,482,469,491,554,542,513,3533
79239,149,182,242,198,196,239,211,1417
79240,0,22,18,61,82,51,60,294
79241,2206,2364,2396,2512,2556,2658,2480,17172
79243,69,52,48,92,93,82,90,526
79244,625,602,634,504,548,534,720,4167
79245,2479,2412,2192,2262,2153,2189,2476,16163
79247,67,82,46,42,43,58,64,402
79248,1498,1458,1548,1496,1577,1612,1493,10682
79250,1486,1421,1488,1461,1374,1450,1508,10188
79251,49,35,72,73,72,52,45,398
79252,2920,2955,3178,3213,3288,3356,3202,22112
79255,720,688,574,622,489,436,571,4100
79256,307,377,390,430,395,345,319,2563
79257,1003,1061,1115,1070,1248,1294,1067,7858
79258,49,40,52,45,36,0,67,289
79259,37,48,87,81,186,147,48,634
79261,455,525,651,625,659,642,527,4084
79311,3758,3863,3811,3898,3595,3492,3445,25862
79312,1050,1242,1207,1171,1081,991,971,7713
79313,1750,1704,1615,1555,1495,1517,1571,11207
79314,85,100,100,72,73,59,56,545
79316,11521,11276,11318,11120,11226,11069,11451,78981
79322,1979,2017,2067,2077,2116,2086,2049,14391
79323,6987,6649,6270,6192,6002,6167,6559,44826
79324,17,12,7,6,3,0,61,106
79325,2467,2407,2517,2345,2307,2454,2319,16816
79326,98,22,0,0,0,0,40,160
79329,3290,3528,3501,3552,3635,3532,3300,24338
79330,255,263,194,174,64,40,114,1104
79331,12978,13038,13169,13195,13163,13263,13258,92064
79336,17364,17209,16955,16941,17183,16843,16972,119467
79339,6932,7220,7258,7170,7158,7178,7230,50146
79342,606,494,568,571,593,524,352,3708
79343,1568,1462,1459,1393,1445,1427,1571,10325
79344,76,95,13,44,40,62,56,386
79345,842,1001,951,968,967,1108,920,6757
79346,2170,2185,2297,2387,2426,2460,2427,16352
79347,7359,7380,7462,7338,7304,7250,7462,51555
79350,345,359,271,268,311,254,392,2200
79351,1399,1363,1419,1491,1479,1329,1326,9806
79353,46,46,46,7,6,6,10,167
79355,2023,2094,2229,2340,2267,2086,1942,14981
79356,6302,6109,6124,6157,6205,6272,6363,43532
79357,2353,2423,2421,2480,2376,2517,2303,16873
79358,1029,978,1143,1112,1120,1277,1116,7775
79359,2851,2871,2760,2913,2902,3691,2899,20887
79360,15169,14810,14479,13914,13582,12421,13574,97949
79363,5511,5368,5078,5182,5104,5011,5369,36623
79364,7768,7946,7861,8234,8188,8168,8172,56337
79366,1325,1319,1411,1397,1218,1244,1096,9010
79367,825,891,784,803,678,589,645,5215
79369,153,113,126,86,120,97,88,783
79370,1533,1691,1706,1738,1891,1848,1889,12296
79371,1472,1389,1368,1415,1301,1316,1317,9578
79372,1248,1291,1331,1270,1232,1473,1434,9279
79373,2998,3183,3257,3356,3371,3339,3307,22811
79376,51,92,103,77,76,54,95,548
79377,240,290,249,233,208,181,277,1678
79378,319,369,354,362,300,346,236,2286
79379,706,715,663,664,613,640,666,4667
79380,207,243,278,281,283,252,197,1741
79381,1514,1335,1340,1263,1223,1269,1263,9207
79382,6691,6231,5974,6052,6047,6126,6291,43412
79401,7715,7799,7639,7092,6398,6265,8408,51316
79403,17370,17073,17237,17888,18083,17511,16869,122031
79404,10724,11328,11133,10947,10833,10866,11289,77120
79406,6871,6628,6846,7154,7282,7318,6025,48124
79407,19307,18243,17787,17485,17612,18432,19068,127934
79410,9524,9273,8926,8863,9078,8563,9429,63656
79411,8665,8763,8946,9178,8326,7806,7951,59635
79412,16624,16301,16325,16052,15800,15363,15650,112115
79413,21712,22243,21454,20967,20008,21134,21187,148705
79414,18606,18539,18647,18259,18265,17275,17121,126712
79415,17641,17392,17358,17406,17178,17234,17689,121898
79416,33856,33839,33411,32772,31849,31886,32296,229909
79423,36462,35245,35063,33809,32937,31568,32277,237361
79424,44788,43576,42008,40114,40330,38885,39023,288724
79501,2999,3077,3131,3126,3361,3292,3528,22514
79502,1121,1273,1277,1215,1234,1139,1350,8609
79503,238,199,153,183,134,138,175,1220
79504,3253,3099,3065,2933,2853,3078,2787,21068
79505,330,334,349,377,431,382,296,2499
79506,780,861,825,762,818,826,730,5602
79508,1586,1266,1158,1266,1284,1177,1242,8979
79510,7365,7592,7519,7973,7974,7869,7982,54274
79511,1295,1231,1128,941,998,874,1338,7805
79512,8074,8149,8147,8171,8268,8367,8197,57373
79517,299,216,156,171,232,165,200,1439
79518,60,91,163,182,159,166,124,945
79519,62,104,66,86,110,64,74,566
79520,2169,2230,2371,2254,2333,2176,2449,15982
79521,4091,3852,3897,3737,3760,3799,3980,27116
79525,2150,1791,2081,2409,2268,2553,2842,16094
79526,991,1134,1038,817,986,979,979,6924
79527,231,197,170,245,269,253,251,1616
79528,576,667,643,677,602,625,619,4409
79529,1335,1386,1361,1336,1330,1321,1383,9452
79530,454,393,420,426,495,511,480,3179
79532,740,797,873,981,913,864,940,6108
79533,284,215,258,329,461,537,472,2556
79534,84,78,119,200,229,291,181,1182
79535,97,74,54,78,105,100,183,691
79536,4811,4655,4631,4190,4127,4479,4988,31881
79537,40,84,99,107,116,160,111,717
79538,199,161,226,195,180,178,271,1410
79539,151,158,206,200,196,219,178,1308
79540,61,72,64,82,103,121,89,592
79541,1104,1009,1171,1096,754,651,791,6576
79543,1176,1192,1118,1224,1123,1182,1186,8201
79544,431,510,439,421,380,359,512,3052
79545,1942,1941,1855,1760,1749,1697,1788,12732
79546,1881,1921,1980,1932,2015,1938,2006,13673
79547,623,773,791,740,833,802,758,5320
79548,170,186,233,227,195,150,174,1335
79549,16018,15890,15912,15938,15497,15341,15652,110248
79553,3351,3414,3277,3465,3560,3530,3469,24066
79556,12885,12899,13029,13006,13001,13028,12995,90843
79560,91,80,69,75,108,108,137,668
79561,595,606,606,618,529,633,662,4249
79562,4077,3896,3876,3745,4034,3491,3669,26788
79563,1008,1110,1253,1200,1222,1377,1161,8331
79565,241,250,260,294,237,192,295,1769
79566,288,326,274,264,290,245,333,2020
79567,3268,3274,3175,3151,3313,3253,3373,22807
79601,27548,28056,27433,27825,26920,26718,25085,189585
79602,22703,22440,21885,21634,21690,22011,21519,153882
79603,24371,24488,23877,24213,23095,22282,24288,166614
79605,30011,29264,29903,29105,29315,29677,30098,207373
79606,23647,24026,23879,23369,24033,23830,22885,165669
79607,3346,3325,3098,3067,2749,2426,2865,20876
79699,170,199,209,331,397,386,321,2013
79701,29593,29659,29065,28757,28634,26927,27728,200363
79703,22610,23736,22116,21214,20391,20759,20592,151418
79705,38519,35954,34407,32784,32807,32476,33536,240483
79706,23489,21745,21187,20577,19181,18106,19571,143856
79707,37590,36158,35566,35381,34289,33718,32854,245556
79713,344,467,466,628,657,775,592,3929
79714,17215,16775,16126,15554,15006,14500,14786,109962
79718,810,768,781,1111,1000,1272,721,6463
79719,667,486,419,464,436,399,397,3268
79720,35080,34787,34470,34255,33787,33645,33640,239664
79730,298,326,253,276,237,181,250,1821
79731,4591,4488,4400,4282,4134,4167,4193,30255
79733,207,216,232,180,194,149,210,1388
79734,2110,2120,2133,2143,2118,2123,2137,14884
79735,13694,13683,13409,13396,13368,13490,13315,94355
79738,254,345,319,301,333,392,275,2219
79739,1047,954,928,956,1030,971,963,6849
79741,240,258,277,243,286,274,288,1866
79742,465,393,441,469,503,502,490,3263
79743,393,395,359,328,337,256,339,2407
79744,1151,1245,1375,1288,1253,1223,1362,8897
79745,6656,6509,6273,6110,6183,6155,6125,44011
79748,161,120,99,108,134,118,173,913
79749,344,390,392,368,323,315,255,2387
79752,2395,2301,2282,2255,2185,2171,2245,15834
79754,63,104,75,71,85,62,80,540
79755,219,224,194,168,187,148,230,1370
79756,9562,9583,9484,9134,8927,8714,9066,64470
79758,1894,1579,1354,1550,1777,1876,2197,12227
79759,14,15,14,0,0,0,23,66
79761,34203,33502,32399,31644,29950,29837,30488,222023
79762,43792,43084,42142,40531,40731,39457,39056,288793
79763,36883,35124,35038,34258,34502,33074,34079,242958
79764,21603,22111,20783,20868,20079,20316,20725,146485
79765,12199,11026,9742,8298,7403,7135,6927,62730
79766,6597,7138,7431,7928,6860,6671,6115,48740
79770,41,59,45,0,0,0,33,178
79772,13343,12997,12763,12063,11939,11571,12747,87423
79777,230,249,197,321,355,462,170,1984
79778,861,880,863,900,928,959,878,6269
79780,168,243,321,447,498,473,224,2374
79781,334,177,264,290,298,308,303,1974
79782,4449,4308,4247,4001,3989,3874,3976,28844
79783,333,281,194,244,165,120,201,1538
79785,113,164,127,227,240,207,91,1169
79788,421,452,397,372,411,457,506,3016
79789,1043,1052,1131,1150,954,884,974,7188
79821,7011,6822,6925,6845,7305,7740,7142,49790
79830,7894,7651,7569,7514,7559,7320,7682,53189
79831,11,22,17,21,11,13,29,124
79834,163,169,141,153,183,275,200,1284
79835,12533,12676,12703,12041,12775,12556,12690,87974
79836,5694,5038,5624,5226,5067,4928,5772,37349
79837,423,425,392,443,454,540,579,3256
79838,7552,8031,8514,8290,8586,8399,8699,58071
79839,1736,1845,1837,1880,2061,1990,1938,13287
79842,454,558,662,613,547,638,498,3970
79843,2283,2293,2376,2516,2685,2777,2503,17433
79845,4753,4897,5052,5017,4886,4785,5138,34528
79846,88,93,31,30,87,153,104,586
79847,72,73,56,49,51,63,167,531
79848,725,866,786,795,957,891,927,5947
79849,12472,12658,14036,14097,13656,13935,13208,94062
79851,1064,822,831,784,714,696,641,5552
79852,666,835,881,895,832,799,799,5707
79853,3048,3182,3320,3159,3163,3167,3729,22768
79854,118,133,150,164,190,178,213,1146
79855,2254,2281,2320,2338,2391,2420,2336,16340
79901,10351,10347,10786,10626,10473,10575,11328,74486
79902,20750,20834,20592,21099,21142,20440,21236,146093
79903,16585,16456,17795,17762,17836,18107,18451,122992
79904,34060,34857,35337,34241,33652,33229,35060,240436
79905,24526,24522,25557,25034,24372,24529,26036,174576
79906,4863,4874,4379,4416,4333,4384,4374,31623
79907,54337,55470,54694,54563,55584,54982,55132,384762
79908,4798,4327,3336,2847,2326,1870,3673,23177
79911,3908,3763,3308,2685,2172,1849,1565,19250
79912,79492,79252,79313,78697,77242,76448,77161,547605
79915,36622,36980,38018,38748,39402,39650,40057,269477
79916,2968,2884,2918,2968,2915,3144,2995,20792
79920,46,79,57,66,73,52,153,526
79922,8581,8606,8592,8258,8415,8491,8935,59878
79924,59901,59019,58743,59115,58320,58932,59058,413088
79925,39990,40639,41529,40935,41111,41708,40641,286553
79927,40304,40242,39872,39057,38132,37738,39016,274361
79928,57415,56629,53476,51248,48055,44205,49544,360572
79930,30029,30342,29426,29989,30123,28528,28410,206847
79932,27697,27136,26041,26725,26219,25461,24986,184265
79934,24879,24062,23743,21857,19674,17995,19174,151384
79935,18227,18737,18560,18718,18623,18249,18042,129156
79936,113255,113887,113451,114734,115538,114941,111086,796892
79938,71965,68980,63471,59252,54984,51367,53520,423539
79942,18,17,0,0,0,0,2,37
80002,18461,18439,17932,18742,18129,17865,18020,127588
80003,36341,36518,35797,35337,35741,35506,35384,250624
80004,37152,37070,36680,36093,35586,35769,35892,254242
80005,28634,27662,27523,26763,26669,25938,25553,188742
80007,8691,7537,7061,6957,7137,6996,7262,51641
80010,43389,43987,43999,43169,42836,41088,39728,298196
80011,49110,48360,47287,47508,47631,47269,47461,334626
80012,50782,49010,48382,46974,44739,44060,46665,330612
80013,72168,72348,71619,71261,70239,69744,69588,496967
80014,38502,37617,37059,35735,35483,35618,36710,256724
80015,65940,65718,64819,64460,64040,63089,62432,450498
80016,49384,47660,45795,42252,40210,37499,41219,304019
80017,35251,35269,33978,34144,33945,34656,34270,241513
80018,11701,10954,10512,10118,9860,9306,9206,71657
80019,2578,2368,2349,2181,1952,1663,1690,14781
80020,48928,48889,49118,48889,48700,48320,46871,339715
80021,32245,31685,30705,31004,30292,29760,30051,215742
80022,46985,46336,45663,43605,42662,41066,42699,309016
80023,19654,19094,17186,15193,14322,12786,15415,113650
80024,369,347,606,441,420,402,228,2813
80025,517,460,251,253,248,228,253,2210
80026,28903,28340,27389,26885,26730,26268,26378,190893
80027,32989,32417,31946,31580,31175,30911,31034,222052
80030,16293,15703,16045,15216,15307,15895,15329,109788
80031,36283,35352,35081,34196,33131,32424,33932,240399
80033,24653,24805,24838,24712,24660,24615,23969,172252
80045,759,659,612,559,340,307,277,3513
80101,430,418,332,270,183,203,392,2228
80102,5275,5101,5136,5142,4969,5271,5514,36408
80103,2736,2702,2682,2420,2354,2529,2458,17881
80104,29033,28209,28558,27359,27061,27155,27588,194963
80105,1287,1399,1165,1170,1096,1073,1171,8361
80106,4608,4336,4457,4417,4791,5033,4232,31874
80107,12424,12492,12575,11881,11577,11423,12042,84414
80108,25178,24912,23949,23619,22341,21155,22612,163766
80109,19794,19152,18986,18331,18096,16847,17219,128425
80110,21794,22085,21457,21154,20999,21501,20867,149857
80111,31925,31114,30537,29815,28854,28003,28948,209196
80112,32564,31941,30342,29896,28476,27790,29217,210226
80113,22213,21285,21165,20946,20558,20433,20562,147162
80116,3987,3914,3800,3685,3542,3540,3942,26410
80117,2621,2624,2699,2759,2792,2846,2587,18928
80118,6354,6201,5379,5360,5211,5092,5308,38905
80120,30825,30556,29957,29360,28745,28299,28435,206177
80121,19343,18907,18616,18458,18070,17923,17853,129170
80122,31808,31383,31230,30457,29987,29993,29783,214641
80123,45802,45527,44795,44102,44097,43454,44795,312572
80124,20014,19652,19276,18550,18244,17965,18020,131721
80125,10685,10876,10540,9821,10057,10181,10190,72350
80126,44220,42834,41667,40965,39455,39564,39698,288403
80127,44691,44341,44570,44416,43780,43181,42597,307576
80128,35689,35924,35691,36353,36007,35662,34988,250314
80129,30074,29228,28112,28175,28058,27438,27007,198092
80130,29506,29361,28764,28973,28605,27926,27054,200189
80131,206,140,144,114,113,115,243,1075
80132,20555,20618,20221,20367,19891,19287,19637,140576
80133,2457,2179,2154,2080,2014,1726,2042,14652
80134,61098,59325,58232,57110,56044,54421,55075,401305
80135,3961,4007,3856,3571,3389,3813,3833,26430
80136,5063,5243,5074,5527,5124,5334,4834,36199
80137,1556,1313,1153,1117,961,850,1323,8273
80138,32114,30745,30693,29962,29660,28253,29786,211213
80202,12643,12386,11474,10977,10345,9133,10148,77106
80203,20515,20547,20214,19668,19156,18125,18839,137064
80204,32306,31685,31133,30307,30436,30884,31493,218244
80205,32546,30546,30956,29856,27903,27415,29221,208443
80206,23515,22668,21295,21364,21003,20794,21521,152160
80207,25343,24455,23296,21235,20790,20252,21216,156587
80209,25246,24301,23413,22104,21754,21104,21526,159448
80210,35987,35808,35974,35464,34778,34282,33946,246239
80211,33258,33321,32797,33007,32167,31798,31583,227931
80212,19422,18940,18570,17832,17919,18310,18051,129044
80214,25252,25043,25598,25517,24808,25143,24821,176182
80215,19263,18800,18231,18343,17674,17333,17843,127487
80216,12462,11546,11232,11389,11105,10349,10924,79007
80218,18786,19066,18462,18830,18305,18420,17928,129797
80219,67342,65275,65449,64506,62878,60061,61296,446807
80220,35715,36193,36162,35486,34437,33129,33529,244651
80221,40484,40242,40341,40010,39459,37927,37779,276242
80222,21272,21074,20673,20313,19438,19512,20073,142355
80223,19674,19216,17912,17261,16314,16528,17987,124892
80224,19065,18447,17454,16635,16142,15778,17256,120777
80226,32312,31628,31616,30789,31405,30467,30930,219147
80227,34983,34694,34139,33473,34006,34259,33667,239221
80228,32447,32112,31455,30596,30256,30767,30138,217771
80229,54121,52588,51224,51123,50553,48826,49598,358033
80230,8491,8356,8393,8336,8294,7888,7559,57317
80231,35910,36031,34516,33647,33217,31947,32127,237395
80232,22398,22461,21642,21441,21414,21661,21411,152428
80233,49579,48916,46886,45830,45565,44274,45386,326436
80234,26861,26040,26289,25933,25770,26284,25937,183114
80235,7902,8138,7888,9088,9170,8986,7571,58743
80236,18484,17662,16914,16838,17157,16679,16123,119857
80237,19873,19167,18445,18046,17552,17182,17569,127834
80238,14854,13194,11965,11296,10217,9651,10058,81235
80239,45839,44561,43211,41066,39428,39801,40512,294418
80241,33760,33108,33242,32605,31421,31605,31746,227487
80246,13284,13113,12719,12248,12582,12474,12875,89295
80247,27456,26827,25588,25314,24897,24004,25449,179535
80249,29024,28724,27505,26383,25792,23103,23404,183935
80260,34801,35123,33835,32327,30920,29738,31412,228156
80264,0,0,0,0,0,0,0,0
80290,0,0,0,0,0,0,0,0
80293,0,0,0,0,0,0,0,0
80294,0,0,0,0,0,0,0,0
80301,25099,24182,23980,23977,23765,23170,22555,166728
80302,28484,28825,28003,27352,27077,26617,26941,193299
80303,24321,23295,23505,22740,22936,23198,22361,162356
80304,26732,27241,26471,26251,26005,25110,25623,183433
80305,17643,17358,17401,17689,17326,17683,16874,121974
80310,6642,6680,6630,6381,5953,5598,6578,44462
80401,41073,40160,39336,38541,37782,37534,39378,273804
80403,18498,18585,18345,18408,18429,18125,18211,128601
80419,0,0,382,312,259,215,0,1168
80420,791,850,955,687,668,640,933,5524
80421,8698,8443,8189,8459,8859,9198,8042,59888
80422,4686,4427,4424,4382,4219,4209,4326,30673
80423,204,119,132,153,87,142,169,1006
80424,9847,9476,9546,9078,8977,8275,9627,64826
80425,305,226,244,203,152,137,184,1451
80426,77,103,217,272,213,239,104,1225
80427,762,844,759,733,666,614,822,5200
80428,728,733,613,514,559,560,706,4413
80432,159,138,104,65,23,162,439,1090
80433,8333,8101,8348,8271,8924,8843,8354,59174
80434,26,28,47,49,64,66,43,323
80435,7248,7452,7928,8370,8468,8139,7278,54883
80436,462,488,469,537,570,647,565,3738
80438,411,392,350,339,308,364,486,2650
80439,24130,23786,23746,24208,23160,22425,23778,165233
80440,2503,2479,2353,2218,2249,1978,2422,16202
80442,2301,2489,2759,2451,2744,2699,2309,17752
80443,3755,3686,3345,3228,3125,3324,3676,24139
80444,1233,1120,1175,1152,1211,1344,1080,8315
80446,4200,3698,3604,3775,4103,3700,3715,26795
80447,1487,1779,1675,1605,1639,1967,1964,12116
80448,210,240,278,261,130,147,193,1459
80449,816,798,753,685,681,545,909,5187
80451,890,860,812,835,819,1060,753,6029
80452,3100,3058,2762,2566,2692,2701,3097,19976
80453,337,282,267,194,78,185,197,1540
80454,1279,1322,1124,1198,1092,941,1224,8180
80455,411,499,531,509,496,543,497,3486
80456,844,828,798,689,739,727,620,5245
80457,484,687,663,475,633,735,612,4289
80459,2531,2681,2651,2532,2922,3085,2450,18852
80461,7248,7189,7170,7232,7301,6851,7090,50081
80463,153,130,140,90,147,146,136,942
80465,16404,15986,16003,15304,15000,14721,15147,108565
80466,3678,3418,3269,3237,3216,3114,3338,23270
80467,2139,2051,2173,2117,2168,2616,2224,15488
80468,330,329,350,520,469,456,391,2845
80469,324,247,271,375,391,401,337,2346
80470,3315,3463,3551,3863,4066,4263,3287,25808
80471,0,0,0,0,0,0,23,23
80473,5,43,52,60,78,107,51,396
80475,77,82,66,32,26,60,57,400
80476,223,253,248,236,202,187,194,1543
80477,149,273,414,594,643,594,155,2822
80478,1708,1541,1531,1651,733,535,1606,9305
80479,11,11,26,28,32,71,48,227
80480,1275,1264,1290,1262,1255,1321,1300,8967
80481,667,644,778,799,715,694,572,4869
80482,1019,1034,1084,1151,1158,1106,1630,8182
80483,710,624,496,622,649,596,585,4282
80487,17575,17165,16944,16645,16280,15542,16745,116896
80488,85,90,46,44,48,0,157,470
80497,600,593,364,284,214,156,411,2622
80498,7819,7733,7299,7131,6969,7602,7002,51555
80501,42667,41742,41201,40760,39911,37858,39521,283660
80503,32918,32079,32657,31302,31275,31658,31064,222953
80504,50807,49945,48431,48679,48089,47715,46876,340542
80510,461,554,560,462,345,416,420,3218
80511,150,155,129,102,74,52,76,738
80512,1732,1818,1962,1924,1957,1967,2185,13545
80513,11498,11157,10660,10398,10734,10383,10296,75126
80514,4729,4644,4554,4352,4216,4226,4106,30827
80515,1078,966,1059,872,746,662,1010,6393
80516,23492,22817,21987,20958,19824,18829,20254,148161
80517,9158,9181,9133,9046,9303,9620,9313,64754
80520,1440,1638,1475,1291,1023,966,1498,9331
80521,37170,36740,35697,35023,34427,32991,33409,245457
80524,33575,33029,32068,31738,32272,32386,31668,226736
80525,52612,51194,49259,48207,47005,47295,48419,343991
80526,46175,45590,45522,45413,44605,43650,44183,315138
80528,20027,19310,18576,18617,18633,17967,17946,131076
80530,4236,4026,3622,3515,3309,3124,3790,25622
80532,123,133,100,0,68,78,165,667
80534,16364,14726,13068,12282,11517,10693,11301,89951
80535,2493,2823,2962,2814,2497,2914,2636,19139
80536,2264,1970,2029,2067,1770,1993,1759,13852
80537,43235,42113,40278,38762,38043,37797,38821,279049
80538,45553,45154,45636,45513,44440,43433,43930,313659
80540,4709,4901,4888,5347,4996,4561,4461,33863
80542,4221,3854,3705,3626,3430,3436,3631,25903
80543,6361,6337,6094,5832,5673,5554,5887,41738
80544,34,0,0,0,0,25,111,170
80545,600,530,638,629,695,638,851,4581
80546,302,118,110,47,73,86,149,885
80547,1669,1117,1223,880,746,572,624,6831
80549,10110,9911,9540,9345,9016,8603,8642,65167
80550,23718,23050,22406,21106,20593,19809,20675,151357
80601,37139,36587,35764,35125,34371,33002,33833,245821
80602,31403,29977,28909,28516,28018,27130,27665,201618
80603,12260,11874,11502,11426,10933,10623,11973,80591
80610,3042,2936,2732,2807,2530,2672,2791,19510
80611,730,653,626,698,750,840,659,4956
80612,396,472,428,420,323,311,430,2780
80615,8023,8087,7694,7751,7443,7387,7482,53867
80620,19177,18277,17633,17827,17442,17342,17775,125473
80621,11893,11887,11924,11464,12054,12122,12079,83423
80622,245,277,238,248,189,82,268,1547
80623,946,911,976,1063,1095,989,1028,7008
80624,1283,1262,1224,1158,980,956,946,7809
80631,53871,52122,50466,49501,48154,48580,48603,351297
80634,55570,55479,55464,54656,54493,53002,52861,381525
80640,13308,12593,11692,11235,10445,10275,11054,80602
80642,4037,3936,5050,4318,4286,4435,4309,30371
80643,3268,3081,3331,3224,3126,3209,3011,22250
80644,3509,3135,3104,2815,2837,2775,2989,21164
80645,4417,4583,4567,4488,4349,4217,3905,30526
80648,1094,980,1032,1030,1020,1151,1001,7308
80649,228,244,193,251,283,294,299,1792
80650,1416,1465,1532,1564,1545,1444,1432,10398
80651,4282,4275,4110,4021,4147,4069,4176,29080
80652,350,494,237,405,452,400,574,2912
80653,891,661,683,704,692,621,791,5043
80654,2737,2618,2518,2447,2294,2207,2359,17180
80701,15469,16091,16370,16111,16301,16484,16042,112868
80705,1235,1030,906,850,851,810,884,6566
80720,2779,2766,2833,2831,2755,2846,2558,19368
80721,160,175,147,150,88,119,154,993
80722,306,317,280,279,313,434,349,2278
80723,7133,7104,7099,7221,7157,6995,7179,49888
80726,736,535,438,494,474,380,381,3438
80727,419,342,314,339,280,234,425,2353
80728,1096,1148,1033,1017,996,1045,878,7213
80729,567,467,527,508,604,681,540,3894
80731,1466,1514,1342,1581,1633,1773,1494,10803
80733,423,477,464,573,472,427,529,3365
80734,2827,2771,2972,2931,3016,2858,3045,20420
80735,556,429,431,457,457,399,405,3134
80736,517,548,576,596,579,656,648,4120
80737,1628,1609,1568,1553,1505,1561,1537,10961
80740,162,152,154,110,84,66,108,836
80741,863,831,774,862,903,819,935,5987
80742,178,218,277,235,316,332,225,1781
80743,1000,1040,976,1052,1132,1068,1074,7342
80744,455,453,484,532,569,482,488,3463
80745,218,203,178,238,261,229,156,1483
80746,77,52,46,36,33,35,29,308
80747,488,544,502,476,557,496,462,3525
80749,275,294,305,285,306,347,341,2153
80750,281,289,278,354,329,311,412,2254
80751,17628,17762,18826,18641,18444,18336,18857,128494
80754,150,198,193,196,224,215,164,1340
80755,115,139,142,92,101,173,163,925
80757,348,287,322,284,254,157,255,1907
80758,3862,4045,3899,3817,3752,3875,3795,27045
80759,4547,4588,4670,4588,4569,4459,4698,32119
80801,121,121,100,86,140,116,154,838
80802,370,325,299,249,230,307,238,2018
80804,279,305,330,321,291,347,327,2200
80805,487,549,553,521,546,550,453,3659
80807,5533,5200,5313,5234,5369,5432,5304,37385
80808,6093,5849,6053,6133,5872,5374,6351,41725
80809,1374,1583,1651,1636,1509,1556,1519,10828
80810,1158,1164,1293,1233,1229,1301,1127,8505
80812,200,186,169,164,139,164,275,1297
80813,1808,1933,2087,2103,2096,2233,2055,14315
80814,3387,3485,4043,3881,4335,4682,4023,27836
80815,724,871,850,907,916,944,911,6123
80816,5587,5479,5190,5286,4949,4754,5180,36425
80817,29006,28182,28157,27947,27228,26135,27311,193966
80818,215,262,289,309,293,305,343,2016
80819,727,741,744,740,750,844,921,5467
80820,616,631,609,636,582,653,806,4533
80821,1074,1090,990,981,881,955,1093,7064
80822,282,297,324,337,285,246,260,2031
80823,145,161,175,209,225,237,203,1355
80824,218,233,258,245,288,260,207,1709
80825,465,444,487,621,547,511,422,3497
80827,682,688,606,578,531,518,549,4152
80828,3653,3606,3645,3702,3769,3649,3341,25365
80829,5893,5753,5717,5624,5535,5396,5476,39394
80830,196,193,159,170,167,215,254,1354
80831,23929,24380,24009,22256,21489,20712,21993,158768
80832,619,539,537,548,548,712,666,4169
80833,686,612,527,492,617,510,754,4198
80834,227,262,257,275,269,287,318,1895
80835,999,889,843,773,793,828,911,6036
80836,1101,1062,1121,1173,1088,1012,1157,7714
80840,5957,5864,6046,6362,6816,7240,6682,44967
80860,654,608,549,582,543,503,594,4033
80861,271,244,209,246,263,211,255,1699
80862,50,34,38,47,61,91,31,352
80863,12322,12117,11924,11811,11573,11091,11754,82592
80864,1267,1277,1142,1149,1150,1217,1325,8527
80902,12728,12508,12468,12540,11921,11408,12289,85862
80903,15318,15111,15166,14956,14405,14128,15057,104141
80904,20289,20255,19884,20436,20050,19809,19867,140590
80905,18314,17326,17341,17992,16647,15875,16254,119749
80906,36834,37019,36846,37643,37874,36858,37719,260793
80907,27745,27788,27265,26508,26005,26236,26758,188305
80908,15355,13972,13924,14060,14096,13734,13827,98968
80909,38262,38388,37199,35158,35041,34973,35739,254760
80910,30749,30765,29674,29768,28735,28086,28794,206571
80911,32530,32539,31912,31579,30470,30385,30596,220011
80913,3397,3227,3269,3144,2990,2619,2988,21634
80914,389,296,311,321,324,337,386,2364
80915,20329,20035,20237,19593,19199,19440,19519,138352
80916,38837,39131,38632,37028,37085,35520,34640,260873
80917,31685,31262,30862,29708,28703,28345,29273,209838
80918,49522,48935,48407,47189,46227,45964,45467,331711
80919,28429,27910,27701,27391,27350,27502,27398,193681
80920,39212,38668,38320,38409,38367,38256,38569,269801
80921,20962,19660,19673,19280,18687,18183,18999,135444
80922,28066,27311,26905,26468,26492,26325,26549,188116
80923,28192,28587,28292,27211,26683,25999,26105,191069
80924,7294,6757,5975,5046,4454,3594,4534,37654
80925,8658,7466,7032,6662,6195,5778,5906,47697
80926,1585,1737,1485,1273,1200,1288,1403,9971
80927,1997,1611,1153,977,824,644,604,7810
80928,1324,1343,1088,1141,1205,1221,1202,8524
80929,209,282,282,275,238,202,231,1719
80930,1652,1152,1003,885,1002,949,821,7464
80938,128,0,31,34,29,30,17,269
80939,0,0,0,0,0,0,0,0
80951,4013,4159,3942,4126,4368,4156,4202,28966
81001,30989,30568,29614,29145,29029,29527,30498,209370
81003,14984,15568,15709,15553,15094,14788,14939,106635
81004,26345,25412,25705,26051,25438,25472,25540,179963
81005,30377,30847,30692,30310,30786,30596,29975,213583
81006,12029,11638,11762,11932,12068,11851,11513,82793
81007,30495,30461,30674,29974,29522,29180,29709,210015
81008,10263,10236,10379,10839,10973,10933,9641,73264
81019,1847,1823,1541,1493,1504,1003,1690,10901
81020,762,994,955,882,1015,1126,954,6688
81021,16,13,7,9,7,6,14,72
81022,1520,1534,1418,1503,1263,1258,1560,10056
81023,1358,1285,1245,1232,1218,1127,1236,8701
81024,149,144,97,110,76,58,134,768
81025,707,907,896,974,1022,1030,1071,6607
81027,127,122,120,155,163,189,125,1001
81029,200,251,255,274,329,342,326,1977
81030,171,145,142,130,99,101,193,981
81033,148,183,288,402,370,343,155,1889
81036,1032,1009,984,1004,987,1201,962,7179
81038,0,645,407,361,315,275,486,2489
81039,1642,1764,1747,1659,1669,1756,1856,12093
81040,330,394,354,602,679,608,536,3503
81041,826,719,777,760,857,746,760,5445
81043,41,37,46,49,63,85,61,382
81044,355,331,306,392,286,206,224,2100
81045,63,83,78,61,61,92,88,526
81047,1635,1577,1637,1602,1423,1540,1559,10973
81049,273,303,308,336,328,285,289,2122
81050,9287,9492,9645,10071,10055,9796,9894,68240
81052,8928,9252,9239,9398,9620,9532,9534,65503
81054,4802,4232,4666,4745,4903,5065,5134,33547
81055,1250,1218,1429,1366,1473,1455,1339,9530
81057,495,541,442,432,470,410,418,3208
81058,881,897,934,983,1140,1162,990,6987
81059,579,534,347,354,311,326,651,3102
81062,2139,2153,1940,1986,1920,2055,2439,14632
81063,2668,2492,2478,2341,2601,2781,2726,18087
81064,287,248,267,280,343,336,282,2043
81067,6006,6064,6144,5910,5832,5835,5670,41461
81069,1667,1536,1554,1478,1681,2012,1888,11816
81071,354,358,338,349,338,429,334,2500
81073,1925,1930,1856,1851,1763,1888,1932,13145
81076,550,657,664,657,544,539,418,4029
81077,652,481,522,464,460,418,532,3529
81081,39,43,36,48,64,69,70,369
81082,11663,11702,12046,12281,12515,12591,12480,85278
81084,131,126,121,131,82,92,137,820
81087,197,246,235,192,154,87,145,1256
81089,4465,4487,4399,4326,4292,4408,4602,30979
81090,973,956,1075,1110,1164,1116,981,7375
81091,720,660,844,928,859,869,812,5692
81092,827,774,816,852,800,926,865,5860
81101,15680,15569,15330,15048,14873,14597,14675,105772
81120,1926,1919,2052,2029,2058,2036,2267,14287
81121,290,233,262,217,187,159,270,1618
81122,8036,7960,7909,7366,7478,7551,8228,54528
81123,1010,1059,1112,998,881,960,805,6825
81124,91,112,106,78,106,173,303,969
81125,3367,3352,3251,3175,3463,3632,3447,23687
81126,202,216,215,188,180,237,276,1514
81128,168,186,117,111,57,73,115,827
81129,90,123,187,207,184,196,156,1143
81130,801,758,726,756,688,686,671,5086
81131,1212,1180,1173,1215,1082,1019,1189,8070
81132,3381,3349,3249,3136,3024,2817,3231,22187
81133,956,918,876,978,958,1014,840,6540
81136,110,107,171,207,214,213,261,1283
81137,5890,5844,5704,5434,5483,5532,5225,39112
81138,59,43,42,32,63,10,56,305
81140,2702,2725,2718,2500,2399,2276,2341,17661
81141,1459,1497,1436,1499,1498,1597,1318,10304
81143,674,611,667,523,498,481,672,4126
81144,6850,7038,7015,7296,7528,7798,7344,50869
81146,608,611,652,690,651,585,531,4328
81147,11623,11564,11593,11531,11561,11714,11446,81032
81148,340,337,335,451,515,513,404,2895
81149,819,882,951,1028,1042,999,838,6559
81151,1612,1490,1362,1452,1495,1425,1470,10306
81152,1245,1281,1274,1269,1382,1241,1434,9126
81154,1178,1227,1397,1399,1300,1209,1148,8858
81155,349,345,362,355,221,166,225,2023
81201,8999,9142,8888,8953,8910,8878,8645,62415
81210,283,261,223,337,290,308,275,1977
81211,7711,7275,7364,7144,7157,7166,7623,51440
81212,29996,30263,30211,29956,30143,30300,29742,210611
81220,135,145,117,111,127,183,141,959
81221,264,286,274,279,269,257,310,1939
81222,515,441,378,388,175,171,263,2331
81223,1412,1507,1480,1402,1531,1460,1639,10431
81224,3631,3827,3677,3689,3603,2881,3446,24754
81225,1247,916,857,783,755,709,952,6219
81226,9288,9162,9090,9132,8995,8848,9066,63581
81227,7,8,12,0,0,0,10,37
81230,9128,8982,9235,9106,9179,9574,9075,64279
81231,707,724,567,618,657,675,715,4663
81232,7,6,5,44,91,88,23,264
81233,849,845,1176,1153,1172,1070,823,7088
81235,753,740,737,714,680,637,802,5063
81236,958,935,889,923,899,1064,1017,6685
81237,49,123,152,132,106,98,82,742
81239,8,10,0,9,41,80,79,227
81240,3878,3691,3698,3966,4151,4369,4323,28076
81241,87,104,65,40,71,95,78,540
81242,837,984,985,1052,913,619,606,5996
81243,141,146,142,91,73,89,93,775
81244,413,375,338,327,306,280,398,2437
81248,159,139,136,122,33,31,48,668
81251,153,173,141,100,71,159,220,1017
81252,3880,3853,3756,3715,3738,3537,3830,26309
81253,622,580,571,554,427,253,410,3417
81301,29899,29497,29280,29238,28844,28098,28308,203164
81303,8456,8080,7799,8087,7779,7775,7743,55719
81320,161,173,190,220,271,294,388,1697
81321,14775,14242,14284,14155,14286,14106,14459,100307
81323,4724,5002,4959,5207,4896,5235,4409,34432
81324,1229,1233,1181,1180,1193,1417,1387,8820
81325,157,160,177,122,141,116,121,994
81326,2095,2116,2063,2239,2223,2152,2193,15081
81327,482,716,806,765,766,704,639,4878
81328,4441,4475,4092,3885,4020,3829,4069,28811
81330,96,55,50,8,8,0,26,243
81331,483,388,324,238,169,128,476,2206
81332,186,199,189,244,277,258,282,1635
81334,1246,1038,1242,1298,1270,1231,1493,8818
81335,35,111,94,97,125,261,131,854
81401,21900,22211,22235,22518,22488,22341,22437,156130
81403,10953,10889,11103,11459,11115,11065,10534,77118
81410,1400,1611,1577,1577,1474,1590,1655,10884
81411,14,10,14,6,18,25,55,142
81413,4698,4893,5016,5374,5243,5372,5243,35839
81415,1323,1334,1438,1288,1934,2172,1612,11101
81416,14358,14161,13787,13617,13593,13613,13874,97003
81418,1970,1739,1786,1801,1782,1648,1714,12440
81419,3976,3763,3789,3816,3757,3292,3883,26276
81422,644,696,588,520,531,627,692,4298
81423,1703,1567,1527,1660,1518,1417,1480,10872
81424,1088,1018,1143,1101,1072,1094,1239,7755
81425,5520,5555,5119,4967,5034,4963,5424,36582
81426,150,187,132,164,143,199,181,1156
81427,999,966,902,852,1025,943,1124,6811
81428,3417,3485,3883,3875,3810,3733,3701,25904
81429,74,94,88,103,106,79,181,725
81430,652,684,572,505,544,693,727,4377
81431,356,313,437,437,480,498,460,2981
81432,2964,2791,2825,2780,2610,2732,2682,19384
81433,510,568,616,618,732,777,659,4480
81434,169,166,143,155,228,300,158,1319
81435,5140,5111,5260,5101,5155,5020,4965,35752
81501,24837,24570,24610,24568,23616,23655,23465,169321
81503,15237,14707,14656,14507,14768,14567,15250,103692
81504,28478,28385,29628,29955,29783,28920,28481,203630
81505,9226,9178,8919,8874,9526,8845,9779,64347
81506,10961,10832,10907,10695,10443,11129,10961,75928
81507,14951,15997,15849,15466,14891,14593,15081,106828
81520,14101,14093,13392,14346,14828,14596,13447,98803
81521,15647,15534,14830,14700,14335,13911,15397,104354
81522,20,24,25,0,0,34,139,242
81523,1207,1261,1117,949,952,890,763,7139
81524,1985,1832,2066,2193,2328,2104,2300,14808
81525,1107,1179,1020,854,677,925,871,6633
81526,5373,5540,5445,5363,5296,5410,5321,37748
81527,1884,1715,1902,1918,2044,2059,2073,13595
81601,15729,16028,16368,16177,16166,15822,15442,111732
81610,376,374,444,461,455,516,446,3072
81611,10018,9822,9821,9869,9513,9439,9921,68403
81612,0,0,0,0,0,0,20,20
81615,2883,2865,2852,2823,2766,2695,2839,19723
81620,11405,11130,10767,10895,10644,10770,10450,76061
81621,5719,6262,6564,6606,7122,6736,5914,44923
81623,15465,15147,14530,15002,15353,15794,15235,106526
81624,1430,1365,1480,1446,1396,1525,1537,10179
81625,12353,12390,12425,12611,12651,12560,12921,87911
81630,847,798,742,801,829,871,979,5867
81631,8302,7949,8128,8079,7979,7851,8215,56503
81632,9244,9838,9493,9511,9520,8985,10276,66867
81633,0,0,0,0,0,0,19,19
81635,6561,6570,6409,6578,6527,6704,5957,45306
81637,8324,8222,8009,7707,7495,7294,7721,54772
81638,206,224,279,143,149,132,112,1245
81639,2163,2279,2289,2365,2467,2663,2463,16689
81640,92,129,138,217,238,313,249,1376
81641,3768,3671,3603,3584,3467,3545,3834,25472
81642,83,105,121,95,84,114,61,663
81643,736,685,789,715,783,752,793,5253
81645,1138,1164,1154,1046,966,1180,1121,7769
81646,236,219,209,152,132,107,184,1239
81647,7142,6946,6961,6802,6856,6715,7104,48526
81648,2856,2754,2677,2570,2510,2328,2808,18503
81649,249,279,268,272,264,236,277,1845
81650,13145,13244,13431,13476,13250,12450,13006,92002
81652,4886,4535,4377,4478,4403,4773,4904,32356
81653,26,49,45,36,67,65,31,319
81654,1580,1200,1101,939,908,1011,1391,8130
81655,86,81,94,102,99,0,65,527
81656,255,265,385,413,332,267,242,2159
81657,5697,5667,5737,5668,5679,5677,5581,39706
82001,36962,36974,36650,36161,35605,34790,35484,252626
82005,585,478,473,470,447,503,417,3373
82007,19988,20269,19927,19689,19502,19185,19096,137656
82009,33895,33199,32664,32018,31896,31766,31703,227141
82050,267,241,273,371,241,233,401,2027
82051,42,30,11,7,5,0,60,155
82052,10,10,9,0,0,12,23,64
82053,1572,1388,1729,1723,1619,1334,1524,10889
82054,1024,639,573,694,710,832,920,5392
82055,176,180,228,268,333,302,285,1772
82058,85,71,56,34,15,0,52,313
82059,160,121,119,69,0,19,135,623
82060,583,435,496,413,169,159,372,2627
82061,0,0,12,13,11,13,39,88
82063,157,114,21,76,59,83,100,610
82070,20589,21018,20894,21022,20339,20291,19766,143919
82072,16401,15787,15563,14886,14946,14379,15533,107495
82073,51,49,44,37,27,14,72,294
82081,67,52,0,0,0,35,60,214
82082,1390,1677,1545,1473,1542,1557,1606,10790
82083,288,309,341,380,362,307,373,2360
82084,0,0,0,0,0,0,16,16
82190,697,683,787,781,781,642,369,4740
82201,6659,6406,6329,6196,6464,6130,6467,44651
82210,452,431,328,601,523,554,399,3288
82212,378,362,318,256,384,449,474,2621
82213,559,631,685,635,542,636,513,4201
82214,1179,1289,1413,1356,1285,1497,1302,9321
82215,133,171,164,129,127,109,132,965
82217,17,130,141,157,154,159,107,865
82219,16,16,16,15,36,33,48,180
82221,710,665,686,584,541,361,635,4182
82222,103,169,155,216,191,187,107,1128
82223,1369,1264,1334,1283,1161,1132,996,8539
82224,22,12,15,22,23,0,23,117
82225,2118,2094,2070,1994,1985,2039,2067,14367
82227,181,187,161,176,187,164,241,1297
82229,9,174,189,170,183,281,74,1080
82240,10352,10355,10269,10174,9990,9743,10235,71118
82242,42,41,30,36,40,20,39,248
82243,116,106,47,98,114,150,187,818
82244,471,535,597,720,785,916,478,4502
82301,9291,9474,9462,9465,9556,9823,9584,66655
82321,678,725,717,790,695,677,717,4999
82322,158,111,142,140,116,105,106,878
82323,92,82,95,175,195,218,186,1043
82324,242,253,198,197,306,275,268,1739
82325,938,828,987,877,719,714,878,5941
82327,850,792,828,792,853,880,929,5924
82329,355,308,276,275,231,216,359,2020
82331,2526,2580,2566,2569,2573,2514,2286,17614
82332,220,158,66,50,43,46,97,680
82334,379,398,428,449,477,500,501,3132
82335,59,30,27,17,0,0,21,154
82336,399,360,371,475,400,334,498,2837
82401,7757,7797,7773,7774,7813,7706,7866,54486
82410,2212,1972,1742,1655,1632,1712,1760,12685
82411,534,557,512,521,519,535,664,3842
82412,605,641,718,743,698,716,626,4747
82414,15543,15455,15538,14826,14553,14383,15011,105309
82420,987,964,895,764,776,776,783,5945
82421,354,333,376,410,375,368,448,2664
82422,77,58,123,154,69,75,105,661
82423,159,204,221,205,235,239,233,1496
82426,2760,2852,3013,2969,2861,2763,2644,19862
82428,117,69,64,42,46,59,139,536
82430,109,59,120,100,106,140,100,734
82431,3404,3595,3516,3641,3737,3694,3552,25139
82432,316,267,201,166,197,186,315,1648
82433,1070,922,792,957,834,941,789,6305
82434,135,157,218,214,205,177,156,1262
82435,11949,11981,11675,11912,11935,11838,11738,83028
82440,154,206,127,146,210,165,145,1153
82441,224,216,252,240,266,213,250,1661
82442,681,687,735,742,652,725,732,4954
82443,4619,4714,4673,4710,4668,4614,4697,32695
82450,97,101,115,214,165,174,177,1043
82501,19527,19617,19789,19777,19424,19441,19408,136983
82510,538,521,465,441,482,478,423,3348
82512,128,136,126,197,208,177,210,1182
82513,1844,1815,1638,1805,1774,1566,1879,12321
82514,1711,1686,1706,1390,1403,1373,1645,10914
82515,468,434,474,449,401,420,446,3092
82516,448,474,468,414,449,411,496,3160
82520,14012,13941,13840,13778,13661,13315,13535,96082
82523,870,1048,1071,1026,1054,1042,868,6979
82601,28340,28117,27857,27486,27295,27105,27400,193600
82604,27410,26883,26465,26325,25785,25336,25882,184086
82609,18181,17754,17287,16772,16322,15764,15730,117810
82620,210,323,243,309,300,287,210,1882
82630,62,79,80,78,0,86,10,395
82633,10012,9914,9706,9513,9185,8987,9592,66909
82635,241,327,401,397,306,278,207,2157
82636,4178,4332,4112,3850,3779,3750,3981,27982
82637,4202,4009,4096,4251,4405,4286,4136,29385
82638,0,0,0,0,0,0,17,17
82639,762,779,907,798,804,941,805,5796
82640,48,16,31,35,18,23,29,200
82642,74,70,59,51,53,52,94,453
82643,605,527,606,619,606,473,469,3905
82644,1650,1676,1549,1478,1448,1435,1480,10716
82646,0,0,0,0,0,0,20,20
82648,0,0,13,19,13,12,56,113
82649,1063,1013,1103,1189,1194,1031,1120,7713
82701,5425,5338,5540,5433,5453,5646,5455,38290
82710,274,281,212,218,229,136,243,1593
82711,148,113,112,120,43,8,110,654
82712,456,396,381,401,306,195,264,2399
82714,163,146,220,188,184,139,95,1135
82715,0,0,0,0,0,0,0,0
82716,18147,18189,17916,18468,17722,17841,18747,127030
82718,25894,25335,24426,23189,23183,22464,23003,167494
82720,931,1019,1150,1285,1232,1065,955,7637
82721,2925,2952,2913,2697,2864,2991,3078,20420
82723,338,474,326,323,314,272,278,2325
82725,452,232,222,212,229,180,207,1734
82727,1493,1798,2331,2511,2287,1880,1838,14138
82729,2255,2149,2053,2093,2081,2321,2251,15203
82730,1527,1489,1409,1528,1515,1368,1566,10402
82731,36,40,65,74,94,143,135,587
82732,2451,2379,2440,2401,2270,2037,2154,16132
82801,25070,24933,24674,24412,24881,24443,24558,172971
82831,162,180,184,155,159,187,216,1243
82832,857,880,1101,940,658,525,618,5579
82833,0,76,105,95,179,182,225,862
82834,7519,7643,7467,7497,7487,7532,7585,52730
82835,291,273,268,324,347,274,318,2095
82836,1135,1004,925,1157,1019,1146,1073,7459
82837,50,35,34,19,11,16,29,194
82838,365,415,354,373,406,307,268,2488
82839,1271,1227,1323,1127,1057,1031,1153,8189
82842,1000,954,957,1121,719,793,843,6387
82844,13,12,59,65,62,55,35,301
82845,28,25,0,0,20,19,37,129
82901,29408,29302,29014,28785,28309,27872,27971,200661
82922,71,40,108,162,149,269,257,1056
82923,174,210,496,409,426,431,558,2704
82925,231,312,246,113,157,257,304,1620
82929,86,74,34,0,15,21,70,300
82930,14558,14442,14433,14795,14712,15035,14614,102589
82932,417,808,865,1032,1181,1010,836,6149
82933,469,595,628,684,671,790,759,4596
82934,315,288,384,239,136,215,185,1762
82935,13155,13208,13149,13204,13149,12991,13121,91977
82936,0,0,0,5,4,17,49,75
82937,3889,3874,3643,3364,3393,3219,3654,25036
82938,210,97,159,185,129,145,227,1152
82939,1795,1900,2127,1970,1862,1623,1861,13138
82941,4854,4724,4871,5392,5031,4833,5028,34733
82942,96,81,83,25,15,0,123,423
82943,155,140,146,84,149,191,301,1166
82944,298,260,299,325,300,129,216,1827
82945,413,303,248,268,224,217,351,2024
83001,16304,16625,16479,16031,16057,16346,15851,113693
83011,40,67,74,153,148,149,240,871
83012,181,186,18,99,69,64,180,797
83013,583,556,501,383,317,290,395,3025
83014,3917,3709,3934,4052,3927,3587,3595,26721
83025,538,161,121,128,147,285,400,1780
83101,3106,3126,3143,3017,2948,2958,3104,21402
83110,4558,4417,4616,4808,5466,5628,4307,33800
83111,470,395,490,527,474,383,519,3258
83112,391,172,277,437,446,399,666,2788
83113,2934,3065,2889,2918,3103,3127,3278,21314
83114,1037,1052,928,1023,999,1015,828,6882
83115,1642,1640,1453,1076,1103,779,830,8523
83116,548,552,575,615,631,722,728,4371
83118,1203,1582,1384,1343,1087,487,1139,8225
83119,108,108,154,51,54,100,172,747
83120,1059,1076,853,818,660,294,471,5231
83121,6,5,4,5,5,55,14,94
83122,709,565,571,469,389,323,494,3520
83123,478,548,662,607,641,686,711,4333
83124,139,108,102,75,80,80,137,721
83126,330,468,471,469,208,250,334,2530
83127,3378,2936,2785,2625,2658,3009,3041,20432
83128,1253,1341,1286,1380,1375,1257,1601,9493
83201,37210,37408,37465,37877,38477,38315,37199,263951
83202,23192,22452,22345,21979,21046,20472,21608,153094
83203,279,348,346,350,510,471,309,2613
83204,18071,18370,18509,18597,17888,17773,18026,127234
83209,1165,1105,913,835,781,732,1175,6706
83210,3175,3163,3175,3429,3331,3334,3449,23056
83211,5920,5971,6071,5680,5933,5969,6374,41918
83212,158,178,174,155,163,163,137,1128
83213,1493,1561,1595,1667,1659,1579,1644,11198
83214,594,508,531,548,520,510,671,3882
83215,17,21,22,26,32,28,26,172
83217,825,752,782,814,768,841,843,5625
83218,343,322,339,365,359,389,338,2455
83220,174,152,135,142,102,95,137,937
83221,26814,27319,27332,27130,26614,26615,27021,188845
83223,126,106,115,99,101,102,139,788
83226,2324,2428,2345,2522,2384,2452,2504,16959
83227,177,153,236,288,212,189,142,1397
83228,750,712,686,580,633,636,522,4519
83232,527,562,505,510,429,442,467,3442
83233,12,15,14,12,29,12,109,203
83234,1650,1609,1407,1265,976,1056,1213,9176
83235,37,36,30,38,184,207,99,631
83236,1997,1807,1880,2028,2187,2239,2275,14413
83237,971,1104,1337,1497,1363,1412,1146,8830
83238,107,133,95,118,106,107,109,775
83239,552,521,537,517,491,425,572,3615
83241,2003,2107,2042,1998,1847,1890,1980,13867
83243,98,152,92,121,130,187,80,860
83244,237,231,220,244,316,331,358,1937
83245,2004,2119,2225,2182,2312,2236,2257,15335
83246,784,811,953,881,881,811,1069,6190
83250,1344,1291,1196,1290,1679,1773,1637,10210
83251,1134,1123,1236,1080,1210,1090,1097,7970
83252,4171,4093,4149,4127,3959,3931,4154,28584
83253,81,154,112,126,186,149,165,973
83254,3664,3765,3807,3760,3846,3882,3617,26341
83255,1092,1057,1183,1138,1084,1191,1213,7958
83261,618,498,495,480,535,577,536,3739
83262,1308,1188,1130,1126,1143,1395,1386,8676
83263,9298,8940,8848,8482,8606,8492,9258,61924
83271,663,653,536,675,745,569,531,4372
83272,265,317,329,432,392,384,313,2432
83274,9506,9483,9471,9345,9611,9133,9246,65795
83276,3866,3921,3946,3864,4074,4140,4097,27908
83277,235,307,338,285,246,271,111,1793
83278,326,255,151,116,65,65,186,1164
83281,183,193,187,166,132,154,93,1108
83283,197,249,172,148,134,154,147,1201
83285,185,135,213,192,148,98,131,1102
83286,1270,1347,1305,1584,1574,1514,1241,9835
83287,220,259,273,302,301,264,299,1918
83301,54438,54289,53582,52396,52184,51552,52010,370451
83302,108,101,121,83,74,77,196,760
83311,647,491,424,445,469,440,562,3478
83312,178,164,212,159,166,177,168,1224
83313,3643,3875,3716,3609,3262,3230,3625,24960
83314,1072,881,967,934,1136,1077,898,6965
83316,9370,9460,9593,9917,9714,9886,9626,67566
83318,16992,17337,17404,16951,16720,16521,17226,119151
83320,830,826,942,869,1141,1157,1006,6771
83321,558,468,495,655,606,617,550,3949
83322,21,36,42,59,66,78,42,344
83323,1837,1941,1986,1970,2010,2029,1951,13724
83324,772,753,753,810,829,864,788,5569
83325,766,825,760,765,756,719,918,5509
83327,890,947,1031,1137,1109,1019,970,7103
83328,5691,5377,5136,5239,5040,4845,5347,36675
83330,6611,6409,6646,6422,6329,6286,6599,45302
83332,2745,2769,2836,2595,2528,2540,2361,18374
83333,10824,10730,11030,11062,10886,10889,10472,75893
83334,1920,1996,2034,2113,1871,1821,2060,13815
83335,1904,1920,2124,1918,1912,2034,1840,13652
83336,5279,4936,4921,4644,4818,4938,4951,34487
83337,26,24,26,27,26,20,33,182
83338,20086,19996,19805,19709,19614,19156,19782,138148
83340,4509,4252,4039,4231,4466,4394,4682,30573
83341,7859,7285,6973,6796,6623,6458,6491,48485
83342,1548,1603,1633,1657,1676,1528,1371,11016
83344,1243,1169,1060,994,961,868,1128,7423
83346,1913,1545,1553,1508,1660,1489,1442,11110
83347,3030,3163,3494,3528,3529,3037,3258,23039
83348,145,117,78,96,200,132,132,900
83349,1206,1252,1158,1091,1028,908,1062,7705
83350,12391,12431,11991,12338,11815,12259,12268,85493
83352,3320,3343,3369,3381,3499,3513,3330,23755
83353,1363,1346,1316,1280,1184,1326,1335,9150
83354,0,0,13,13,11,35,18,90
83355,4594,5106,4729,5379,5372,5410,5405,35995
83401,40635,41056,40134,40160,38361,37762,37966,276074
83402,24025,24997,25711,25335,26378,26001,26069,178516
83404,23396,22614,21993,21716,21957,21595,21606,154877
83406,17710,16181,16028,15828,15379,14962,15902,111990
83414,604,585,454,410,355,153,544,3105
83420,2457,2213,2442,2485,2630,2732,2539,17498
83421,178,327,318,333,561,698,319,2734
83422,3161,3296,3517,3782,3849,3851,3392,24848
83423,889,831,762,691,696,761,860,5490
83424,250,232,92,102,79,169,290,1214
83425,724,731,812,814,771,584,581,5017
83427,1896,1741,1628,1441,1187,1004,1372,10269
83428,399,342,324,307,301,272,416,2361
83429,783,863,903,908,788,703,1048,5996
83431,713,911,902,772,911,842,876,5927
83433,8,7,7,6,7,6,44,85
83434,1653,1608,1822,2020,1996,2060,1741,12900
83435,336,389,416,451,515,534,653,3294
83436,393,378,425,334,333,323,491,2677
83440,35912,36145,35732,35636,35179,34312,34610,247526
83442,20898,20088,19593,19258,18402,17887,19250,135376
83443,1057,1103,1138,1047,1142,1133,1107,7727
83444,1060,1287,1298,1311,1343,1452,1381,9132
83445,7020,6945,6669,6698,6817,6967,7406,48522
83446,31,31,32,33,46,53,48,274
83448,2734,2294,2490,2339,2403,2402,2451,17113
83449,214,219,190,211,194,261,249,1538
83450,1118,1083,1087,1043,1018,1050,1104,7503
83451,986,1019,954,885,603,678,791,5916
83452,1667,1699,1497,857,1128,1080,1484,9412
83454,500,524,537,528,513,533,531,3666
83455,5359,5058,5106,5400,4951,4686,4970,35530
83460,381,510,670,826,929,1045,860,5221
83462,774,625,580,498,393,379,464,3713
83463,98,113,132,81,72,85,130,711
83464,361,387,450,386,516,397,345,2842
83465,154,148,115,132,119,113,109,890
83466,219,249,242,308,284,348,273,1923
83467,5843,6011,6043,6161,6179,6342,6270,42849
83468,121,124,139,145,164,123,170,986
83469,52,25,39,43,33,16,32,240
83501,34827,34567,34406,34185,34022,34088,34230,240325
83520,158,124,119,150,181,222,194,1148
83522,2321,2321,2252,2522,2228,2324,2215,16183
83523,704,654,675,711,762,746,759,5011
83524,927,1007,1034,1064,1123,1084,989,7228
83525,408,386,425,483,680,480,376,3238
83526,355,343,347,358,354,327,278,2362
83530,5888,5698,5757,5557,5475,5087,5404,38866
83533,169,153,124,87,176,205,178,1092
83535,1098,1124,1184,1158,1188,1202,1089,8043
83536,4321,4240,4127,4017,3741,3766,4230,28442
83537,1152,1158,1078,1065,1140,1082,1044,7719
83539,2191,2155,2149,2112,2248,2422,2001,15278
83540,2473,2529,2379,2437,2205,2086,2190,16299
83541,984,841,951,973,990,984,1076,6799
83542,153,189,207,196,139,162,129,1175
83543,779,738,753,682,658,666,717,4993
83544,5891,5782,5856,5944,6002,6050,6092,41617
83545,444,502,540,543,541,483,484,3537
83546,655,743,708,788,716,704,587,4901
83547,207,178,178,218,180,231,219,1411
83548,140,134,130,148,163,232,117,1064
83549,671,734,777,844,731,782,908,5447
83552,812,1053,1033,1013,1309,1365,1225,7810
83553,1100,1203,1198,1021,1010,966,1100,7598
83554,383,523,582,518,574,498,638,3716
83555,514,485,472,504,472,476,564,3487
83601,35,28,42,47,19,22,41,234
83602,20,18,26,16,16,11,24,131
83604,731,701,774,809,859,897,762,5533
83605,43106,41748,40460,39427,38688,37826,39649,280904
83607,22997,23427,22687,23157,23277,23286,21732,160563
83610,841,861,896,921,909,989,946,6363
83611,2545,2883,2993,2794,2907,2888,2453,19463
83612,1962,2063,2121,1995,2103,2198,1925,14367
83615,1180,1013,1070,951,878,1103,1571,7766
83616,25689,24544,23848,23181,22342,21876,22780,164260
83617,15329,15466,15291,15295,15431,15718,15422,107952
83619,7586,7369,7339,7127,6950,7042,7201,50614
83622,1901,1694,1468,1360,1435,1392,1737,10987
83623,1307,1313,1582,1511,1542,1651,1517,10423
83624,1101,1084,1161,1479,1370,1431,1195,8821
83626,1725,1176,1278,1068,1016,929,1192,8384
83627,550,678,458,617,922,792,620,4637
83628,4203,4207,4447,4475,4272,4049,4329,29982
83629,1670,1594,1642,1800,1907,2158,1721,12492
83631,849,1055,1123,1210,1278,1228,1333,8076
83632,214,257,285,266,279,285,214,1800
83633,464,317,324,294,487,577,540,3003
83634,27244,27115,26243,25875,24040,22129,24494,177140
83636,0,0,72,71,163,107,153,566
83637,145,179,301,284,276,282,206,1673
83638,6205,5773,5517,5876,5965,5905,5903,41144
83639,3484,3294,3041,3036,3157,3269,3300,22581
83641,3409,3710,3818,3653,3727,3586,3438,25341
83642,40889,39647,38501,36685,35978,35854,37008,264562
83643,137,117,91,122,132,213,129,941
83644,10826,10232,10086,9921,9984,10035,9976,71060
83645,713,615,515,521,565,484,636,4049
83646,55934,54535,52071,50342,48067,46273,47098,354320
83647,20561,20572,20588,20487,20078,19690,20789,142765
83648,3094,3190,3133,3273,3245,3554,3238,22727
83650,541,574,585,552,626,603,552,4033
83651,32836,31434,30204,29059,28550,28642,28611,209336
83654,1531,1480,1476,1616,1486,1350,1672,10611
83655,4329,4402,4427,4483,4626,4098,4397,30762
83656,725,595,568,564,487,466,582,3987
83657,219,213,223,193,179,145,174,1346
83660,6611,6430,6323,6103,5793,5665,5890,42815
83661,9550,9369,9427,9357,9429,9833,9881,66846
83666,19,28,26,24,28,34,52,211
83669,9358,9169,8775,8492,7680,7487,7365,58326
83670,574,519,570,515,568,557,553,3856
83671,9,10,10,10,0,0,33,72
83672,8464,8543,8628,8643,8648,8680,8583,60189
83676,4353,4593,4366,4242,4413,4063,4347,30377
83677,73,100,115,115,102,29,44,578
83686,47177,46574,47239,47091,45749,44891,46224,324945
83687,30816,30902,30330,29367,29581,29481,29697,210174
83702,22751,22860,22769,23346,23288,23209,22293,160516
83703,16041,15901,15877,15709,16187,15788,16565,112068
83704,40273,40147,40526,39795,39232,39840,39628,279441
83705,27415,26723,26854,27539,27743,26865,26631,189770
83706,32067,31806,32265,31660,31289,30864,29732,219683
83709,54962,53354,52883,52110,52411,50515,50034,366269
83712,8337,7946,7857,8126,7904,7752,8148,56070
83713,30594,30183,28320,27024,26384,27013,28103,197621
83714,20886,20566,20288,20014,20524,19995,20290,142563
83716,16927,16657,15753,15826,15210,15464,14523,110360
83801,6310,5795,5852,6057,5546,5483,6150,41193
83802,158,264,217,211,205,138,68,1261
83803,838,646,588,509,507,629,744,4461
83804,1676,1459,1278,1180,1360,1215,1254,9422
83805,7951,7598,7721,8252,7718,7708,7437,54385
83806,205,212,258,207,218,278,220,1598
83808,162,151,140,163,182,166,147,1111
83809,317,493,389,349,270,320,401,2539
83810,1149,1088,1262,1486,1610,1506,1189,9290
83811,1249,1198,1292,1254,1308,1484,1411,9196
83812,57,68,87,103,138,140,66,659
83813,982,1079,852,840,856,1166,1158,6933
83814,26359,26136,25463,24600,23806,23461,23371,173196
83815,33035,32268,31689,31064,31089,30250,31015,220410
83821,245,293,354,346,403,305,210,2156
83822,1884,2397,2294,2513,2580,2364,2006,16038
83823,1281,1321,1282,1455,1499,1436,1318,9592
83824,323,374,397,290,369,383,348,2484
83825,358,387,421,341,288,267,190,2252
83826,0,0,0,0,34,32,45,111
83827,129,159,158,119,127,158,143,993
83830,877,894,1002,929,671,627,733,5733
83832,1449,1408,1487,1528,1479,1429,1524,10304
83833,1195,1037,1070,1006,1080,996,1164,7548
83834,270,280,285,278,224,165,254,1756
83835,20773,20666,20341,20052,19739,19642,19990,141203
83836,936,864,936,921,1204,867,1033,6761
83837,3060,3051,3168,3081,3135,3201,3063,21759
83839,1225,1122,1105,1060,1018,930,1417,7877
83840,276,265,196,192,221,230,227,1607
83841,247,244,177,171,105,38,338,1320
83842,225,198,155,200,207,193,148,1326
83843,26485,26222,26071,25562,25865,25556,25866,181627
83844,1898,1903,1556,1520,1175,1117,1353,10522
83845,1545,1616,1777,1588,1751,1884,1742,11903
83846,742,774,668,652,750,810,770,5166
83847,1645,1747,1405,1026,1354,1221,1719,10117
83848,266,212,217,202,124,94,137,1252
83849,2036,1866,1763,1780,1807,1780,1925,12957
83850,2225,2153,2098,2119,1882,2031,2129,14637
83851,1713,1697,1578,1440,1499,1522,1691,11140
83852,839,801,896,983,1046,1122,884,6571
83854,39239,38496,38180,38032,37545,37671,37245,266408
83855,2065,2049,2168,2223,2281,2262,2111,15159
83856,6214,6284,6259,5846,5986,6236,6340,43165
83857,815,797,743,599,552,546,691,4743
83858,14148,13973,13918,14001,14019,13671,13656,97386
83860,5592,5464,5322,5448,5339,5851,6119,39135
83861,6278,6205,6381,6765,6846,6813,6360,45648
83864,18065,17722,17798,17942,17560,17197,17076,123360
83866,95,131,80,70,106,120,320,922
83867,597,669,653,567,705,658,616,4465
83868,860,878,802,835,850,729,769,5723
83869,4626,4399,4365,3960,4104,3965,4161,29580
83870,305,340,315,260,266,299,312,2097
83871,2145,2014,2104,2001,1964,2005,1938,14171
83872,583,620,578,776,649,701,705,4612
83873,1306,1402,1738,1899,1905,2021,1591,11862
83874,23,88,89,93,76,58,64,491
83876,1639,1780,1613,1627,1614,1511,1442,11226
84001,835,1119,1218,1143,1074,864,725,6978
84002,376,247,182,254,282,183,302,1826
84003,46205,45184,44669,43441,42318,41249,42384,305450
84004,10248,10146,10023,10097,9850,9555,9818,69737
84005,26001,24933,23428,22358,21106,19498,21410,158734
84006,483,648,551,702,928,934,826,5072
84007,663,499,590,582,510,425,740,4009
84010,45775,45782,45689,45381,45310,45190,44821,317948
84013,938,1003,992,817,765,767,1011,6293
84014,16727,16387,16130,15853,15624,15329,15268,111318
84015,64363,63699,63074,62387,61642,61022,62494,438681
84017,4233,4164,4185,3899,3621,3837,3556,27495
84018,86,96,39,60,96,130,179,686
84020,45632,44297,43694,42751,41538,39984,39765,297661
84021,3919,4082,3809,3780,3600,3593,3323,26106
84022,548,681,941,1046,1206,1553,896,6871
84023,222,245,193,225,243,311,266,1705
84024,107,99,108,57,101,98,63,633
84025,21997,21277,20447,19607,18748,17759,18255,138090
84026,1510,1491,1553,1423,1302,1315,1668,10262
84027,457,458,539,475,642,666,452,3689
84028,748,844,734,604,587,478,824,4819
84029,9931,9696,9660,9470,9399,9084,9473,66713
84031,287,275,301,259,220,201,259,1802
84032,20854,20140,19224,18404,17620,17079,17249,130570
84033,1237,1021,1059,948,953,960,1032,7210
84034,157,167,154,200,282,288,209,1457
84035,314,598,649,520,662,645,748,4136
84036,6166,6053,6171,5966,6099,5986,6045,42486
84037,36378,35500,34740,33965,33462,32713,33369,240127
84038,246,277,282,389,395,396,347,2332
84039,935,960,861,985,849,946,1102,6638
84040,23515,23372,24204,23524,23606,22865,23026,164112
84041,48962,47664,45635,45489,44210,44044,44625,320629
84042,10677,10542,10434,10282,10093,9937,10094,72059
84043,58121,55710,53583,51511,48555,45912,49030,362422
84044,27671,27559,28301,27877,27697,27159,26524,192788
84045,22983,21604,20067,18421,17043,15453,16875,132446
84046,519,521,511,597,647,574,793,4162
84047,32993,32277,31376,30942,29574,29205,28936,215303
84049,4891,4526,4537,4552,4500,4261,4372,31639
84050,10559,10180,9916,9632,9389,9155,9290,68121
84051,468,392,440,485,518,439,402,3144
84052,1454,1375,1303,1246,1099,1295,1403,9175
84053,1003,1024,1016,1033,905,771,1115,6867
84054,18732,17960,17299,16169,15800,15417,16196,117573
84055,1226,1317,1340,1276,1298,1293,1406,9156
84056,3354,3350,3373,3549,3646,3637,3310,24219
84057,39733,38041,37964,37726,37616,37138,36666,264884
84058,33691,33721,31927,31633,30625,31048,30540,223185
84060,8116,8006,7945,7824,7743,7633,7596,54863
84061,390,418,392,492,570,571,391,3224
84062,46746,45822,44704,43615,42771,41534,43269,308461
84063,302,374,454,376,365,357,334,2562
84064,889,779,865,921,873,1011,692,6030
84065,41143,41744,40135,38369,36991,36053,38168,272603
84066,12236,11778,11431,11221,10766,10513,11283,79228
84067,38419,38122,38161,37821,37343,36762,37444,264072
84069,442,564,573,540,559,505,505,3688
84070,26288,25864,26188,25137,24296,24614,24861,177248
84071,1229,1360,1390,1445,1153,928,1175,8680
84072,403,439,434,529,527,536,372,3240
84073,220,201,197,161,168,146,191,1284
84074,48018,46939,45808,45118,44246,43376,44310,317815
84075,26816,26099,25543,24803,24104,23018,24506,174889
84076,618,564,531,464,316,251,390,3134
84078,29981,29313,28003,27369,27133,26430,25851,194080
84080,334,270,253,233,227,262,304,1883
84081,46638,45744,44909,43978,41480,39303,40732,302784
84082,1001,909,781,817,742,892,743,5885
84083,1513,1361,1320,1226,1242,1219,1516,9397
84084,37483,36662,36081,36006,36832,36732,37247,257043
84085,395,340,436,487,369,311,531,2869
84086,401,392,404,365,409,349,401,2721
84087,15413,15095,14299,14249,13707,13449,13983,100195
84088,37397,37845,37394,36360,35188,34862,35603,254649
84092,30032,29853,29909,29693,29848,30010,29525,208870
84093,23788,23288,23501,23237,23534,23144,23130,163622
84094,28246,28052,27267,27670,27650,27085,28069,194039
84095,63317,60489,57236,53995,51364,48374,50566,385341
84096,40328,36451,35428,34527,32998,30738,33396,243866
84097,21478,20923,21059,20591,20823,20136,21322,146332
84098,18552,18301,17449,17367,16933,16126,17282,122010
84101,4236,4851,5087,5124,4705,4731,5277,34011
84102,18150,18047,17424,16760,17212,16462,17421,121476
84103,22017,21869,21466,21311,21742,22058,21084,151547
84104,25750,24978,24883,24889,25163,24211,24869,174743
84105,21952,22034,22940,22899,22672,22612,22140,157249
84106,35162,35279,35485,34432,33006,33423,33384,240171
84107,33411,33836,32707,31350,31472,31118,30863,224757
84108,21650,20779,20329,21502,21623,22005,20738,148626
84109,24428,24185,24442,24259,24131,24040,23858,169343
84111,10855,10909,10719,10846,10950,11056,10744,76079
84112,1476,2252,2226,1997,1656,1610,1942,13159
84113,126,115,119,102,72,53,245,832
84115,26888,26309,25034,24695,24785,24276,24668,176655
84116,35744,35446,34577,33574,31980,31589,33297,236207
84117,25445,25147,24867,24355,24754,24155,24305,173028
84118,70472,69024,67153,67019,66107,65637,68295,473707
84119,55030,54519,54917,54882,53633,53098,53077,379156
84120,51381,50686,49282,49107,47858,47306,48956,344576
84121,40635,41604,41494,41646,41120,41817,41702,290018
84123,39278,38684,38756,38437,38764,38961,37900,270780
84124,22285,21672,21401,21454,21695,21164,21295,150966
84128,26600,27808,28515,28475,29143,28777,27983,197301
84144,190,150,107,66,24,0,0,537
84180,0,0,0,0,0,0,0,0
84301,862,861,876,874,869,869,883,6094
84302,24760,24253,24236,24205,23966,23701,23703,168824
84304,0,0,0,0,20,31,40,91
84305,781,715,813,781,732,745,751,5318
84306,311,351,325,246,241,198,318,1990
84307,1324,1413,1377,1259,1327,1379,1375,9454
84308,297,382,368,395,406,430,325,2603
84309,483,455,476,449,424,529,535,3351
84310,4241,4352,4876,4676,4752,4300,4111,31308
84311,820,784,855,824,800,749,714,5546
84312,3689,3746,3547,3823,4059,3960,4028,26852
84313,86,57,32,185,252,235,68,915
84314,917,1016,955,825,784,929,1031,6457
84315,8409,8319,8256,8019,7926,7669,7581,56179
84316,251,237,227,213,173,208,254,1563
84317,2251,2380,2091,2101,1911,1831,2304,14869
84318,4337,4224,4113,4001,3885,3743,3918,28221
84319,8052,8068,7955,7877,7723,7504,7905,55084
84320,2608,2474,2371,2258,2134,2243,2237,16325
84321,46052,45611,45253,44637,44361,43364,44074,313352
84324,635,674,719,748,685,721,701,4883
84325,2179,2033,2154,2038,1920,1775,2078,14177
84326,1906,1870,1669,1707,1474,1267,1763,11656
84327,928,994,1023,921,875,954,951,6646
84328,1701,1670,1693,1691,1662,1759,1666,11842
84329,87,99,95,180,194,223,202,1080
84330,431,410,401,443,315,341,502,2843
84331,375,342,300,308,283,227,272,2107
84332,7348,7384,7387,7364,7227,7008,7218,50936
84333,2939,2867,2872,2855,2749,2646,2722,19650
84334,432,470,435,284,175,95,230,2121
84335,12344,12166,11950,11713,11259,10844,11372,81648
84336,302,309,351,321,209,242,281,2015
84337,12041,11647,11618,11290,11248,10798,11393,80035
84338,371,399,449,506,514,554,481,3274
84339,4902,4853,4789,4700,5164,5321,5046,34775
84340,3611,3770,3614,3593,3565,3592,3369,25114
84341,22079,21739,21095,20737,19990,19564,20109,145313
84401,36766,36021,35536,35836,35179,34848,35622,249808
84403,37687,37843,37692,37158,37487,36931,36582,261380
84404,60045,59051,57520,56743,55837,55076,56363,400635
84405,31762,31472,31541,31452,31232,30910,31348,219717
84414,29008,28311,27847,26975,26078,25553,26507,190279
84501,13333,13323,13469,13456,13518,13353,13612,94064
84511,4708,4831,4680,4722,4476,4256,4672,32345
84512,908,933,1075,1116,1089,1120,1093,7334
84513,1751,1758,1922,1853,1896,1723,1710,12613
84515,0,0,0,0,0,0,15,15
84516,175,171,175,168,157,219,227,1292
84518,841,836,871,777,612,616,702,5255
84520,1129,1107,1133,1272,1359,1407,1302,8709
84521,776,709,758,697,669,840,840,5289
84522,316,342,339,393,389,362,321,2462
84523,1511,1672,1607,1780,1883,1768,1797,12018
84525,1219,1244,1291,1314,1247,1295,1183,8793
84526,3923,4241,3979,4091,3806,3598,4134,27772
84528,2415,2377,2347,2575,2834,2777,2742,18067
84529,240,123,90,87,89,82,180,891
84530,406,448,484,358,313,213,460,2682
84531,992,983,920,648,644,522,642,5351
84532,9681,9604,9587,9525,9436,9500,9772,67105
84533,187,192,157,259,133,247,267,1442
84534,2378,2170,2123,2301,2444,2347,2654,16417
84535,3226,2835,2669,2822,2746,3049,2601,19948
84536,2065,2112,1998,1856,2026,1880,1454,13391
84537,1566,1619,1541,1367,1301,1356,1505,10255
84539,383,373,467,511,523,564,379,3200
84540,93,85,90,105,127,11,46,557
84542,1760,1802,2022,1907,1958,2006,1806,13261
84601,34481,34910,34707,33667,33064,31471,31486,233786
84604,46735,46832,46912,47491,47558,47536,49145,332209
84606,34953,34086,33724,33499,32910,33402,32291,234865
84620,970,1069,1128,1130,1120,1138,1151,7706
84621,200,235,237,253,233,150,240,1548
84622,1606,1527,1472,1495,1450,1444,1517,10511
84623,535,362,434,446,230,117,405,2529
84624,5573,5628,5568,5600,5594,5685,5668,39316
84626,263,279,372,296,226,222,410,2068
84627,6978,6808,6425,6458,6376,6386,6310,45741
84628,744,737,674,655,691,582,721,4804
84629,2658,3050,3317,3125,3333,3405,2531,21419
84630,509,473,272,326,375,373,294,2622
84631,3264,3310,3285,3176,3122,3044,3067,22268
84632,999,989,1149,1000,1021,1032,1148,7338
84633,1077,1049,1160,1021,1127,1099,1048,7581
84634,3295,3256,3386,3409,3405,3406,3395,23552
84635,748,703,660,725,872,891,863,5462
84636,416,414,418,404,442,342,474,2910
84637,688,570,564,542,591,636,729,4320
84638,308,327,281,300,224,187,294,1921
84639,738,864,906,989,1112,1158,963,6730
84640,144,154,186,193,176,145,121,1119
84642,3375,3389,3450,3435,3459,3298,3548,23954
84643,400,416,391,508,555,444,605,3319
84645,3139,2908,2933,2827,2596,2371,2620,19394
84646,1913,1949,1817,1669,1625,1467,1657,12097
84647,4260,4199,4309,3966,3729,3708,4019,28190
84648,5731,5768,5733,5724,5727,5775,5776,40234
84649,1075,983,918,878,770,750,760,6134
84651,24669,24276,23954,23840,23463,22790,23457,166449
84652,708,789,826,838,807,857,872,5697
84653,8498,8315,7973,8050,8058,7767,7947,56608
84654,2657,2601,2387,2633,2663,2708,2689,18338
84655,11555,11531,10949,10745,10477,10212,10547,76016
84656,352,408,433,380,303,304,345,2525
84657,669,642,615,614,556,499,505,4100
84660,41163,40257,39533,38532,37454,36155,37995,271089
84662,1134,1022,1015,1238,1282,1451,1371,8513
84663,32459,31708,31195,30811,30139,29326,29975,215613
84664,9014,8788,8545,8296,8148,8036,8033,58860
84665,439,414,403,456,478,466,528,3184
84667,346,344,366,432,393,428,405,2714
84701,8859,8838,8650,8519,8593,8607,8692,60758
84710,158,128,115,174,179,188,131,1073
84711,763,699,688,695,539,538,735,4657
84712,210,213,235,235,235,162,201,1491
84713,3535,3576,3618,3708,3712,3771,3792,25712
84714,374,532,635,829,1045,946,835,5196
84715,435,444,450,472,481,474,459,3215
84716,220,170,180,209,215,210,297,1501
84718,246,210,222,199,195,155,189,1416
84719,86,60,50,38,27,51,90,402
84720,20931,20210,20001,19719,19726,20370,19705,140662
84721,21597,21782,21551,21556,20796,19516,20961,147759
84722,764,742,650,615,749,554,615,4689
84723,937,870,1016,956,849,812,687,6127
84724,1096,1089,1259,1234,1251,1296,1214,8439
84725,1760,1779,1845,1711,1436,1663,1964,12158
84726,744,801,834,786,799,915,961,5840
84728,36,71,236,264,260,257,158,1282
84729,215,284,335,305,396,434,396,2365
84730,239,195,210,271,252,242,268,1677
84731,227,216,11,27,122,184,194,981
84732,31,27,16,7,16,13,77,187
84733,173,233,163,182,221,195,202,1369
84734,131,151,139,155,194,174,261,1205
84735,249,254,267,227,204,189,258,1648
84736,196,252,206,280,268,243,246,1691
84737,16513,16143,15713,15062,14726,14375,14838,107370
84738,7868,7642,7433,7057,6899,6808,6878,50585
84739,500,549,591,488,490,546,507,3671
84740,189,262,253,246,248,207,191,1596
84741,5858,5732,5731,5812,5545,5409,5556,39643
84742,247,211,207,216,185,247,260,1573
84743,10,35,53,50,53,39,34,274
84744,330,375,338,294,246,231,411,2225
84745,4212,4180,4144,4134,4097,4102,4066,28935
84746,1324,1305,1351,1504,1493,1291,1149,9417
84747,1044,989,1129,1093,1126,1232,1097,7710
84749,373,378,276,280,283,247,218,2055
84750,554,518,455,405,445,511,469,3357
84751,1815,1797,1955,1883,1822,1682,1680,12634
84752,860,886,963,992,953,943,994,6591
84753,25,37,28,53,35,26,26,230
84754,3954,3921,4001,3845,4024,3824,3652,27221
84755,60,75,77,92,109,91,112,616
84756,339,337,378,286,311,238,366,2255
84757,1077,832,743,888,1075,998,1167,6780
84758,724,719,638,549,522,535,533,4220
84759,2168,2187,2292,2319,2293,2213,2112,15584
84760,668,605,589,567,679,850,559,4517
84761,3124,3064,3040,2995,2951,2908,3131,21213
84762,188,246,301,174,245,198,248,1600
84763,356,395,398,292,299,290,245,2275
84764,231,182,158,163,149,178,331,1392
84765,6680,6538,6383,6283,6606,6390,6143,45023
84766,237,186,177,272,227,190,147,1436
84767,565,585,631,670,660,746,679,4536
84770,41847,40799,39996,40547,40945,39780,39131,283045
84772,168,142,218,103,136,133,171,1071
84773,306,248,126,116,124,64,321,1305
84774,1913,1841,1908,1754,1730,1717,1399,12262
84775,427,512,622,644,548,544,431,3728
84776,665,700,626,582,754,701,538,4566
84779,477,503,483,429,422,488,641,3443
84780,22762,21735,20843,20121,19356,18224,18756,141797
84781,118,150,139,101,147,153,188,996
84782,843,769,753,949,1006,869,794,5983
84783,504,484,491,568,587,822,805,4261
84784,2926,2926,2894,2839,2801,2719,2745,19850
84790,39469,38822,37911,36269,34251,34843,35770,257335
85003,9079,9479,9262,9197,9373,9384,9369,65143
85004,5209,4610,4649,4533,4391,4173,4965,32530
85006,27804,26440,26473,25097,25083,23931,25742,180570
85007,14461,14445,14114,13737,13934,13697,14040,98428
85008,59490,57086,55820,52966,50193,51462,56145,383162
85009,46006,46782,47667,49710,49581,49836,52520,342102
85012,6558,6279,6446,6374,6805,6968,6390,45820
85013,21371,20228,20479,20996,20136,21303,19314,143827
85014,27316,25553,24979,24669,23984,24296,24782,175579
85015,38829,39441,39719,40452,40644,39657,37644,276386
85016,35660,34901,33432,33646,31605,32392,33896,235532
85017,41468,40048,40333,41317,41937,43399,38872,287374
85018,38587,37978,37454,37461,37734,37552,36065,262831
85019,24426,24978,25866,25032,25850,27023,25042,178217
85020,33478,32670,32675,32540,33255,34254,32850,231722
85021,40422,38994,37018,38182,38677,37274,37743,268310
85022,50369,49112,48071,47433,46427,43830,46395,331637
85023,33328,31995,31486,31177,32219,32008,31274,223487
85024,24553,24077,23699,23687,23058,22380,22898,164352
85027,35225,35834,36244,36854,36929,38601,37140,256827
85028,19608,19000,18541,19276,18939,19443,19157,133964
85029,45513,44964,44241,42567,44117,45643,43233,310278
85031,31005,28338,27980,29755,28880,27484,30493,203935
85032,71957,72222,71347,70008,70382,71154,65485,492555
85033,64428,61118,58799,56009,55440,53566,53037,402397
85034,4322,4171,4586,4187,4826,5021,5582,32695
85035,57470,55354,54668,51329,50189,47668,47486,364164
85037,49702,48348,47465,46208,46422,45779,44771,328695
85040,32420,31850,30312,28718,29244,28075,29352,209971
85041,62683,59188,58191,57329,55037,54433,54947,401808
85042,43820,41917,41677,40615,39618,40612,40962,289221
85043,36177,35301,31724,28553,29522,30175,30560,222012
85044,39574,38608,38538,38954,38664,39349,37993,271680
85045,7465,7381,7420,7902,8089,8214,7238,53709
85048,35621,34462,34698,35362,34791,34718,33449,243101
85050,30715,30083,29490,27793,26833,24795,25736,195445
85051,42223,42752,43022,42860,42565,43587,40375,297384
85053,28404,27982,28366,28716,28567,28949,28480,199464
85054,6390,6049,5884,5867,5312,4987,5384,39873
85083,19443,19195,18663,18376,18176,17091,18104,129048
85085,20689,19529,18560,18501,15916,14840,17517,125552
85086,41533,41102,42749,41194,39954,38737,40495,285764
85087,8351,7900,7551,7131,6463,5884,7708,50988
85118,11572,11857,12005,11924,12478,13281,12246,85363
85119,21271,20672,20911,22081,21892,21760,21219,149806
85120,29767,28599,28038,26146,26488,26376,28168,193582
85121,2153,2873,3043,3249,3064,2714,2178,19274
85122,54941,52817,53558,52136,51310,50205,50942,365909
85123,10560,9105,9581,8310,8004,6459,10677,62696
85128,15982,15867,15965,15744,15252,15451,14823,109084
85131,18221,17877,18347,18430,18562,17975,18017,127429
85132,35906,36013,35681,34981,34579,31985,33556,242701
85135,502,585,591,646,773,919,630,4646
85137,2603,2656,2751,2644,2533,2509,2329,18025
85138,35198,35003,35265,33637,31722,28499,33633,232957
85139,18450,18669,18074,17768,16772,17635,17979,125347
85140,43283,40505,39508,37063,32540,27570,36711,257180
85141,342,323,385,371,376,429,515,2741
85142,55931,54373,53488,51190,49644,45828,48870,359324
85143,36414,38393,37873,36917,35655,34754,35015,255021
85145,2679,2144,1945,1658,1455,1279,2106,13266
85147,4372,4439,4834,4824,5213,5343,4543,33568
85172,1471,1381,1248,774,796,833,1368,7871
85173,2940,2856,2913,2867,2890,2841,2872,20179
85192,1339,1394,1331,1269,1674,2086,2120,11213
85193,4412,3735,4007,3972,4352,4292,4906,29676
85194,7232,7146,6523,6448,6432,5469,6721,45971
85201,50323,50232,47815,47737,46312,46809,46092,335320
85202,39095,36909,36024,36672,36605,35560,37275,258140
85203,36889,35568,33935,33514,32979,33412,35541,241838
85204,64583,64665,62767,60819,60566,60092,60885,434377
85205,41376,41270,41891,43251,42426,42742,39858,292814
85206,35415,33885,32887,32602,32701,32901,33154,233545
85207,47214,46821,47142,46201,45911,45203,44744,323236
85208,37360,35852,36742,36389,35388,35652,34762,252145
85209,41738,41181,41525,40423,39927,39481,37377,281652
85210,38707,38151,38908,37143,37591,38058,36464,265022
85212,28700,25829,24685,24433,24373,23072,24492,175584
85213,35241,33789,33621,33659,33594,33302,31797,235003
85215,15969,15524,15594,15433,15524,15964,15963,109971
85224,43827,45291,44606,45361,44416,44105,42796,310402
85225,70168,73155,72300,71828,70715,69121,69810,497097
85226,36707,38484,38543,37394,37559,37733,37376,263796
85233,35828,37463,38015,39027,39117,38563,37564,265577
85234,50101,52774,51823,51459,51208,49934,50014,357313
85248,31990,31941,30253,30773,29985,29128,29821,213891
85249,38958,40432,39598,39081,37030,36315,36908,268322
85250,17445,16950,16850,16653,16276,16549,15906,116629
85251,39867,38968,37550,35541,34643,33592,34390,254551
85253,17461,17115,17166,17003,16995,17330,17047,120117
85254,46915,46089,45230,45554,47559,47554,45801,324702
85255,40151,39105,38082,38309,37663,36803,37270,267383
85256,4638,4656,4932,5241,5393,5672,4974,35506
85257,31426,30040,28684,28114,28843,28670,26755,202532
85258,23933,22654,22471,22744,22248,22688,23342,160080
85259,22479,22417,22265,22499,21855,21851,21422,154788
85260,37596,36552,36755,36226,36464,37640,36056,257289
85262,10575,10385,10990,11034,10567,9851,11275,74677
85263,2313,2458,2324,2090,2057,2298,2111,15651
85264,1310,1106,1123,1190,1184,1220,1249,8382
85266,11715,11112,10646,10717,11129,11246,11406,77971
85268,24139,23570,23214,22927,22805,22680,22684,162019
85281,61382,59492,57507,55548,56005,55292,57348,402574
85282,51847,51538,51930,51080,51665,52470,48671,359201
85283,49123,47087,46117,46373,44975,44501,44813,322989
85284,18436,17655,17315,17517,17229,17310,16479,121941
85286,40933,41935,39678,36774,38664,36857,38930,273771
85295,42290,42782,39947,37949,35237,33651,38332,270188
85296,41556,42244,41553,40694,39680,38498,36799,281024
85297,31683,31061,29228,27180,26357,23646,26979,196134
85298,29153,28219,25494,22106,20856,20788,21479,168095
85301,66818,64604,63060,61387,60607,61177,60161,437814
85302,39430,37356,38334,37149,37146,37059,36909,263383
85303,30801,30571,30754,31599,31685,31214,30310,216934
85304,27520,26600,26479,27426,26935,27242,25883,188085
85305,11771,11482,11545,11542,12218,11913,10822,81293
85306,24697,24735,24385,24351,24406,24587,24191,171352
85307,8295,7850,7556,8560,8430,9774,9230,59695
85308,65922,65154,63662,64515,64923,65114,63876,453166
85309,743,789,806,799,807,673,1485,6102
85310,18969,19207,19260,19074,20120,20468,19007,136105
85320,1497,1391,1157,916,847,773,1197,7778
85321,4873,5069,4854,4727,4543,4110,4435,32611
85322,753,723,612,731,755,952,752,5278
85323,40729,40306,39385,39263,38374,38254,39507,275818
85324,2689,2333,2550,1948,2158,2575,2886,17139
85325,927,928,802,797,939,1143,1212,6748
85326,56102,55996,53868,52101,50845,49355,51705,369972
85328,449,393,285,291,265,280,259,2222
85331,28710,27898,27396,27327,25922,25705,26960,189918
85332,1334,1363,1313,1428,1545,1766,2146,10895
85333,588,471,497,437,584,477,790,3844
85334,969,1015,1051,871,832,692,1482,6912
85335,33937,33010,32600,31814,30959,29616,31787,223723
85336,558,579,714,560,537,502,700,4150
85337,2790,2626,2948,2662,2584,2345,2793,18748
85338,46098,46600,46583,44319,43669,41157,41115,309541
85339,43651,42223,39137,37621,35236,33419,35586,266873
85340,30756,28890,28747,28696,28565,28149,26262,200065
85341,33,34,28,29,23,0,39,186
85342,1319,1269,1351,1534,1510,1456,1578,10017
85343,175,205,90,93,87,100,196,946
85344,10015,9981,9709,9791,10319,10873,9147,69835
85345,57867,59693,58852,58170,57929,55842,56208,404561
85346,4197,4142,4298,4353,4290,4049,4423,29752
85347,910,846,815,851,573,565,716,5276
85348,2790,2875,2924,3089,2459,2134,2786,19057
85349,29377,29377,28340,27086,23788,23065,25517,186550
85350,22173,22726,22877,22592,21902,20820,21214,154304
85351,29216,29094,28771,28501,28281,28656,27789,200308
85352,377,338,268,234,185,224,461,2087
85353,37983,35574,33920,32308,31613,30306,31011,232715
85354,7053,6198,5772,5649,5292,4755,6645,41364
85355,11380,10186,9649,9566,9336,8779,8745,67641
85356,5138,5114,4832,4698,4582,3938,4539,32841
85357,517,492,716,683,732,698,761,4599
85360,250,211,209,221,225,232,222,1570
85361,6593,5784,5984,5091,5442,5611,6700,41205
85362,585,553,562,649,611,595,663,4218
85363,6563,6405,6418,6312,6081,5922,6156,43857
85364,74767,73631,72980,73129,74083,73969,74904,517463
85365,48529,49050,49624,47933,48079,48693,46558,338466
85367,20995,20931,20559,21537,22150,21751,20429,148352
85371,440,509,563,533,624,652,419,3740
85373,19089,18926,18770,17979,17583,17228,17356,126931
85374,46045,46394,46507,47274,45284,45173,47146,323823
85375,27701,27502,27545,28255,28645,28689,27703,196040
85377,3160,2978,3048,3029,2901,2823,3051,20990
85379,45742,43550,42544,41096,40239,38297,39732,291200
85381,25767,27154,26100,25611,25225,24556,24249,178662
85382,39689,41584,40792,40656,39254,39945,40454,282374
85383,42126,40928,39552,38400,37693,36252,37182,272133
85387,10663,11139,10665,10080,10181,8895,9573,71196
85388,27580,25266,24065,22367,21857,20288,23490,164913
85390,8665,8702,8959,9213,8977,8617,8621,61754
85392,38097,37303,37172,36187,35560,34022,35310,253651
85395,27421,27465,25000,24587,22568,21434,25922,174397
85396,15839,14832,13506,12736,10595,9545,12163,89216
85501,13342,13685,13366,13344,13551,13370,13345,94003
85530,1988,1989,1734,1688,1663,1559,2069,12690
85531,345,406,422,389,394,379,623,2958
85533,2928,2959,2952,2792,2734,2587,2943,19895
85534,2785,2717,2774,2635,2429,2483,2588,18411
85535,0,0,0,7,11,7,21,46
85536,592,481,517,501,258,181,408,2938
85539,5132,5233,5367,5500,5179,5053,4520,35984
85540,3464,3280,3028,3215,3396,3373,2874,22630
85541,21576,21491,21784,21559,21860,21561,21877,151708
85542,3360,3619,3695,3740,3504,3524,3196,24638
85543,3829,3660,3476,3951,4443,3857,3822,27038
85544,1815,1608,1604,1989,2208,2492,2949,14665
85545,461,456,577,658,706,687,583,4128
85546,20422,20397,20027,19437,19157,18964,19677,138081
85550,5199,4904,4990,5297,5217,5851,4790,36248
85551,285,260,445,437,500,631,405,2963
85552,6503,6507,6278,6200,6179,6536,6218,44421
85553,1564,1481,1550,1441,1120,931,1501,9588
85554,516,519,426,289,279,284,778,3091
85601,607,587,635,618,615,817,698,4577
85602,9052,8898,8912,9291,9304,9595,9464,64516
85603,6829,6872,6946,6959,7450,7615,7155,49826
85605,404,458,463,469,467,547,597,3405
85606,1263,1177,1328,1426,1490,1552,1184,9420
85607,13991,13492,17229,17866,19128,18887,18925,119518
85608,6880,7321,5119,4717,3228,2881,2305,32451
85609,286,266,384,319,321,259,392,2227
85610,1001,1046,1063,1072,1368,1483,1333,8366
85611,760,1034,1030,963,911,879,965,6542
85613,5987,5859,5743,5789,5319,4732,5601,39030
85614,23140,22046,22245,21998,22152,21293,21895,154769
85615,9576,10024,9481,9152,9250,9596,9413,66492
85616,5375,5494,5403,5584,5346,5219,5566,37987
85617,1215,1415,1354,1369,1292,1280,1277,9202
85618,1900,1833,1853,1642,1453,1241,1725,11647
85619,167,151,141,60,32,160,50,761
85620,707,860,884,1067,928,785,897,6128
85621,22548,22965,22971,22928,23074,22996,23054,160536
85622,6367,6704,6659,6752,6441,6393,6325,45641
85623,4856,4641,4843,4961,4328,3971,4073,31673
85624,1399,1250,1306,1269,1100,972,1426,8722
85625,1864,1819,1602,1800,1993,2044,1983,13105
85626,954,1017,867,1036,594,640,1021,6129
85627,1107,1210,1010,967,1066,960,968,7288
85629,24752,23359,24359,23839,22442,21181,23568,163500
85630,2510,2306,2650,2874,2877,2839,2819,18875
85631,3739,4042,3970,3897,3886,4128,3630,27292
85632,844,830,887,857,907,901,835,6061
85633,68,53,55,39,37,66,54,372
85634,6251,6027,6332,5982,6102,5991,6490,43175
85635,34102,35055,35850,34563,34735,34551,34727,243583
85637,1329,1425,1286,1237,1177,949,1268,8671
85638,1962,2034,2146,2094,2004,1967,1973,14180
85640,449,469,721,487,494,451,441,3512
85641,25716,24020,23193,22293,21091,19932,21753,157998
85643,8702,8902,8934,9233,9423,9737,9810,64741
85645,1991,1927,1937,1922,1954,1769,2231,13731
85646,1606,1486,1476,1444,1084,848,1311,9255
85648,18673,18857,18884,19205,19495,19920,19080,134114
85650,15386,14807,14324,14525,14867,14888,15279,104076
85653,15460,13984,13827,13876,13556,13319,15083,99105
85654,53,297,366,407,275,290,97,1785
85658,11270,10600,9829,8771,7904,7068,7790,63232
85701,5311,5300,5047,4889,4692,4752,4983,34974
85704,30487,30411,30417,30665,30789,30819,30929,214517
85705,56863,56176,54795,54433,54766,54556,57521,389110
85706,55179,55778,56962,56989,56347,56231,55209,392695
85707,701,749,430,545,574,378,658,4035
85708,4178,4180,4200,3916,3196,3436,2980,26086
85710,56143,56534,55808,55323,55753,55119,54439,389119
85711,39177,41015,40315,40291,41628,41154,41251,284831
85712,34892,33906,33758,33830,32911,31720,32666,233683
85713,47108,47261,48865,49712,49356,51507,50151,343960
85714,14744,14706,14107,13725,14199,14055,15009,100545
85715,17727,18200,18884,19034,18769,18667,17702,128983
85716,31834,33137,32716,33098,32490,33171,32853,229299
85718,27061,27414,27010,26932,27786,27887,27367,191457
85719,45963,44813,44140,44220,42825,44105,43989,310055
85723,0,0,0,0,0,0,0,0
85724,0,0,0,0,0,0,0,0
85726,0,0,0,0,0,0,0,0
85730,39145,39772,39494,39142,38967,39244,38323,274087
85735,10759,11516,11723,11395,11453,10984,11250,79080
85736,4467,4458,4829,4752,4719,4946,4975,33146
85737,21737,21851,21872,21395,20951,20491,20727,149024
85739,18247,17621,17224,17715,17492,17642,17848,123789
85741,34718,34707,35014,35191,33817,33271,32998,239716
85742,26833,26466,25669,25414,25476,25353,25212,180423
85743,29496,29404,29164,28858,28844,27932,29144,202842
85745,37899,37746,38575,37654,38099,37764,37006,264743
85746,42956,43591,42715,42704,44304,44532,43057,303859
85747,24535,24423,23952,23490,22764,21844,23058,164066
85748,17426,17458,17603,18275,18764,19062,18087,126675
85749,19189,19188,18890,19107,19400,19453,19032,134259
85750,24068,23494,23615,23741,24205,24505,24161,167789
85755,15907,15875,15529,15716,15561,15210,15107,108905
85756,39863,38157,37253,35522,35314,33423,35703,255235
85757,19016,18819,18545,18341,17611,17969,16988,127289
85901,17466,17211,16856,16896,16448,16688,17207,118772
85911,2216,1979,1914,1546,1753,1813,1800,13021
85912,227,186,131,83,38,63,178,906
85920,288,306,390,325,387,466,464,2626
85922,49,67,46,37,33,29,41,302
85923,474,572,791,793,921,847,621,5019
85924,2374,2676,2713,2561,2765,2733,2683,18505
85925,4986,4906,4894,4892,4858,4721,4893,34150
85926,356,293,247,163,172,225,265,1721
85927,129,106,67,66,183,215,176,942
85928,1360,1213,1164,1129,1075,991,1102,8034
85929,7579,8283,7720,8698,9384,9036,8322,59022
85930,1226,1255,1081,948,725,600,1086,6921
85931,179,178,157,151,167,147,207,1186
85932,456,535,400,325,311,357,364,2748
85933,2478,2424,2825,2866,2980,2857,3033,19463
85934,488,630,606,684,546,462,574,3990
85935,5064,4784,5216,5264,4916,4990,4735,34969
85936,4706,4447,4406,4389,4189,4159,4293,30589
85937,7592,7444,7500,7492,7419,7704,7638,52789
85938,1853,2233,2091,2510,2744,3123,2366,16920
85939,4503,4375,4442,4481,4556,4367,4400,31124
85940,1173,1401,1284,1274,1224,982,1443,8781
85941,11025,11451,10991,11183,10683,10403,9941,75677
85942,108,99,37,43,0,0,80,367
86001,43511,42168,42401,41378,40950,40524,40776,291708
86003,4,3,0,0,25,23,23,78
86004,37215,37521,36811,38750,38731,38706,37338,265072
86011,7811,7478,6950,6512,6320,6129,6362,47562
86015,439,290,300,164,75,82,385,1735
86016,46,81,78,55,102,107,62,531
86017,731,672,733,689,1028,1039,667,5559
86018,824,703,670,663,541,528,759,4688
86020,2157,2201,2263,1917,1924,1957,1941,14360
86021,6302,6219,6131,6019,5738,5595,6085,42089
86022,2096,2741,2828,2334,1937,2123,2210,16269
86023,2236,1894,1707,1608,1420,1057,2627,12549
86024,517,541,522,497,513,524,703,3817
86025,5609,5588,5748,5646,5581,5548,5676,39396
86028,0,0,0,0,0,0,47,47
86029,241,280,256,191,139,87,320,1514
86030,1724,1530,1830,1695,1631,1444,1374,11228
86031,1829,2040,2027,1856,1976,2095,1856,13679
86032,1285,1346,1280,1316,1280,1227,1509,9243
86033,7354,7319,7573,7243,7366,7791,7844,52490
86034,2146,2039,1963,1943,2233,2414,2271,15009
86035,1860,1722,1758,1737,1725,1772,1802,12376
86036,348,248,291,358,362,360,388,2355
86038,12,7,7,23,26,19,77,171
86039,1203,1294,1358,1306,1309,1400,1467,9337
86040,10920,10653,10305,10256,10401,10373,10283,73191
86042,1902,1860,2069,2087,2094,2019,1778,13809
86043,2617,2293,2080,1787,1772,2138,1798,14485
86044,3652,3824,3933,3793,3893,4033,4251,27379
86045,12085,12577,12507,12308,11966,11712,11354,84509
86046,5628,5906,6227,5963,6031,5906,6090,41751
86047,15682,15064,15420,15278,15357,15195,14970,106966
86052,8,8,16,22,24,18,28,124
86053,2403,2311,2388,2530,2611,2611,2311,17165
86054,1877,1883,1800,1613,1659,1475,1935,12242
86301,22109,21412,21655,21896,21620,20879,20626,150197
86303,17325,17269,16383,16296,16633,16984,17082,117972
86305,17593,18064,17860,18450,18873,18979,17356,127175
86313,232,285,107,87,79,193,257,1240
86314,37464,36382,35418,35577,34520,35270,34401,249032
86315,7613,6795,6768,6643,6521,6052,7234,47626
86320,2119,2040,2031,2073,1810,1011,1885,12969
86321,2242,2431,2533,2293,2296,2223,2219,16237
86322,11723,11534,11295,11283,11307,11404,11480,80026
86323,15130,15920,16220,15933,16781,16517,15822,112323
86324,4250,4395,4259,4063,4052,4099,4168,29286
86325,4679,4672,4667,4708,4638,4571,5152,33087
86326,25635,24649,24871,24736,25026,25068,23344,173329
86327,9892,9982,9570,9119,9421,9342,8858,66184
86329,824,808,937,870,716,817,1179,6151
86331,494,559,570,551,490,555,477,3696
86332,1709,1760,1984,1798,1686,1688,1637,12262
86333,6664,6146,5713,5392,5105,5006,5734,39760
86334,4516,3939,4333,4511,4218,4104,4985,30606
86335,5287,6025,5652,5196,5105,4871,4806,36942
86336,11421,11378,11146,10990,10925,11163,11320,78343
86337,1130,1162,1036,870,731,783,1267,6979
86338,526,562,636,491,477,410,743,3845
86343,81,107,111,89,56,53,177,674
86351,6382,6561,6546,6825,6490,6712,6349,45865
86401,24507,25177,26010,26231,25950,25126,24289,177290
86403,17503,16767,15839,15666,15665,14950,15802,112192
86404,16545,16888,15969,15893,16567,15178,16243,113283
86406,22984,23234,24485,24584,24045,25513,23763,168608
86409,27047,26082,25705,26031,26364,27490,26471,185190
86411,223,206,200,164,114,96,224,1227
86413,14985,15750,14571,14319,14464,12412,12103,98604
86426,13789,13351,13573,13902,13950,14878,13863,97306
86429,7690,7380,7106,7239,6764,6471,7162,49812
86431,337,257,244,257,303,289,403,2090
86432,3439,3549,3636,3041,2540,2744,3933,22882
86433,81,120,126,164,136,144,111,882
86434,1478,1409,1350,1163,920,949,1490,8759
86435,45,59,126,181,222,268,487,1388
86436,1513,1474,1829,1729,1875,1693,2104,12217
86437,91,103,77,62,58,111,76,578
86438,963,889,901,725,513,540,913,5444
86440,6709,7013,6781,7062,7539,7931,6906,49941
86441,2277,2251,2488,2199,1848,2096,2224,15383
86442,33061,33010,33108,33223,33602,34062,33382,233448
86443,0,0,0,0,0,0,76,76
86444,863,713,703,603,917,1152,1289,6240
86445,244,379,379,311,350,278,311,2252
86502,1344,1412,1535,1535,1424,1587,1464,10301
86503,11845,10967,10866,11227,10648,9962,10714,76229
86504,6827,6469,6549,6396,6190,6594,6589,45614
86505,7955,7978,8190,7831,8182,8381,7682,56199
86506,1387,1440,1511,1440,1595,1488,1321,10182
86507,2456,2551,2415,2464,2311,2132,2340,16669
86508,825,871,960,996,902,930,752,6236
86510,4913,5058,5035,5112,5138,4917,5358,35531
86511,3597,3409,3338,2916,2974,2905,3694,22833
86512,2530,2608,2704,2771,3041,3022,2439,19115
86514,2615,2474,2444,2568,2806,2851,3317,19075
86515,4916,4637,4741,4928,4662,4746,4479,33109
86520,1961,1995,2002,1938,1765,1884,1793,13338
86535,1174,1127,1105,1149,1112,1097,1199,7963
86538,2432,2570,2563,2552,2410,2270,2338,17135
86540,982,1028,887,883,979,806,1088,6653
86544,1224,1332,1452,1345,1412,1266,1267,9298
86545,1430,1466,1500,1690,1479,1564,1650,10779
86547,1300,1249,1253,1367,1298,1254,1171,8892
86556,1909,1920,1901,1811,1792,1593,2090,13016
87001,4099,4442,4261,4271,3817,3595,3684,28169
87002,21675,21735,22094,22637,23069,22440,22517,156167
87004,10756,10568,10447,10351,10512,10555,10136,73325
87005,369,660,767,404,553,592,799,4144
87006,1102,958,668,881,741,621,703,5674
87007,1036,1140,997,841,794,749,1080,6637
87008,2891,2622,3112,2958,3171,3347,2552,20653
87010,1250,1304,1281,1092,975,616,1139,7657
87011,36,40,18,20,16,50,84,264
87012,252,232,266,234,298,235,261,1778
87013,4832,4632,4819,4533,4495,4574,5200,33085
87014,543,537,519,412,494,697,654,3856
87015,12426,11878,12785,13014,12886,12711,13105,88805
87016,3345,3505,3621,4165,4028,4042,3730,26436
87017,330,380,431,358,380,464,429,2772
87018,474,457,448,417,423,387,522,3128
87020,11634,11593,11436,11528,11166,11346,11347,80050
87021,3431,3732,3501,3319,3215,3297,3472,23967
87022,939,978,912,828,733,561,907,5858
87023,603,573,555,413,473,342,665,3624
87024,2334,2246,2165,2063,2192,2219,2214,15433
87025,1091,1137,1176,1168,1119,1038,1237,7966
87026,3903,4073,4147,4104,3858,4288,4063,28436
87027,222,274,225,323,275,256,309,1884
87028,498,391,279,286,341,139,145,2079
87029,221,239,146,218,219,307,237,1587
87031,44158,44460,44479,44104,43432,43833,44075,308541
87032,265,86,98,0,0,138,291,878
87034,2105,2260,2396,2374,2231,2377,2207,15950
87035,7122,7335,7606,7279,7877,7775,7268,52262
87036,2038,2255,1987,1947,1755,1644,1868,13494
87037,623,586,700,661,623,842,677,4712
87038,543,523,446,495,534,707,616,3864
87040,297,366,416,424,631,434,496,3064
87041,817,779,737,768,691,751,881,5424
87042,3601,3625,3636,3657,3702,3719,3644,25584
87043,4911,4963,5202,5502,5505,5481,5052,36616
87044,335,498,446,585,576,671,387,3498
87045,1570,1569,1616,1376,1239,1115,1751,10236
87046,58,39,45,38,27,23,186,416
87047,4159,4319,4390,4635,5166,5077,4894,32640
87048,9061,8838,8945,9052,9045,8975,8682,62598
87049,1530,892,942,998,1401,800,973,7536
87051,1483,1147,955,959,940,462,969,6915
87052,3401,3362,3290,3189,3056,3016,3182,22496
87053,1116,1090,1041,1082,1046,1049,998,7422
87056,954,1148,1242,1253,1580,1596,954,8727
87059,9417,9869,9368,9598,9588,9964,9604,67408
87061,244,260,382,282,282,223,371,2044
87062,1341,1277,1676,1968,2019,1961,1869,12111
87063,217,245,273,247,201,226,323,1732
87064,98,126,98,111,128,196,161,918
87068,5074,4890,4794,4789,4708,4544,4755,33554
87070,214,50,52,60,60,48,42,526
87072,652,572,588,490,462,426,660,3850
87083,598,590,534,525,514,449,569,3779
87102,20145,19840,19623,19692,20550,20772,21204,141826
87104,12671,12423,12170,12126,11967,12093,12123,85573
87105,58906,58342,57878,57937,58735,58179,57680,407657
87106,25015,25562,25476,25727,25965,25625,27013,180383
87107,31374,31220,32237,31560,31054,30143,31183,218771
87108,37287,37922,38150,37221,36143,35930,38647,261300
87109,39312,40426,40386,39810,40213,40049,40432,280628
87110,38092,37764,37774,38170,38842,39057,38587,268286
87111,57610,57689,58341,57554,57153,58125,56490,402962
87112,42890,43065,43188,43510,43719,43659,43584,303615
87113,15274,15461,15861,15814,15571,14659,14477,107117
87114,67625,67728,66061,64917,62550,61269,61623,451773
87116,3958,4032,4350,4269,4168,4376,4117,29270
87117,363,392,328,292,253,236,310,2174
87120,61126,60631,59947,60487,59124,58513,58023,417851
87121,79573,78626,77052,75581,74413,71242,76721,533208
87122,18373,18660,18260,17777,17923,18074,17977,127044
87123,44656,43695,43626,43690,42270,41983,41468,301388
87124,54040,53563,52880,52049,50058,49507,51404,363501
87144,40985,39989,39464,38441,38494,36238,37719,271330
87301,24142,24361,24102,23830,23601,23873,23674,167583
87305,3423,3202,3326,3230,3238,2889,3350,22658
87310,1061,972,907,780,787,830,938,6275
87311,4034,4007,3592,3304,3041,2943,4208,25129
87312,563,487,417,366,362,353,579,3127
87313,6035,5954,5714,5800,5914,5123,5662,40202
87315,137,130,41,24,89,76,149,646
87316,1304,1320,1286,1411,1293,1263,1304,9181
87317,1200,1013,1094,901,1213,1717,1956,9094
87319,1935,2157,2269,2580,2445,2430,1832,15648
87320,703,734,738,753,729,687,765,5109
87321,2035,1934,1668,1729,1706,2044,2226,13342
87322,240,240,261,210,192,104,247,1494
87323,4248,4244,4618,4541,4874,4033,4558,31116
87325,2962,2850,2931,3201,2937,2805,3034,20720
87326,1849,1889,2129,1995,1975,2106,1688,13631
87327,10561,11410,11057,10935,11392,11706,7883,74944
87328,2890,2941,3109,3461,3189,3115,2668,21373
87347,118,212,178,257,283,309,309,1666
87357,722,755,763,779,716,698,604,5037
87364,1002,943,1025,1089,1164,1072,1111,7406
87375,3412,2815,2586,2870,2870,2795,3193,20541
87401,44458,45830,46249,45784,46531,45798,46293,320943
87402,10286,10488,10530,11090,10989,10999,11034,75416
87410,16674,17360,17480,16968,16755,17017,17603,119857
87412,568,701,658,834,811,1043,966,5581
87413,15903,16260,16125,16062,16015,15891,16792,113048
87415,1671,1647,1713,1765,2291,2233,1791,13111
87416,5223,5283,5244,5517,5294,4837,5454,36852
87417,5823,5611,5673,5751,5549,5808,6910,41125
87418,1030,1254,1507,1780,1605,1634,1059,9869
87419,203,268,231,241,238,328,464,1973
87420,11592,11875,12979,13006,12955,13035,11967,87409
87421,1814,1737,1574,1716,1675,1807,1871,12194
87455,1801,1613,1729,1725,1747,1602,1750,11967
87461,1220,1239,1259,1400,1464,1314,1315,9211
87499,494,463,485,430,397,354,453,3076
87501,15839,15261,15523,15490,15767,16007,15147,109034
87505,30346,31007,30421,30189,29597,30267,31013,212840
87506,13349,13393,13292,13454,13181,12748,12580,91997
87507,47321,46794,46531,46430,46347,45552,45890,324865
87508,20112,20384,19493,19086,18513,18421,18183,134192
87510,773,770,595,690,577,705,1096,5206
87511,2537,2717,2473,2512,3129,3347,2747,19462
87512,65,86,92,203,207,192,199,1044
87513,1188,994,892,993,818,611,1007,6503
87514,680,733,1039,1352,1461,1450,1345,8060
87515,459,340,251,198,294,402,311,2255
87516,127,104,122,176,140,171,130,970
87517,147,138,149,89,105,178,356,1162
87518,142,129,132,116,58,69,91,737
87519,153,575,592,722,824,819,460,4145
87520,882,1163,1223,1531,1628,1830,1419,9676
87521,1012,967,843,757,834,627,1003,6043
87522,2283,2490,2762,3044,3013,2994,3384,19970
87523,539,417,304,218,334,368,405,2585
87524,57,61,73,94,144,107,260,796
87525,143,115,91,76,65,23,72,585
87527,748,743,599,618,709,788,880,5085
87528,3574,3213,3298,3405,3391,3322,3417,23620
87529,5300,5311,5411,5560,5027,4331,3600,34540
87530,1179,1051,767,608,677,686,974,5942
87531,583,343,354,415,444,443,368,2950
87532,18362,18170,18406,18222,17573,17923,18223,126879
87533,144,136,160,137,132,134,185,1028
87535,1138,1055,893,971,802,698,1270,6827
87537,3245,3407,3954,3677,3286,3121,2957,23647
87538,647,582,503,312,246,253,493,3036
87539,102,146,291,309,332,295,269,1744
87540,1001,879,886,823,1196,1249,923,6957
87543,201,305,507,535,733,658,247,3186
87544,17895,17939,17974,17979,18008,18040,17950,125785
87548,904,1084,1145,1067,1066,1158,928,7352
87549,865,928,816,1114,979,834,1118,6654
87551,352,277,329,324,416,328,305,2331
87552,3403,3428,3410,3340,3713,4119,3325,24738
87553,1190,1119,1080,1058,1157,1251,1209,8064
87554,0,13,23,23,57,56,61,233
87556,2545,2223,2112,2273,2118,2192,2417,15880
87557,6734,7702,7172,6640,6453,6853,6359,47913
87558,364,350,415,434,515,589,606,3273
87560,1503,1478,1405,1489,1264,1454,1445,10038
87562,379,509,452,435,545,440,576,3336
87564,372,360,471,382,394,381,332,2692
87565,283,453,307,321,258,251,478,2351
87566,3606,3571,3478,3058,3024,2888,3000,22625
87567,1742,1754,1585,1687,1633,1364,1634,11399
87569,362,288,431,443,354,309,442,2629
87571,11398,10719,10444,10247,10357,10957,11706,75828
87573,42,31,0,0,0,0,36,109
87574,271,255,292,142,105,54,187,1306
87575,1095,862,866,813,592,680,789,5697
87577,336,190,96,28,37,37,454,1178
87578,388,397,923,1072,992,617,611,5000
87579,821,811,889,947,972,815,890,6145
87580,628,535,683,557,580,589,449,4021
87581,0,0,65,91,107,119,141,523
87582,1025,1423,1635,1595,1669,1440,1350,10137
87583,96,120,126,115,86,107,234,884
87701,19699,19878,20165,20359,19887,19641,20081,139710
87710,1420,1690,1785,2050,1982,1777,1768,12472
87711,376,462,519,484,636,850,753,4080
87712,305,387,406,134,80,79,283,1674
87713,155,230,152,161,197,146,283,1324
87714,1106,1123,1074,906,1020,1150,1151,7530
87715,531,601,820,811,762,969,532,5026
87718,507,483,547,615,580,541,467,3740
87722,549,419,249,200,335,338,376,2466
87723,257,210,146,135,307,326,408,1789
87724,0,0,0,0,0,0,88,88
87728,346,306,341,277,281,379,417,2347
87729,103,84,140,138,92,107,126,790
87730,38,38,13,13,12,8,27,149
87731,254,241,421,441,512,282,223,2374
87732,1488,1389,1410,1273,1378,1438,1672,10048
87733,131,151,190,219,194,231,158,1274
87734,231,316,139,190,135,148,181,1340
87735,43,18,25,46,45,38,90,305
87736,242,272,353,544,385,317,233,2346
87740,7309,7545,7505,7663,7757,8002,8068,53849
87742,389,496,450,769,924,722,609,4359
87743,340,315,378,365,296,332,361,2387
87745,760,714,685,917,1212,1426,654,6368
87746,77,55,50,12,38,48,120,400
87747,1575,1644,1739,1708,1717,1723,1624,11730
87749,330,100,112,102,129,20,75,868
87750,0,0,11,24,37,48,11,131
87752,620,709,674,799,651,570,431,4454
87753,169,98,274,164,194,187,254,1340
87801,10076,10369,10384,9880,9919,10270,10221,71119
87820,86,83,97,73,115,97,161,712
87821,742,694,770,836,698,619,672,5031
87823,1157,1176,881,776,899,871,884,6644
87824,125,130,156,234,302,242,194,1383
87825,1717,1675,1829,1982,2141,2631,2999,14974
87827,187,167,148,172,153,132,276,1235
87828,563,827,583,653,710,443,429,4208
87829,542,558,675,689,767,901,922,5054
87830,1619,1754,1675,1567,1396,1173,999,10183
87831,180,198,423,408,318,484,195,2206
87832,948,884,1015,1057,887,514,600,5905
87901,6666,6682,6778,6870,7066,7051,7139,48252
87930,925,1022,1097,1231,1476,1192,829,7772
87931,628,529,635,745,500,497,634,4168
87933,0,0,0,0,49,72,106,227
87935,1752,1724,1791,1687,1360,1228,1770,11312
87936,285,247,223,457,432,417,515,2576
87937,3026,2903,3119,2833,2102,2171,3303,19457
87939,69,150,188,218,187,148,125,1085
87940,852,480,349,205,451,353,669,3359
87941,867,1085,1059,930,1008,888,1216,7053
87942,1025,1176,847,709,758,1010,898,6423
87943,183,148,187,184,236,396,228,1562
88001,37201,36131,36361,35863,36543,37524,37484,257107
88002,1338,1567,1670,1567,1661,1271,1656,10730
88003,619,816,1048,1090,1129,1044,894,6640
88004,707,649,400,277,282,370,699,3384
88005,28683,30982,29366,29448,27552,27005,27116,200152
88007,23130,23170,25364,26957,27447,27369,24048,177485
88008,6906,6881,6256,6085,6215,6272,5747,44362
88009,86,157,197,196,210,153,88,1087
88011,29458,29025,28542,27235,26275,25265,27698,193498
88012,27910,26830,26294,26150,26771,25597,25961,185513
88020,778,639,624,580,612,629,882,4744
88021,19707,19492,18864,18013,17341,16936,18421,128774
88022,1277,1354,1171,1041,1113,1044,1343,8343
88023,2563,2556,2702,2729,2763,3054,2406,18773
88024,563,461,326,211,253,49,236,2099
88025,301,259,333,492,441,393,256,2475
88026,1363,1405,1261,1329,1473,1328,1658,9817
88027,462,554,434,426,610,559,493,3538
88028,404,457,517,640,536,692,492,3738
88029,1279,1377,1395,1538,1621,1448,1873,10531
88030,23348,23412,23552,23463,23541,23802,23222,164340
88032,386,342,344,283,117,119,195,1786
88033,0,15,17,16,15,15,11,89
88034,114,184,126,125,89,81,96,815
88038,323,327,518,454,490,607,431,3150
88039,203,166,106,132,255,523,465,1850
88040,72,99,96,92,93,107,116,675
88041,994,1257,1167,1266,1142,1098,1243,8167
88042,164,169,241,233,324,297,250,1678
88043,1640,1649,1637,1637,1692,1678,1621,11554
88044,3702,3929,4518,4444,4339,4183,3896,29011
88045,3464,3550,3681,3896,3906,3941,3662,26100
88046,855,801,795,760,773,837,697,5518
88047,2493,1937,1811,1758,2003,1840,1967,13809
88048,2966,3066,3302,4028,3668,3631,3862,24523
88049,458,425,412,458,299,197,408,2657
88051,100,81,54,51,18,3,94,401
88052,152,145,72,71,49,15,270,774
88053,131,202,19,69,75,77,133,706
88055,7,19,13,13,10,25,37,124
88056,189,276,194,126,130,186,233,1334
88061,18562,18321,18655,18426,18568,18504,18585,129621
88063,13070,13509,13354,13000,12795,12748,12799,91275
88065,577,545,660,685,845,840,624,4776
88072,1716,2204,2346,2714,2712,2524,2501,16717
88081,16018,15364,15297,14455,14041,14554,15708,105437
88101,47233,47180,46923,46046,45048,44140,45006,321576
88103,341,334,274,282,273,295,278,2077
88112,152,144,152,214,193,203,123,1181
88113,39,30,53,103,134,219,103,681
88114,17,16,16,20,28,42,35,174
88115,71,35,19,14,20,20,44,223
88116,327,357,393,372,382,408,455,2694
88118,262,258,206,236,250,251,180,1643
88119,1902,1923,1823,1869,1968,1949,1932,13366
88120,171,142,174,206,215,214,239,1361
88121,79,93,142,125,138,150,152,879
88124,1101,1080,1073,1075,1097,1108,1165,7699
88125,70,64,63,61,77,60,90,485
88126,56,36,31,38,66,39,30,296
88130,18484,18777,18980,18901,18610,18237,18651,130640
88132,264,289,256,178,218,297,199,1701
88134,27,53,64,48,53,40,46,331
88135,1656,1760,1731,1637,1448,1665,1804,11701
88136,48,44,80,58,48,31,44,353
88201,26379,26072,25911,25462,25271,25362,25490,179947
88203,30551,30828,30909,31351,31257,31290,31561,217747
88210,18393,17856,17243,16865,16870,16785,17217,121229
88220,35362,35241,34794,34840,34172,33973,33725,242107
88230,5131,5391,5356,5425,5393,5152,5179,37027
88231,3334,3353,3291,3210,3126,3067,3238,22619
88232,2639,2712,2853,2556,2590,2341,2525,18216
88240,39568,38680,37635,36906,36842,36871,37149,263651
88242,7167,7523,7456,7144,6966,6084,6141,48481
88250,257,131,158,97,125,138,270,1176
88252,2217,2288,2215,2179,1979,2029,2160,15067
88253,886,887,915,908,912,840,935,6283
88254,46,37,101,90,89,167,191,721
88255,59,34,33,68,79,31,128,432
88256,1946,1953,2071,2087,2068,1851,1925,13901
88260,15082,14861,14883,14770,14341,14260,14343,102540
88262,4,10,8,7,7,17,30,83
88263,107,87,141,72,67,44,175,693
88264,22,26,0,0,0,0,39,87
88265,150,159,244,283,293,266,243,1638
88267,1369,1233,1128,1162,1088,1054,1349,8383
88268,199,164,118,0,0,0,7,488
88301,1237,1252,1239,1280,1421,1339,1386,9154
88310,36460,37002,36807,36328,36038,35994,35776,254405
88311,1403,1421,1548,1717,1528,1069,854,9540
88312,2635,2932,3136,3072,3208,2788,2586,20357
88314,111,123,135,184,230,302,210,1295
88316,2175,1746,1715,2015,2156,2546,2351,14704
88317,1604,1183,1386,1337,1551,1584,1751,10396
88318,322,314,297,352,343,373,381,2382
88321,86,85,89,117,119,99,187,782
88323,0,0,5,12,21,0,14,52
88324,231,201,190,123,186,248,210,1389
88325,594,619,641,871,956,865,899,5445
88330,3977,4021,3745,3599,3585,3553,3054,25534
88336,423,380,341,235,250,191,267,2087
88337,2277,2731,2442,2487,2340,2101,2295,16673
88338,251,225,236,208,105,112,189,1326
88339,668,670,798,827,727,746,618,5054
88340,3586,3550,3771,3885,3834,3743,3616,25985
88341,429,406,310,299,353,256,538,2591
88342,117,109,65,6,24,21,52,394
88343,24,24,22,25,13,17,48,173
88344,24,43,139,170,214,230,159,979
88345,8368,8752,8868,9001,8768,8835,8845,61437
88346,3198,3309,3370,3226,3145,3150,3132,22530
88347,192,128,169,159,164,134,100,1046
88348,287,243,239,296,264,267,314,1910
88349,12,12,0,0,30,75,70,199
88350,299,357,255,283,295,331,368,2188
88351,179,169,216,237,251,386,256,1694
88352,4690,4655,4880,4771,4801,4874,5188,33859
88353,389,437,509,534,532,481,473,3355
88354,46,77,116,122,173,106,108,748
88355,0,0,0,0,0,0,29,29
88401,6752,6831,6789,6816,6669,6641,6944,47442
88410,68,109,25,86,99,94,129,610
88411,45,58,74,57,68,75,82,459
88414,60,62,77,89,95,57,39,479
88415,3494,3459,3564,3528,3422,3443,3569,24479
88416,62,82,65,68,199,171,189,836
88417,44,57,125,61,58,38,25,408
88418,229,263,331,330,468,398,294,2313
88419,214,201,198,179,256,318,229,1595
88421,33,31,27,0,0,0,19,110
88422,103,98,86,103,35,53,68,546
88424,57,64,60,80,75,79,128,543
88426,1046,1136,1221,1236,1243,1187,1212,8281
88427,140,146,92,109,136,159,119,901
88430,70,69,69,122,157,231,162,880
88431,56,0,0,0,35,31,49,171
88434,393,331,402,418,584,573,369,3070
88435,3803,3678,3543,3629,3496,3389,3559,25097
88436,87,110,103,101,89,96,185,771
89001,1057,1326,1067,878,1038,1452,1224,8042
89002,34343,34391,33803,34191,33146,32853,31880,234607
89003,770,1051,1021,900,1011,1082,1032,6867
89004,345,351,283,385,399,385,313,2461
89005,15373,15261,15157,15116,15186,15318,15065,106476
89007,1423,1374,1431,1694,1153,1054,1351,9480
89008,1272,1272,1400,1390,1463,1211,1508,9516
89010,458,549,368,319,281,313,415,2703
89011,21506,19848,18182,17599,17690,17341,19550,131716
89012,31614,30209,29121,28082,27936,27333,29085,203380
89013,477,466,429,409,366,347,285,2779
89014,38916,38213,37758,37768,37333,38209,36922,265119
89015,41738,39988,38429,38048,38910,38944,38993,275050
89017,130,131,105,121,188,153,176,1004
89018,4797,4517,4814,5327,5637,5897,1007,31996
89019,1762,1804,1843,1892,1882,2172,2673,14028
89020,1453,1340,1135,1240,1077,1134,1456,8835
89021,3322,3757,3387,3429,3037,2964,3605,23501
89022,53,56,92,127,121,91,69,609
89025,1589,1441,1311,1332,1011,864,1400,8948
89026,0,0,217,383,573,361,150,1684
89027,16953,16533,16072,15691,15366,14943,15275,110833
89029,7823,7855,7819,7990,7169,7226,7546,53428
89030,47895,48009,47727,48407,51857,51507,53928,349330
89031,66586,64876,63260,62455,60297,60611,60589,438674
89032,43967,44699,43896,43918,41233,40168,40297,298178
89039,143,149,138,144,165,170,316,1225
89040,3334,3373,3535,3521,3901,3982,3721,25367
89042,1223,1272,1507,1581,1364,1169,1010,9126
89043,1473,1193,1203,1326,1229,1192,1429,9045
89044,18587,17762,16720,16249,14989,13705,14260,112272
89045,1736,1734,1856,1831,1830,1864,1505,12356
89046,398,470,545,515,517,383,660,3488
89047,66,61,91,111,173,159,107,768
89048,21034,19996,20258,20380,20668,20498,21169,144003
89049,2768,2870,3155,3392,3212,3359,2727,21483
89052,51208,51903,51378,50246,48587,48182,47214,348718
89054,48,72,67,179,150,125,105,746
89060,9411,9587,9831,10281,10623,10691,10227,70651
89061,5485,5337,4938,4669,4552,4658,5252,34891
89074,49133,49105,49123,47870,47794,46392,47095,336512
89081,34495,33498,33917,32798,30045,27393,29774,221920
89084,24583,23100,22405,20612,20379,19555,21837,152471
89085,4369,4067,3998,4191,3950,3936,3367,27878
89086,5787,5640,4998,4551,4784,3944,4726,34430
89101,40673,40708,43261,44213,45219,45812,46055,305941
89102,37272,37433,37483,37661,38143,39054,35759,262805
89103,50979,49678,49312,49537,50057,48598,50519,348680
89104,39694,40301,39648,38711,39608,38730,39909,276601
89106,26300,26878,26328,27104,27004,27976,25759,187349
89107,37943,37147,36423,36204,36534,36174,36282,256707
89108,75179,73572,71634,68972,67208,66804,70123,493492
89109,7491,7341,7013,6852,6904,7477,7770,50848
89110,73896,72160,71374,71150,72269,73437,70994,505280
89113,26927,26796,25850,24623,23964,22751,23800,174711
89115,59220,60601,61346,58870,60509,61983,58794,421323
89117,53462,53155,54234,54646,54900,55445,55416,381258
89118,20682,20420,20317,20644,19640,19326,19318,140347
89119,50333,47926,46684,44425,44392,43648,49445,326853
89120,24830,24402,23679,23195,22382,21780,23311,163579
89121,63884,63313,62991,61911,61813,62611,64096,440619
89122,49800,48533,47561,46236,46004,44253,45720,328107
89123,57322,57563,57579,58991,58968,57558,56300,404281
89124,783,817,798,821,688,801,941,5649
89128,37110,37819,38213,38561,37479,37319,35669,262170
89129,55164,53137,52313,52145,52735,51374,51252,368120
89130,35480,34829,32908,31215,30088,30603,33015,228138
89131,46129,45539,44037,45220,45309,44719,43072,314025
89134,25053,25136,25264,25455,26296,25852,24040,177096
89135,25919,25640,25473,25178,24147,23462,24144,173963
89138,14753,14120,13120,13203,12619,12614,12118,92547
89139,37869,36398,34250,32332,31706,30190,30477,233222
89141,29182,28895,30163,28290,27593,27233,25150,196506
89142,34834,32712,31145,31185,32262,31472,33731,227341
89143,12778,12589,11880,11964,10650,11046,12786,83693
89144,18858,18905,19600,20074,19641,20006,18714,135798
89145,25193,24550,24246,24285,23231,22784,23186,167475
89146,17896,18835,18111,18517,19386,19032,19071,130848
89147,52646,51808,51606,51419,51131,49581,49778,357969
89148,47938,44986,43498,42934,39926,38131,39712,297125
89149,35120,35356,35657,33420,32040,30692,31143,233428
89156,29132,28693,27426,27288,27747,28368,27794,196448
89161,52,37,39,93,102,53,184,560
89166,17783,15944,13615,11860,9776,7518,13209,89705
89169,22421,22209,21785,21809,23183,23372,23304,158083
89178,35241,32539,31489,28781,26198,24565,27588,206401
89179,5178,4105,3175,2815,2132,1689,2340,21434
89183,38974,38964,39008,38800,37323,35847,36005,264921
89191,743,818,759,763,824,1075,857,5839
89301,7904,7547,7191,6716,6698,6424,7606,50086
89310,417,531,554,523,520,555,550,3650
89311,150,135,132,124,130,82,235,988
89314,361,335,382,242,224,214,158,1916
89316,1224,1298,1406,1513,1560,1473,1408,9882
89317,161,467,479,530,622,650,477,3386
89318,1273,1353,1590,1677,1608,1952,1219,10672
89319,399,391,500,766,816,599,450,3921
89402,14,0,0,0,0,0,71,85
89403,14871,14383,14130,14089,14146,13706,14158,99483
89404,46,42,44,30,0,0,52,214
89405,20,20,78,206,184,185,239,932
89406,24119,24252,24347,24572,24779,24904,24772,171745
89408,19409,19229,19243,19203,19090,18897,19626,134697
89409,119,126,109,128,149,165,283,1079
89410,10417,10498,10563,10432,10809,11009,10557,74285
89411,983,1087,1104,891,731,874,929,6599
89412,252,301,227,265,223,252,288,1808
89413,451,480,470,408,414,370,655,3248
89414,337,359,390,308,288,234,349,2265
89415,3361,3598,3741,3862,3901,4143,3793,26399
89418,291,215,196,134,207,243,388,1674
89419,5570,5673,5618,5620,5491,5625,5150,38747
89420,13,19,33,39,35,27,48,214
89421,698,823,826,694,685,612,634,4972
89422,69,34,41,82,94,93,165,578
89423,10565,10443,10586,10722,11088,11048,10465,74917
89424,269,250,261,275,309,267,341,1972
89425,445,670,738,756,807,650,432,4498
89426,171,195,183,308,255,209,208,1529
89427,1054,898,812,717,688,497,746,5412
89428,211,222,219,183,176,180,179,1370
89429,7249,7407,7377,7322,7363,7310,7627,51655
89430,599,477,454,465,215,222,433,2865
89431,37700,37800,37143,36812,37047,36449,36189,259140
89433,21046,20232,19544,19630,19440,20228,20188,140308
89434,25602,25736,25260,24948,25109,25503,25416,177574
89436,39919,38337,38215,37781,36078,35267,36867,262464
89438,110,8,7,0,0,0,48,173
89439,1484,1609,1563,1687,1643,1457,1417,10860
89440,925,841,784,688,866,734,947,5785
89441,12250,12042,11767,11660,11982,11336,11542,82579
89442,1125,1088,1121,999,953,862,1118,7266
89444,2636,2502,2677,2580,2717,2707,2734,18553
89445,16016,15748,15727,15679,15445,15486,16114,110215
89446,136,111,98,105,124,0,36,610
89447,7763,8203,8113,8290,8402,8828,7931,57530
89448,1497,1542,1430,1365,1268,1180,1695,9977
89449,3325,3130,3044,2960,2561,2486,2994,20500
89450,186,203,177,154,134,119,86,1059
89451,8576,8770,8405,8500,7993,8228,8930,59402
89460,12762,12860,12863,13338,13496,13521,13236,92076
89501,3892,3551,3671,3533,3292,2951,4252,25142
89502,45625,44777,44277,44329,44830,44671,43566,312075
89503,28512,28246,28731,28191,29114,28887,27891,199572
89506,41056,42448,41418,42054,41813,39826,38379,286994
89508,12236,12042,11505,11276,11312,11804,11662,81837
89509,33707,33572,33447,33302,33016,33220,33395,233659
89510,1684,1668,1740,1574,1685,1558,1685,11594
89511,25763,26173,26582,26311,25822,25127,25011,180789
89512,25448,25561,25781,24450,24049,24088,25574,174951
89519,8084,8131,8294,8407,8166,8492,8392,57966
89521,29394,27554,26432,25111,24258,23681,25716,182146
89523,34232,32736,32071,31732,31178,31275,31373,224597
89701,26152,26240,26264,26637,26669,26715,27625,186302
89702,0,138,161,179,192,131,0,801
89703,10232,10142,10538,10169,10099,10452,9714,71346
89704,4315,4535,4675,4822,4735,4517,4290,31889
89705,5723,5469,5384,5350,5218,5080,4969,37193
89706,19618,19778,19405,19543,20034,20413,19510,138301
89801,25263,24471,23546,22824,22320,21715,23298,163437
89815,14060,14424,14984,14404,14161,14374,13346,99753
89820,5591,5677,5661,5610,5596,5463,5358,38956
89821,487,448,482,455,298,370,482,3022
89822,2348,2310,2419,2643,2658,2838,2513,17729
89823,186,181,278,166,27,16,273,1127
89825,1568,1614,1490,1326,1410,1131,1228,9767
89826,76,80,111,193,182,102,42,786
89828,447,433,229,379,337,293,268,2386
89830,143,141,124,198,194,231,270,1301
89831,29,31,28,30,28,25,78,249
89832,1450,1696,1541,1531,1410,1445,1304,10377
89833,138,188,222,246,156,133,201,1284
89834,120,106,148,168,181,228,126,1077
89835,2051,1789,1654,1729,1795,1651,1822,12491
89883,4390,4422,4448,4442,4494,4484,4488,31168
90001,57942,57227,56314,54760,54480,54760,57110,392593
90002,51826,50626,50098,49475,48613,46509,51223,348370
90003,70208,69502,66913,66200,67226,66183,66266,472498
90004,63095,64008,63547,62760,62884,63932,62180,442406
90005,39338,38979,38638,39548,39592,41178,37681,274954
90006,61230,61625,61419,59498,58849,57912,59185,419718
90007,41979,43426,43779,43173,43653,42265,40920,299195
90008,32060,31837,33012,33280,33754,34429,32327,230699
90010,3524,3740,3792,4133,3835,3229,3800,26053
90011,104762,104058,102926,100882,100671,101523,103892,718714
90012,32543,30860,30029,29528,29164,29298,31103,212525
90013,11668,11299,10575,10256,9318,8216,11772,73104
90014,7191,7006,6659,6008,5556,5204,7005,44629
90015,19378,18767,18226,18358,17668,17957,18986,129340
90016,47079,47590,47786,47273,46779,46871,47596,330974
90017,25772,24336,23719,23755,23171,22401,23768,166922
90018,51639,49824,48852,48498,48497,48212,49310,344832
90019,68530,67553,67606,65408,64613,63894,64458,462062
90020,40170,39866,39102,39866,41086,40596,38967,279653
90021,2954,2970,2913,2940,2664,2603,3951,20995
90022,67191,68136,69516,70147,68657,67322,67179,478148
90023,46611,46288,45886,45126,45663,44706,45903,320183
90024,49737,50693,50117,50964,50269,49427,47452,348659
90025,46520,46107,45284,43555,42932,42653,42147,309198
90026,67557,68520,67986,68726,69615,70052,67869,480325
90027,46043,46646,46025,45942,45702,45491,45151,321000
90028,31122,30380,29994,28151,28254,27434,28714,204049
90029,40242,40472,40161,40208,39437,38563,38617,277700
90031,38940,39422,39333,40052,39990,39076,39316,276129
90032,47285,47099,47309,47784,49242,48729,45786,333234
90033,49156,48277,48567,49049,49048,49102,48852,342051
90034,57443,58069,58968,58703,59305,59662,57964,410114
90035,30582,30852,31399,30999,30553,29113,28418,211916
90036,37931,37640,36425,36101,35942,36124,36865,257028
90037,61451,62872,61536,61845,60867,60639,62276,431486
90038,28155,28577,28798,29836,30225,30498,28917,205006
90039,28436,28149,27843,27049,28260,29262,28514,197513
90040,12812,12699,12830,12696,12692,12862,12520,89111
90041,28405,28796,28439,28203,28571,28857,27425,198696
90042,63109,62650,61034,60623,62303,63424,62430,435573
90043,44328,43129,43118,43527,43761,44042,44789,306694
90044,90155,88975,88412,87590,85940,88164,89779,619015
90045,41145,41922,41453,40272,40535,40150,39480,284957
90046,50923,51651,51329,50499,49937,49212,48581,352132
90047,48306,48678,46999,47533,47857,47550,48606,335529
90048,22722,22498,22409,21316,20793,20931,21397,152066
90049,35581,35427,35262,35310,36107,36451,35482,249620
90056,8118,8537,8380,8536,8628,8108,7827,58134
90057,48302,46509,45747,45392,44871,43808,44998,319627
90058,2674,2680,2748,2980,3289,3484,3223,21078
90059,46027,44648,42470,41831,40305,40209,40952,296442
90061,27203,28135,28641,27457,26621,26952,26872,191881
90062,33690,33353,32675,32450,31569,30710,32821,227268
90063,54142,53813,54353,54160,53994,52883,55758,379103
90064,27032,26384,25788,26103,25894,25633,25403,182237
90065,46965,46904,46254,45242,45816,46844,45527,323552
90066,59258,59124,58337,59031,56107,56210,55277,403344
90067,2355,2330,2364,2312,2257,2468,2424,16510
90068,21450,21233,21943,22043,22270,22048,22286,153273
90069,20435,20132,20426,20731,20328,19789,20483,142324
90071,0,0,0,0,0,0,15,15
90073,915,862,801,773,623,560,539,5073
90077,8912,8844,8328,8506,8262,8571,9377,60800
90079,0,0,0,0,0,0,0,0
90089,3680,3334,3326,3276,3402,3516,3217,23751
90090,0,0,0,0,0,0,0,0
90094,8072,6858,6062,5852,5567,4994,5464,42869
90095,0,0,0,0,0,0,3,3
90201,102786,102946,102515,101932,101647,101584,101279,714689
90210,20957,22052,21478,21548,21517,21719,21741,151012
90211,8129,7530,8080,7748,7889,8097,8434,55907
90212,12915,12577,12415,12510,12306,11836,11555,86114
90220,51271,50715,50222,49810,50947,50741,49328,353034
90221,53922,54236,53657,52446,51350,51535,53704,370850
90222,32195,31875,32362,31893,30990,30628,31869,221812
90230,32692,31978,33090,32335,32508,32019,31766,226388
90232,14810,15708,15353,15454,15248,15001,15149,106723
90240,26426,26655,26287,25411,25258,25398,25876,181311
90241,44815,43592,43596,43776,43786,43558,42399,305522
90242,41982,43160,43199,43147,42763,42373,43497,300121
90245,16901,16929,16839,16760,16678,16597,16654,117358
90247,47706,48032,47374,47361,46590,46729,47487,331279
90248,10592,10166,9936,9822,9904,10268,9947,70635
90249,26795,26627,27451,26800,26790,26735,26669,187867
90250,96987,95939,95223,93994,93925,93154,93193,662415
90254,19726,19747,19725,19605,19535,19422,19506,137266
90255,75770,76180,76206,76620,75961,76137,75066,531940
90260,35569,35866,35854,35508,35014,34471,34924,247206
90262,71197,71163,70650,70137,69734,69643,69745,492269
90263,1887,1832,1987,1899,1847,1710,1612,12774
90265,18394,18258,17660,17630,17749,17822,18116,125629
90266,35573,35603,35534,35324,35226,34986,35135,247381
90270,27575,27700,27663,27527,27443,27454,27372,192734
90272,23151,23934,23497,22779,22893,22765,22986,162005
90274,25503,25778,25482,25339,25387,25319,25209,178017
90275,42545,42593,42420,42051,41903,41712,41804,295028
90277,35204,35178,34546,34635,33972,34382,35293,243210
90278,40582,40485,40839,40574,40867,40661,40071,284079
90280,95219,95350,95515,95000,94703,94586,94396,664769
90290,5974,6478,6902,7093,6983,6820,6368,46618
90291,27277,27167,27803,27253,26961,26992,28341,191794
90292,22482,21679,21507,21536,22350,22152,21576,153282
90293,12649,12458,11997,12403,12129,12833,12132,86601
90301,36429,36360,36714,36798,37165,37024,36568,257058
90302,31064,30482,30219,30502,30344,30729,29415,212755
90303,25134,26408,26453,26339,25828,26055,26176,182393
90304,27008,26854,26936,28101,27198,26978,28210,191285
90305,15777,15665,15501,14814,14896,14107,14853,105613
90401,7621,7297,7035,6821,6766,6531,6722,48793
90402,11410,11661,11503,11749,12351,12615,12250,83539
90403,24539,24416,25116,24864,24286,24770,24525,172516
90404,22201,22081,21641,20807,20739,20123,21360,148952
90405,28861,28915,28535,28560,28114,27350,27186,197521
90501,43405,43145,43407,42373,42363,41290,43180,299163
90502,17855,17585,17135,16947,16845,16655,18010,121032
90503,44562,45986,45518,46780,46253,46402,44383,319884
90504,33609,33279,32777,31633,31650,31463,32102,226513
90505,37242,36904,37381,36306,36135,35804,36678,256450
90506,0,0,0,0,0,0,0,0
90601,34169,34203,34143,33145,32630,32524,31974,232788
90602,26778,27421,26676,25768,25923,26210,25777,184553
90603,20325,20221,20475,20083,19933,19199,20063,140299
90604,41371,40977,39541,40661,40483,40340,39407,282780
90605,41305,41643,42103,42017,40698,40159,40331,288256
90606,32499,32697,32978,32791,32998,32929,32396,229288
90620,46550,46639,45992,45266,44295,43414,45113,317269
90621,35168,35245,35478,35507,35994,36338,35153,248883
90623,15886,15839,15767,15689,15528,15402,15554,109665
90630,49093,49145,48844,48590,48292,47881,47993,339838
90631,68971,69151,68899,68065,67929,67707,67619,478341
90638,49876,49819,49543,49222,49062,48922,49012,345456
90640,63461,63521,63400,63016,62965,62782,62549,441694
90650,106360,106659,106521,105940,105603,105348,105549,741980
90660,63684,63815,63686,63310,63106,62994,62928,443523
90670,16266,15998,15594,15489,15265,15321,14866,108799
90680,30373,30795,30770,30261,30369,30526,29945,213039
90701,16842,16785,16698,16657,16597,16573,16591,116743
90703,50442,50276,50069,49526,49551,49537,49399,348800
90704,3912,3906,3952,3960,3999,4060,4090,27879
90706,77687,77756,77455,76989,76619,76243,76615,539364
90710,27914,27457,27550,26830,27486,27672,25457,190366
90712,31722,32451,32015,31710,31334,31786,31499,222517
90713,28833,28699,28411,27653,27562,27344,27925,196427
90715,20064,19753,20283,20953,21129,20662,20388,143232
90716,14383,14382,14358,14280,14203,14265,14184,100055
90717,21658,21816,21612,21459,21347,21353,21318,150563
90720,22413,22029,22325,22227,21710,21360,21751,153815
90723,54941,55023,54813,54468,54255,54196,54099,381795
90731,61046,62028,62348,61432,59270,60467,59662,426253
90732,21763,21417,19810,19651,19895,20300,21115,143951
90740,24296,24330,24288,24073,23789,23875,23729,168380
90742,627,689,842,866,968,1063,831,5886
90743,368,358,330,441,411,277,456,2641
90744,57432,57963,58061,57358,57441,56811,53815,398881
90745,57785,58186,57727,58162,58090,57668,57251,404869
90746,26584,26523,26738,26276,25861,26021,25990,183993
90747,0,0,0,0,0,0,0,0
90755,11491,11440,11400,11260,10994,10893,11074,78552
90802,39873,39155,38816,39297,39017,38669,39347,274174
90803,31680,31709,30805,30563,30855,30670,32031,218313
90804,40751,41007,40679,40472,41094,40817,40311,285131
90805,95808,95127,94561,92991,93117,92627,93524,657755
90806,42312,42498,43140,43176,42873,42486,42399,298884
90807,33217,33763,33726,32645,32176,31912,31481,228920
90808,38637,39428,39834,40016,39064,39848,38232,275059
90810,37422,36936,36736,36113,36935,37208,36735,258085
90813,60997,60078,60017,59178,58719,57602,58911,415502
90814,18760,19264,18789,18937,18633,18260,19131,131774
90815,39822,40462,40572,40966,40502,41278,39733,283335
90822,148,152,169,176,183,47,117,992
90831,0,0,0,0,0,0,0,0
91001,37699,37163,37481,37832,38066,38113,36126,262480
91006,32106,31728,32392,32271,32339,32233,31715,224784
91007,34619,34598,34198,33586,33836,33241,34095,238173
91008,1203,1132,1149,1217,1122,1271,1391,8485
91010,26000,25840,25797,24708,24913,24917,26074,178249
91011,20679,20721,20671,20590,20468,20308,20280,143717
91016,41901,42090,42235,41985,41610,41385,40598,291804
91020,8448,8438,9249,8585,8462,8682,8415,60279
91024,11067,11084,11060,10983,10939,10881,10917,76931
91030,25905,25967,25914,25747,25603,25465,25616,180217
91040,19587,19969,20017,19296,19903,20232,20372,139376
91042,27164,27298,28126,28725,28266,27593,27585,194757
91046,125,175,168,176,141,123,156,1064
91101,20761,20936,21098,21378,21545,21121,20460,147299
91103,28124,27819,27684,26984,27127,27330,27480,192548
91104,38725,38976,38421,37590,36961,37335,36751,264759
91105,11728,11413,11373,11401,10891,10548,11254,78608
91106,24875,25243,24861,24355,24494,25096,24229,173153
91107,32027,31722,31828,32415,31737,31329,32940,223998
91108,13675,13654,13613,13540,13297,13281,13361,94421
91201,23510,23092,22985,23272,23671,23419,22781,162730
91202,23219,23148,23007,22610,22533,22414,22830,159761
91203,14051,13680,13740,13213,13360,13016,13220,94280
91204,17681,17053,16292,15924,16241,15830,16032,115053
91205,37664,38322,38138,38504,38362,38321,37810,267121
91206,34247,34038,33706,33014,32474,32674,33065,233218
91207,10071,10359,10334,10435,10613,10566,10506,72884
91208,17180,17164,16548,15962,15655,15672,16245,114426
91210,886,727,614,651,228,194,328,3628
91214,30935,30965,31078,31653,31479,31642,30356,218108
91301,26007,26293,26439,26218,25834,25343,25488,181622
91302,25906,25431,25165,25070,24910,25802,25709,177993
91303,29668,29471,27827,26744,26613,26308,26855,193486
91304,52846,53853,53517,53194,52907,52249,50231,368797
91306,49043,49532,48707,47879,47048,47235,45061,334505
91307,26703,26219,25597,25496,24983,24506,24474,177978
91311,38479,38505,37769,38117,37945,37504,36557,264876
91316,29485,28837,28190,27736,26368,26586,26898,194100
91320,45502,44952,44958,45060,45433,45205,44274,315384
91321,34664,34178,34576,35243,35148,34948,34882,243639
91324,29689,28497,29178,27304,26742,26853,27669,195932
91325,33558,33197,32823,33121,33268,32497,32417,230881
91326,36168,36921,36024,35900,35691,34468,33708,248880
91330,3328,3231,2708,2138,1470,794,2702,16371
91331,101536,102266,102367,100535,96965,97523,103689,704881
91335,80161,78230,77952,76616,74641,75267,74363,537230
91340,35681,35481,35455,35161,35207,34516,34188,245689
91342,95222,93466,91701,89686,89001,87707,91725,638508
91343,64323,64149,61976,62321,60759,59886,60254,433668
91344,53290,54566,53165,52892,53014,53134,51747,371808
91345,18763,18276,18196,18254,18654,18629,18496,129268
91350,37400,36520,35826,35410,34293,32449,33348,245246
91351,33247,33071,32433,31773,31936,31596,32362,226418
91352,47079,47543,46874,46334,45494,46561,47807,327692
91354,30058,29340,29034,29487,28392,28330,28722,203363
91355,33129,34188,33635,32282,33203,32104,32605,231146
91356,29728,29467,29847,30090,29590,29905,29458,208085
91360,43222,43948,44208,43767,42937,42083,42402,302567
91361,20808,20831,20266,20631,19731,20193,20438,142898
91362,35862,35546,35564,35093,35485,35267,36045,248862
91364,27607,27100,26975,25971,25947,25087,25851,184538
91367,42319,42578,42029,40506,40323,39503,39499,286757
91371,0,0,0,0,0,0,1,1
91377,14885,15087,14512,14564,14423,14045,13811,101327
91381,20790,20405,20296,19800,19673,18597,20158,139719
91384,29676,29788,28949,29189,29155,29617,29855,206229
91387,44106,43502,42518,41058,40375,39991,40328,291878
91390,20546,20473,19691,20875,20050,19348,19786,140769
91401,41019,41217,40503,39466,40085,38600,39285,280175
91402,71765,71894,70781,71486,70749,70676,69817,497168
91403,24579,24613,24353,23672,23377,23551,23484,167629
91405,54356,53347,53406,54435,54185,53395,51145,374269
91406,55385,54364,53528,52682,53129,52955,51558,373601
91411,25290,25370,24146,24546,23708,23520,24628,171208
91423,34140,33347,32130,31466,30946,30268,30991,223288
91436,14353,13970,14563,14147,14508,14294,14372,100207
91501,20110,20855,19829,20398,20546,20860,20849,143447
91502,12080,12011,12605,11420,11340,11134,11371,81961
91504,26833,25469,25544,25228,25527,25370,24939,178910
91505,30985,31273,31133,31636,30563,29835,30778,216203
91506,18125,18272,18428,18260,18906,19039,18904,129934
91601,39318,38754,38781,37807,37090,35830,37180,264760
91602,18615,18304,18315,17771,17115,17342,17473,124935
91604,30386,30269,29072,28468,28323,27107,29034,202659
91605,55377,55665,56060,55793,55313,54052,56343,388603
91606,45040,44773,45467,45788,46880,45897,44958,318803
91607,31405,30231,29591,28993,28821,28346,27927,205314
91608,0,0,0,0,0,0,0,0
91701,40870,40546,40822,40270,40553,40394,38976,282431
91702,61968,61170,60475,60036,60284,59967,59705,423605
91706,77667,77877,77692,77192,77028,77012,76571,541039
91708,2893,3445,3447,3585,3840,3854,3369,24433
91709,77266,76796,76187,75551,75211,74765,74796,530572
91710,87071,84812,83042,81596,80801,79755,80358,577435
91711,36957,36651,36484,36011,35857,35460,35705,253125
91722,35407,35798,36352,35370,35408,35400,34409,248144
91723,19258,19428,20010,19778,18713,18753,18275,134215
91724,26190,26479,25405,25407,24935,24784,26184,179384
91730,68807,67613,66979,66362,65610,63925,66925,466221
91731,30179,30418,29209,29744,29703,29279,29591,208123
91732,62855,62872,63849,62548,61832,62661,61386,438003
91733,44622,44313,43790,43593,43902,43459,43896,307575
91737,25508,25619,24759,24138,24254,24872,24740,173890
91739,38681,38490,38009,37242,35770,34016,34794,257002
91740,26555,26745,26324,25961,26115,25235,25356,182291
91741,25780,25693,25678,25540,25282,25667,25824,179464
91744,86638,87337,87096,84674,83182,83241,85040,597208
91745,54043,55184,55237,55776,56370,55723,54013,386346
91746,31319,30034,29420,28869,31086,31680,30485,212893
91748,46565,46732,47859,46966,46946,47076,45406,327550
91750,34156,34052,33969,34045,33906,33800,33249,237177
91752,29801,29525,28649,30073,29664,28618,30047,206377
91754,33514,34009,33622,33616,33052,32778,32742,233333
91755,27487,27076,27305,26945,27334,27442,27496,191085
91759,417,389,369,363,274,284,476,2572
91761,59933,60103,59892,58919,59844,59903,56913,415507
91762,58223,57402,56148,55982,54406,55801,55857,393819
91763,37786,37784,37432,37191,36739,36725,36375,260032
91764,54303,53820,54078,53688,54397,53055,54086,377427
91765,47493,47598,47562,47273,47433,47017,46457,330833
91766,72100,72026,71851,71541,70447,70842,71599,500406
91767,49483,49099,49027,48768,49808,49461,48068,343714
91768,36365,36444,36454,36142,36191,35525,34537,251658
91770,63552,63758,63119,62489,61836,61869,62097,438720
91773,34222,34107,33869,33441,33273,33269,33119,235300
91775,25389,25486,25395,25363,24775,24677,23988,175073
91776,37843,38127,37378,37246,37716,37634,38475,264419
91780,35674,35280,35274,34890,34877,34139,34332,244466
91784,25999,26140,26034,26464,26457,27285,25938,184317
91786,52951,52365,52152,51381,51439,50650,51165,362103
91789,43973,43805,43369,42609,42332,42292,43079,301459
91790,46374,46566,46059,46404,44631,44720,44907,319661
91791,33484,33247,33174,31796,32226,32170,32414,228511
91792,29493,30063,30102,30452,31338,30560,30854,212862
91801,55265,54565,53792,54176,53964,53135,52735,377632
91803,29502,30118,30586,29591,29571,30197,30322,209887
91901,18586,18507,18184,17123,17034,16606,17403,123443
91902,19429,18813,19504,18579,17659,17399,17653,129036
91905,1539,1139,1370,1099,1088,955,1700,8890
91906,3565,3466,3644,4071,3679,3511,3627,25563
91910,76027,77302,76797,77320,73761,71887,75802,528896
91911,84241,84122,83710,81872,82708,79518,82999,579170
91913,47494,45430,43655,40954,40698,40633,40971,299835
91914,16865,17406,16926,17516,16200,16741,15448,117102
91915,30679,28209,27290,26271,25172,24329,24659,186609
91916,1542,1611,1580,1487,1566,1491,1622,10899
91917,937,932,896,884,560,648,992,5849
91931,474,486,331,489,377,449,592,3198
91932,26801,26555,26257,25827,25640,25334,25718,182132
91934,274,267,293,239,364,477,737,2651
91935,8347,8335,8426,8238,8171,8387,8624,58528
91941,33077,33111,33474,32413,31582,31762,31779,227198
91942,39795,39804,39438,38828,38719,38314,38069,272967
91945,26673,26486,26027,25719,25523,25343,25460,181231
91948,13,44,47,45,57,43,78,327
91950,62078,61774,61262,60784,60283,60003,60322,426506
91962,2190,1998,1722,1377,1071,1027,1646,11031
91963,988,1256,1043,1091,1193,1424,1118,8113
91977,62065,62072,59481,60542,60769,58402,58368,421699
91978,9804,9793,9812,9276,9003,8871,8896,65455
91980,595,709,631,195,258,359,165,2912
92003,4905,4267,4306,4157,4000,3841,4746,30222
92004,2520,2709,2624,2679,2637,2847,3881,19897
92007,11929,12131,11782,11273,11135,11094,10429,79773
92008,26968,26896,26464,26536,26746,26343,27649,187602
92009,44330,43837,43627,42649,41210,39781,40747,296181
92010,15551,15598,15283,14968,14695,14194,14382,104671
92011,24899,24476,23883,23120,22416,21982,22405,163181
92014,13665,13708,13525,13403,13247,13333,13154,94035
92019,43200,43873,44357,44406,43676,42914,42598,305024
92020,58554,58940,58305,57747,56807,56836,57767,404956
92021,69552,67608,66854,65175,64441,63397,65068,462095
92024,50246,49566,49226,49048,48725,48214,49121,344146
92025,53742,51859,49734,49110,48567,47937,49978,350927
92026,49327,50412,49981,49537,49309,48713,48922,346201
92027,56899,56875,56892,55461,55129,54956,53881,390093
92028,48468,47807,48335,47282,48103,47278,46239,333512
92029,18758,18717,19528,20198,19823,20170,19021,136215
92036,2700,3173,2977,2807,3202,2733,3440,21032
92037,38659,37718,39241,40114,41746,43149,46781,287408
92040,43191,43269,42323,41214,42232,41024,41281,294534
92054,42523,42195,42992,42751,42688,42829,40375,296353
92055,12926,13091,12725,12457,13130,12107,15655,92091
92056,53920,54069,52758,52182,51142,50765,51835,366671
92057,57125,56764,55618,54901,54274,53061,54096,385839
92058,46463,44825,45685,45943,45685,44141,42436,315178
92059,1177,1310,1450,1374,1301,1473,1618,9703
92060,79,68,61,74,162,212,218,874
92061,2046,1642,1824,2113,2301,2678,2499,15103
92064,49763,49587,49079,48622,48208,47942,47904,341105
92065,37633,36637,36039,37299,36341,36840,35414,256203
92066,530,516,273,233,277,363,378,2570
92067,9127,9147,9020,8068,7524,7576,9535,59997
92069,48682,49135,47130,46492,45362,45316,46369,328486
92070,1034,1151,1193,1165,1244,1243,1245,8275
92071,56682,56158,55362,54469,53841,53302,53422,383236
92075,12548,12491,12437,12345,12104,12083,12056,86064
92078,48009,45984,45926,44007,43220,41589,42906,311641
92081,28976,29038,28843,27785,27598,27927,27404,197571
92082,18722,19541,19825,20559,19302,19420,19037,136406
92083,37367,36431,36604,37282,36915,36247,36975,257821
92084,50915,50377,48275,46811,47077,46982,47654,338091
92086,1672,1538,1335,1343,1191,1188,1573,9840
92091,1473,1428,1433,1383,1268,1040,1048,9073
92101,36857,36295,35893,35914,35373,33886,37095,251313
92102,44778,45461,44893,43853,43354,42715,43267,308321
92103,33873,33241,31927,31064,30226,30324,31066,221721
92104,45788,44756,44590,45471,44723,43714,44414,313456
92105,72724,71832,71334,68469,67482,65746,69813,487400
92106,18864,18415,19539,20087,19971,19217,19330,135423
92107,29292,28360,26947,26535,26746,27264,28651,193795
92108,20899,20548,19245,18794,18390,17828,18858,134562
92109,48430,46797,45304,44012,43857,44095,45787,318282
92110,28508,28789,28006,27444,27254,26673,25341,192015
92111,48380,49375,47590,47271,46072,44737,45096,328521
92113,57887,57737,57580,58158,55782,55206,56066,398416
92114,69688,69798,69305,68160,68524,66461,65433,477369
92115,64410,62308,61718,61084,60054,59978,58560,428112
92116,32920,33110,32943,32218,31828,31847,31680,226546
92117,54489,53477,53205,52648,52375,52612,51332,370138
92118,23473,22939,22664,21247,19771,18838,23575,152507
92119,23456,24265,23926,22965,23327,23772,23057,164768
92120,28518,27135,25365,25131,25463,26430,26317,184359
92121,4588,4503,4832,4580,4580,4398,4179,31660
92122,47314,46104,44602,45556,46217,44768,43728,318289
92123,30202,29955,29240,28943,27437,27565,26823,200165
92124,31061,30135,30196,30742,31024,31360,30443,214961
92126,80685,79589,78201,77860,76797,76373,73343,542848
92127,43588,43033,41900,40246,40237,39425,39337,287766
92128,49522,48906,49264,49332,48438,47934,47490,340886
92129,55780,54735,54664,53387,53218,52942,51536,376262
92130,51757,51262,50280,48721,47599,47527,48940,346086
92131,34425,34039,33868,33672,34306,34073,32787,237170
92132,0,0,0,0,0,0,0,0
92134,216,199,151,101,62,30,198,957
92135,851,953,955,688,1358,793,571,6169
92139,36720,36934,37450,36594,36528,35249,35125,254600
92140,3112,2977,2594,2514,2661,3854,3435,21147
92145,2096,2145,1968,1529,1381,1014,1449,11582
92147,569,567,562,514,459,412,559,3642
92154,88016,88292,86740,84060,81952,79755,79708,588523
92155,528,555,714,775,839,843,550,4804
92173,32416,32355,31518,31031,28723,28055,29429,213527
92201,64436,64238,63915,62551,63009,61304,61827,441280
92203,29768,29131,27466,26183,24850,24016,25605,187019
92210,4987,4946,4839,4876,4861,4797,4677,33983
92211,24623,24558,24564,23729,24477,24271,24294,170516
92220,33101,32461,32793,32134,31860,31563,31638,225550
92222,0,0,0,0,0,0,45,45
92223,49804,47970,46719,44458,42408,40779,43605,315743
92225,22242,22763,23509,23624,24292,25016,24310,165756
92227,27120,27013,26818,26438,26310,26079,26234,186012
92230,4088,3669,3297,2699,2121,1741,2550,20165
92231,40070,40027,39675,39245,38700,37694,39073,274484
92233,7770,7869,10460,10578,10520,10045,8099,65341
92234,53253,53005,52534,51927,51507,51130,51151,364507
92236,44124,43654,43037,41815,40881,39743,41083,294337
92239,196,207,428,383,345,284,223,2066
92240,35684,36206,35878,35078,33178,32695,34722,243441
92241,9212,10209,9156,9378,9823,8619,8803,65200
92242,1332,1247,1235,1313,1329,1331,1539,9326
92243,49425,49514,48615,48190,47762,47445,48030,338981
92249,7960,7686,7147,7103,7277,7347,7334,51854
92250,8645,8557,8461,8424,8692,8638,8285,59702
92251,22496,22827,22348,21858,21416,21119,21583,153647
92252,8874,8833,9228,10047,9680,9430,9647,65739
92253,39435,38958,38462,37750,37101,36322,37262,265290
92254,12491,13626,12300,11366,11181,10996,12768,84728
92256,3105,3266,3631,3664,3736,3632,3588,24622
92257,1770,1666,1757,1962,2044,1978,2326,13503
92258,435,473,520,397,529,665,861,3880
92259,197,326,269,366,334,305,390,2187
92260,33834,33275,32855,32452,31365,31399,31753,226933
92262,27561,27102,26693,25852,25302,24827,26179,183516
92264,19778,19836,19754,20240,20397,20885,19383,140273
92266,97,100,62,47,73,144,234,757
92267,0,0,0,0,35,34,126,195
92268,505,470,605,561,511,563,574,3789
92270,17876,17770,17634,17456,17215,17022,17220,122193
92273,1661,1356,1228,1295,1430,1691,1823,10484
92274,19326,19918,18937,18780,18405,18184,19801,133351
92275,2174,1738,1413,1122,1239,1173,1506,10365
92276,7803,8180,7921,7429,7541,7564,7585,54023
92277,24028,24363,24112,23691,23642,23463,23911,167210
92278,4162,4079,4156,4441,4567,4835,3846,30086
92280,16,14,15,0,0,0,14,59
92281,2249,1985,1960,1773,1779,1872,2432,14050
92282,1233,910,783,668,735,879,1239,6447
92283,2287,2406,2334,2670,2807,2935,3158,18597
92284,25850,25680,25045,24951,24685,24896,25095,176202
92285,2556,2579,2731,2739,2441,2667,2632,18345
92301,32801,32639,32667,32222,31907,32014,32725,226975
92304,21,23,17,17,47,38,17,180
92305,519,391,321,295,312,146,535,2519
92307,38583,38379,38204,37265,36891,36875,37630,263827
92308,40285,40180,39953,39987,40217,39109,39837,279568
92309,742,835,916,837,730,713,763,5536
92310,9337,9238,9191,9049,9581,9781,8845,65022
92311,33962,33676,32831,32724,32859,32774,31894,230720
92313,12432,12371,12252,12169,12140,12132,12025,85521
92314,11997,11469,10572,10235,9785,9433,10162,73653
92315,5282,5269,5236,5213,5150,5109,5094,36353
92316,30231,31789,31720,31151,31768,31232,30830,218721
92320,8364,8211,8097,7940,7818,7770,7788,55988
92321,1214,1157,1244,965,1004,789,1522,7895
92322,696,888,911,811,598,864,1257,6025
92324,58854,58684,58013,57326,56471,56103,56505,401956
92325,8019,8211,8318,8053,8174,7707,9391,57873
92327,544,886,1202,1291,1253,1253,632,7061
92328,292,288,281,285,263,249,445,2103
92332,3,8,7,8,6,8,65,105
92333,217,462,640,635,644,663,472,3733
92335,99079,98442,99580,98460,98228,97773,95397,686959
92336,92306,92781,91510,90633,89922,88670,88419,634241
92337,39074,38547,37844,37474,36609,35737,37849,263134
92338,0,0,0,0,0,0,12,12
92339,1171,1028,997,984,1046,849,885,6960
92341,231,287,294,326,263,233,410,2044
92342,7058,6593,6303,6800,5946,5207,6379,44286
92344,22259,21386,21392,20116,19986,20336,20769,146244
92345,81094,80709,81049,80683,79070,76950,78715,558270
92346,60320,59501,58845,57499,57365,56748,54923,405201
92347,1372,1672,1554,1696,1791,1551,1692,11328
92352,6601,6800,6783,6410,6294,6545,8004,47437
92354,20963,20829,21555,21427,21475,21196,21559,149004
92356,5995,6211,6293,6504,6155,6310,6455,43923
92358,1069,1111,1127,986,1068,735,707,6803
92359,8710,8718,8298,8087,7397,7425,8103,56738
92363,5356,5355,5355,5242,5156,5183,5321,36968
92364,0,32,30,57,53,60,90,322
92365,2601,2024,1953,2308,2552,2972,2637,17047
92368,937,970,1064,930,1030,1095,1113,7139
92371,16721,15846,14729,14729,14727,14618,16763,108133
92372,5763,5987,5929,4920,4859,5287,6220,38965
92373,35149,34766,34017,33891,33279,33506,33423,238031
92374,41452,41276,40911,40605,40494,40472,40267,285477
92376,85857,86021,85647,84699,83613,83759,81516,591112
92377,20370,20016,19750,19137,19698,19867,19989,138827
92378,154,192,166,135,139,140,183,1109
92382,5006,5247,5161,5577,5519,5428,5268,37206
92384,24,33,34,56,59,42,36,284
92385,296,202,269,274,181,223,313,1758
92386,1992,2105,1949,1866,1858,2086,2270,14126
92389,133,128,115,108,82,98,156,820
92391,3227,3123,3001,2693,2335,1909,2534,18822
92392,57648,56178,56461,54557,52312,51454,54858,383468
92394,36017,36141,34479,35027,34350,32351,33237,241602
92395,41384,42007,42481,42364,43378,42322,42400,296336
92397,4853,4753,4616,4497,4833,4757,4894,33203
92398,1588,1515,1165,949,1068,1175,1379,8839
92399,54335,54227,54056,53370,53219,52219,52606,374032
92401,1885,2015,2104,2076,1952,2150,1932,14114
92404,58738,59577,60501,61918,60222,60073,58271,419300
92405,29897,28831,29526,29967,31075,31080,28873,209249
92407,64225,62439,60118,58275,55780,56774,56689,414300
92408,15788,15661,15318,14548,14077,14277,15271,104940
92410,48660,48011,47510,47192,48069,46272,49410,335124
92411,26437,27282,26364,25822,25443,25300,26214,182862
92501,21975,22114,22216,22211,21887,22186,20970,153559
92503,94029,94431,92959,90989,89783,89679,84519,636389
92504,57004,53772,53960,54221,53194,53676,53778,379605
92505,49705,49319,49064,49435,48803,48132,47672,342130
92506,46172,46048,45993,44704,44129,44064,44001,315111
92507,57347,56231,55156,54152,53791,52094,58002,386773
92508,38360,38443,36583,35937,35278,33685,35000,253286
92509,80480,78446,78221,78117,78700,77798,75196,546958
92518,1145,1004,1129,1049,968,791,1162,7248
92530,54710,53606,51816,50141,48687,48418,50216,357594
92532,22248,22213,21260,20383,19713,17262,18644,141723
92536,2811,2842,2750,3454,3613,3829,3810,23109
92539,3775,4220,3890,3887,4284,4719,4734,29509
92543,36962,36603,34680,34406,34054,34674,33555,244934
92544,47275,47507,47136,45256,45080,44885,44734,321873
92545,40732,40386,41078,39770,38642,37241,39457,277306
92548,7577,6939,7020,7017,6849,7130,6643,49175
92549,2644,2702,2652,2157,1993,2309,3926,18383
92551,33670,33573,33050,30468,29230,29973,30815,220779
92553,74925,74320,73803,75024,75136,73633,73722,520563
92555,42264,41438,40419,39748,38751,37745,39076,279441
92557,51551,51810,51871,51196,51001,50049,50320,357798
92561,1577,1475,1600,1509,1332,1553,1661,10707
92562,64222,62912,63293,62070,61376,58727,62079,434679
92563,60651,59463,57605,56252,53655,52827,53892,394345
92567,10205,10442,9469,8906,8634,7891,9459,65006
92570,59324,56738,56766,54115,53722,53510,53697,387872
92571,54512,54366,54825,53820,51614,50051,52516,371704
92582,16695,16446,16200,16580,16166,14568,15649,112304
92583,32051,31818,31167,30029,29431,29797,30236,214529
92584,49317,47887,46346,45510,43203,42396,43400,318059
92585,21714,20623,20148,19222,18071,17015,17797,134590
92586,19351,19150,19384,19091,19556,19581,19815,135928
92587,17157,17514,16787,16081,16169,15832,16675,116215
92590,3951,4207,3841,3529,3676,3355,3660,26219
92591,40396,39753,39767,39092,38723,38325,38272,274328
92592,80135,77420,74558,72760,70726,68889,72492,516980
92595,31541,31426,31139,30448,30209,29855,29851,214469
92596,25363,26219,26044,24297,23815,24314,23172,173224
92602,24962,24234,23529,22239,22051,21191,22871,161077
92603,20206,20083,20173,20172,19215,18805,20184,138838
92604,28580,29039,28425,27942,27453,26649,26853,194941
92606,23129,23378,22294,21740,21252,20760,21495,154048
92610,11895,11862,11799,11250,11555,11811,11248,81420
92612,31166,30314,29325,28040,26386,25363,27522,198116
92614,25930,26046,25657,25131,24538,23585,24748,175635
92617,16942,16565,15805,16388,16855,16149,14044,112748
92618,29921,25043,21345,18617,16614,14899,16366,142805
92620,46966,44763,43802,41443,39927,37865,38486,293252
92624,6454,6830,6450,6258,7237,7531,7248,48008
92625,12187,12098,12572,11975,12442,12759,12478,86511
92626,51133,51818,51575,51904,50759,50230,49341,356760
92627,61996,61314,60806,59488,60167,60152,61510,425433
92629,26797,26680,26955,27173,26182,25910,25756,185453
92630,61081,60449,59657,59401,59083,58156,59182,417009
92637,16330,16342,16284,16251,16325,16246,16012,113790
92646,55598,55584,55505,55184,55367,56179,55224,388641
92647,61285,60898,59741,58081,57117,56112,57245,410479
92648,47701,47415,46623,45598,45360,45000,45317,323014
92649,33513,33166,32976,33470,32694,33130,32463,231412
92651,24612,24291,23668,23559,23636,23679,23881,167326
92653,29028,29037,28853,28607,29473,29358,29291,203647
92655,9257,9485,9139,9231,8544,7716,8337,61709
92656,52335,51826,51370,50820,49067,48216,49046,352680
92657,9768,10238,9751,10078,10136,9710,9741,69422
92660,35935,35677,35308,34068,33671,33508,34797,242964
92661,3419,3128,3152,3840,3931,4233,3744,25447
92662,2863,2894,3018,2903,2931,2761,2756,20126
92663,22408,22629,22772,23141,22163,21455,21649,156217
92672,34605,35344,35041,35224,34445,34210,34464,243333
92673,30553,29803,29875,29263,28819,27922,29309,205544
92675,36548,35970,35596,35192,34829,34524,34731,247390
92676,2156,1993,2033,2146,2254,2112,1945,14639
92677,65645,65238,64642,63797,63446,62855,63297,448920
92678,532,495,427,436,514,591,494,3489
92679,32819,32885,32822,33377,33034,32974,32611,230522
92683,91613,91734,91204,90640,90074,89522,89747,634534
92688,45105,45226,45074,44767,44302,43852,43792,312118
92691,49471,48944,48129,47275,47295,46753,47582,335449
92692,48851,48785,48967,48739,47672,47385,47222,337621
92694,25906,25464,24568,22527,21448,20510,21944,162367
92701,51317,51520,52588,54117,53979,54353,53908,371782
92703,71245,70116,69890,69952,68926,67936,65445,483510
92704,89993,89304,87121,87208,86136,87910,88123,615795
92705,47515,46713,46163,45815,44945,43942,44706,319799
92706,36684,37180,36585,36287,36660,36013,36457,255866
92707,61667,63082,63595,60288,60495,59304,59492,427923
92708,57675,57508,57441,56510,55914,55554,56004,396606
92780,62017,61209,60438,58755,58181,57542,57741,415883
92782,23174,23182,22583,22889,22588,21978,23032,159426
92801,66657,65595,63883,62859,61627,61500,62068,444189
92802,42583,43250,43743,42502,42032,42797,42709,299616
92804,86220,84504,85969,84648,85174,85386,85914,597815
92805,73043,72637,70839,71568,72033,70267,70401,500788
92806,40296,40989,39616,39468,38300,35983,37173,271825
92807,35284,35285,36323,36027,35738,35999,36171,250827
92808,20427,20449,20137,20495,20384,20738,20039,142669
92821,37642,37615,37580,37254,36275,35308,35533,257207
92823,3769,3400,2960,2761,3048,3327,3613,22878
92831,36533,36249,35316,34970,34693,33851,34204,245816
92832,25601,25166,25247,25264,24694,24833,24752,175557
92833,53227,53271,53309,52232,52609,51958,51767,368373
92835,23464,23567,23378,23477,23055,23107,24010,164058
92840,56256,56917,56291,55513,53943,52846,54083,385849
92841,34031,33717,32839,32512,31890,32075,32845,229909
92843,45211,43928,44468,44351,45341,44127,45214,312640
92844,23585,24804,24314,24614,24523,25355,24307,171502
92845,17276,17221,17202,17125,16774,16762,16333,118693
92860,26822,27091,27304,27177,27235,27256,27198,190083
92861,5872,5901,5911,5842,5809,5784,5781,40900
92865,20643,20554,19715,19529,19358,17923,19704,137426
92866,15760,15490,15473,15213,15017,15035,14885,106873
92867,44868,44991,44569,44148,43557,42702,44515,309350
92868,27232,26817,27353,27149,26279,26192,25404,186426
92869,36298,37124,37390,38001,39167,39963,37184,265127
92870,53690,53772,53474,52794,52510,51648,52033,369921
92879,46487,47452,48654,48327,46912,45657,46745,330234
92880,66557,63696,61187,66353,65093,61035,58763,442684
92881,34466,33490,32817,32048,30846,30656,30991,225314
92882,71024,70676,70188,68885,68715,67830,67917,485235
92883,32549,32167,31940,30364,29549,29265,29301,215135
92886,49644,49565,48649,47786,46907,45398,46564,334513
92887,20529,20292,20071,19700,19654,20102,20006,140354
93001,33765,33899,32360,32094,32464,32940,32990,230512
93003,51041,50701,51454,50446,50113,50062,50474,354291
93004,30218,30268,30417,30737,29698,28485,29149,208972
93010,44761,44422,43234,43924,43358,42352,42901,304952
93012,35714,35272,35366,34964,34339,34263,34617,244535
93013,16603,16259,15944,16156,15867,15844,16091,112764
93015,17487,17253,17423,17440,17484,17571,17334,121992
93021,37093,36873,36407,35847,35720,35263,36422,253625
93022,7154,7122,7069,6726,6698,6146,6106,47021
93023,20168,20313,20603,20512,20601,20688,20589,143474
93030,60582,61102,61215,59435,59298,57414,59372,418418
93033,83103,83057,82263,81644,80492,80209,82728,573496
93035,28258,27626,26966,27207,27767,28146,27732,193702
93036,46328,44716,44277,43568,42133,41567,41691,304280
93040,1980,2044,2037,1914,1699,1548,2031,13253
93041,24351,24197,23998,23874,24075,24309,23641,168445
93042,104,110,82,64,47,24,56,487
93043,163,305,116,0,0,0,333,917
93060,33837,34060,33836,33489,33380,33103,32811,234516
93063,56637,56500,56687,55846,55662,54866,54366,390564
93064,0,0,0,0,0,0,40,40
93065,72211,72676,72273,71899,71505,71661,72508,504733
93066,3082,3222,3179,3240,3048,3113,3102,21986
93067,690,735,641,543,622,666,895,4792
93101,32157,32458,32860,32523,32327,31543,31683,225551
93103,20827,20448,20271,20607,20931,20724,20249,144057
93105,25808,25632,24967,24379,24719,24511,24815,174831
93108,11345,11761,12119,11446,11201,11735,11112,80719
93109,11583,11089,11031,10443,9838,10227,10858,75069
93110,16777,17382,17321,17572,17020,16801,16829,119702
93111,18441,18440,17554,17313,16901,17177,17370,123196
93117,57268,56386,55064,54251,54182,53028,53217,383396
93201,1314,1317,1173,1084,1014,1093,1348,8343
93202,3570,3744,3486,3738,3623,3585,4143,25889
93203,22106,22079,21784,21208,20774,20554,20938,149443
93204,13590,14154,14553,15001,15341,15705,15529,103873
93205,1630,2066,2065,2190,1900,2050,2113,14014
93206,1978,2211,2196,2240,2053,2134,2300,15112
93207,252,284,263,304,281,227,263,1874
93208,74,130,125,142,139,96,104,810
93210,18617,19101,21303,21846,21293,17756,19504,139420
93212,24861,24920,25204,25618,25588,25937,26079,178207
93215,55494,56046,56028,56141,55355,55398,55659,390121
93218,1068,1037,1009,845,890,850,994,6693
93219,10266,10667,10378,9570,9097,8801,10194,68973
93220,381,381,265,255,59,28,211,1580
93221,15109,15000,15391,15488,14691,14519,14945,105143
93222,1542,1604,1681,1555,1535,1472,2099,11488
93223,10699,10704,10759,10695,10632,10579,10604,74672
93224,432,412,429,459,486,503,451,3172
93225,4886,5391,5572,5373,4665,4722,5077,35686
93226,211,317,363,382,383,412,282,2350
93230,66109,66108,66316,65927,66186,65664,65264,461574
93234,6865,6863,6896,6936,6952,7026,6987,48525
93235,4014,3837,4044,3924,4864,4614,4559,29856
93238,1550,1664,1575,1653,1496,1625,1490,11053
93239,1704,1840,1950,1720,1604,1502,1688,12008
93240,6489,5797,5667,5100,5308,5818,6056,40235
93241,17233,17765,18474,18541,18542,18119,17489,126163
93242,3748,3372,3230,3267,3326,3243,3468,23654
93243,1736,1565,1720,1419,1925,1808,1699,11872
93244,396,376,340,293,282,305,534,2526
93245,37502,37520,37062,36708,36544,36606,37412,259354
93247,18676,18916,18932,18417,18092,18368,17423,128824
93249,2277,2373,2698,2459,2564,2465,2739,17575
93250,14824,14056,13925,13493,13599,13661,13522,97080
93251,236,229,229,233,261,253,270,1711
93252,3437,3587,3665,3830,3752,4028,4176,26475
93254,685,813,700,611,626,629,811,4875
93255,675,639,598,627,495,338,614,3986
93256,6092,5670,6035,5591,5401,5196,5753,39738
93257,75715,75959,75390,76470,76627,75451,75004,530616
93258,2650,2277,2292,1854,1650,1455,2046,14224
93260,199,135,175,162,149,137,200,1157
93261,3221,3150,3248,3317,3263,2895,3099,22193
93262,74,73,59,45,32,19,63,365
93263,20346,20098,20204,19613,19384,19130,19582,138357
93265,3290,3137,2892,2879,3273,3438,3699,22608
93266,1271,1171,1465,1378,1450,1655,1587,9977
93267,6817,6585,6962,7010,6739,6993,6237,47343
93268,17643,17387,16890,17143,16776,16891,16897,119627
93270,5654,5336,5519,5615,5424,5649,5837,39034
93271,2001,2185,2278,2155,2285,2218,2276,15398
93272,4117,3816,3438,3396,3114,3202,3583,24666
93274,72264,71853,71430,70820,69896,68532,69721,494516
93276,216,206,176,148,160,102,161,1169
93277,52526,51377,51849,51604,51125,50853,50607,359941
93280,27572,27375,27390,27162,27029,26732,27152,190412
93283,2339,2353,2313,2319,2090,1936,2040,15390
93285,1700,1709,2218,2005,2173,2446,2536,14787
93286,10169,9931,9942,9950,9650,9482,9548,68672
93287,115,115,141,112,133,126,119,861
93291,56298,55990,54899,53742,53123,51573,52849,378474
93292,39089,39767,38825,38107,37472,37371,39032,269663
93301,11555,11557,11685,11396,11421,12138,12248,82000
93304,51891,52172,51607,52421,51208,50801,48731,358831
93305,38793,38291,37871,37194,37204,36878,37601,263832
93306,69660,69242,68910,67322,67736,65735,64587,473192
93307,84667,85957,84184,82472,81404,79117,82658,580459
93308,54497,54128,54132,53639,53514,52993,52447,375350
93309,59492,60380,60631,59489,59051,58934,58409,416386
93311,45512,44874,44358,42591,41234,39076,40829,298474
93312,58102,57579,56313,55539,54750,53979,56741,393003
93313,49006,45862,43644,44571,44122,42406,43553,313164
93314,26197,24537,23264,22535,22084,21591,22393,162601
93401,28684,28431,27920,28571,28311,27618,28033,197568
93402,15636,15424,14880,14260,14949,15014,14318,104481
93405,35642,35021,34833,33567,33655,33485,35440,241643
93410,0,0,0,0,0,0,0,0
93420,30022,30444,30076,30401,29710,29480,28413,208546
93422,33270,32191,31899,31349,31178,30777,31375,222039
93424,867,956,853,853,913,805,1261,6508
93426,1988,1549,1522,1372,1193,1086,1401,10111
93427,5662,5410,5279,5370,5394,5229,5505,37849
93428,6309,6396,6348,6393,6400,6499,6314,44659
93429,140,116,114,94,238,224,154,1080
93430,3214,2933,2735,2733,2710,3094,2972,20391
93432,953,880,798,1041,1125,1050,1384,7231
93433,13484,13409,13337,13269,13212,13189,13162,93062
93434,7252,7243,7178,7123,7030,6914,7110,49850
93436,55914,55329,55176,54433,54355,54014,54017,383238
93437,3483,3317,3464,3693,3632,3886,3338,24813
93440,1507,1813,1472,1680,1723,1641,2058,11894
93441,1099,1251,1195,1212,1230,1174,1530,8691
93442,11092,11035,10998,10896,10811,10803,10789,76424
93444,19317,19173,19578,19712,19269,18948,19244,135241
93445,8164,7659,7168,7248,7233,7123,7173,51768
93446,44515,44844,44288,43356,42613,42527,43714,305857
93449,7984,7890,7789,7746,7721,7753,7657,54540
93450,988,929,814,791,770,722,740,5754
93451,4184,4112,4187,4212,4261,4231,3779,28966
93452,552,500,721,609,579,641,524,4126
93453,3170,3701,3486,3575,3485,2998,2899,23314
93454,38980,37651,37362,36509,35731,34666,36448,257347
93455,43898,42780,42513,42919,41889,40718,41684,296401
93458,56722,57081,56514,55651,55458,55328,55431,392185
93460,4798,4802,4944,5348,5112,5633,5255,35892
93461,1447,1572,1661,1589,1402,1397,1623,10691
93463,7905,7911,8132,7822,7846,7712,7646,54974
93465,8995,8827,9652,9738,10085,9962,9153,66412
93501,5134,5125,5258,5411,5042,5233,5467,36670
93505,13324,13165,13232,13324,13347,13658,14038,94088
93510,7594,7462,7289,7216,7153,7236,7993,51943
93512,352,333,178,143,110,61,277,1454
93513,1803,1732,1584,1541,1516,1430,1763,11369
93514,13976,14254,14472,14250,14511,14978,13857,100298
93516,2314,2326,2271,2347,2046,2355,2299,15958
93517,909,929,796,591,424,516,670,4835
93518,949,954,986,1131,1098,1139,1146,7403
93519,36,67,97,89,96,91,101,577
93522,35,24,18,15,35,32,48,207
93523,3366,3469,3378,2926,3002,3021,3074,22236
93524,171,177,263,454,668,793,229,2755
93526,703,726,714,713,611,591,719,4777
93527,2206,1876,1914,2125,2335,2265,2387,15108
93528,127,118,79,49,183,179,172,907
93529,631,512,589,419,418,406,633,3608
93530,29,34,28,56,54,20,47,268
93531,369,363,338,409,357,336,509,2681
93532,2681,2557,2419,2476,2736,2800,2932,18601
93534,38994,38431,39120,39563,38655,37983,39341,272087
93535,73948,73979,73282,73606,72231,70008,72046,509100
93536,70969,71254,71313,69988,70599,69120,70918,494161
93541,500,519,651,766,581,554,449,4020
93543,13780,13720,13578,13251,12160,12639,13033,92161
93544,1021,1145,951,944,912,1095,1259,7327
93545,2005,2006,2099,2214,2256,2155,2082,14817
93546,9252,9147,9408,9681,9625,9207,9567,65887
93549,250,215,334,364,364,396,344,2267
93550,75624,75088,74203,74561,74389,72388,74929,521182
93551,51023,50100,50572,50306,49372,49896,50798,352067
93552,41128,42630,42073,39943,39396,38178,38158,281506
93553,1882,1784,1975,2242,2169,2130,2138,14320
93554,156,140,128,116,30,26,72,668
93555,34064,33580,32967,32376,32021,31755,32560,229323
93558,236,284,267,249,50,66,125,1277
93560,20263,20209,19189,19371,18496,18639,18910,135077
93561,34182,33823,34246,34851,35446,35542,34630,242720
93562,1620,1712,1781,1877,1943,2047,1818,12798
93563,413,387,375,344,292,353,388,2552
93591,6508,6781,6558,6483,6503,6935,7285,47053
93592,41,8,20,16,85,79,64,313
93601,1944,1917,2457,2050,1882,1741,1909,13900
93602,4151,4264,4207,4074,3677,4192,3862,28427
93603,138,195,274,271,280,281,222,1661
93604,708,951,874,967,1186,690,674,6050
93605,211,248,201,243,218,227,175,1523
93606,849,676,604,424,373,540,1217,4683
93608,993,998,725,804,859,711,1114,6204
93609,5689,5781,5843,6282,6173,5837,5640,41245
93610,23757,23912,24151,24206,24715,24456,23833,169030
93611,47988,48736,48597,47559,46810,46034,45614,331338
93612,36062,36237,34814,34415,34804,34055,35351,245738
93614,11255,10785,10865,11245,11053,10786,11661,77650
93615,6263,6027,5923,6135,6211,6182,6042,42783
93616,2599,2146,2126,2455,2698,3054,2627,17705
93618,30465,30379,29628,29022,28525,27670,28262,203951
93619,32958,30602,30409,29476,29609,28715,28965,210734
93620,9591,9789,10028,9825,9657,9101,9591,67582
93621,194,212,307,316,322,305,464,2120
93622,10632,10350,9747,9558,9489,9261,9581,68618
93623,134,89,58,51,58,53,69,512
93624,1326,1339,1359,1377,1615,1177,1134,9327
93625,7446,7346,7068,7049,6730,6715,7313,49667
93626,1760,1153,813,773,702,730,1359,7290
93627,77,81,85,51,0,0,123,417
93628,221,196,266,240,402,472,327,2124
93630,19095,18898,18990,18407,18039,17946,19162,130537
93631,16268,16618,16844,16576,16666,15789,15941,114702
93633,0,0,0,0,33,49,25,107
93634,23,17,15,24,49,55,33,216
93635,39969,39927,39439,38929,38661,38298,38776,273999
93636,11885,12367,11919,11341,11443,11850,11908,82713
93637,39952,39596,40101,40515,39577,39827,37743,277311
93638,50626,50851,49761,48805,47823,46574,49068,343508
93640,12660,12375,12140,11902,11600,11505,11880,84062
93641,258,230,233,598,594,494,595,3002
93643,2935,2617,2724,2674,2829,3244,3171,20194
93644,7854,7702,7434,7308,7627,8353,8637,54915
93645,207,194,212,606,712,482,318,2731
93646,11195,11001,10716,10785,10960,10627,10557,75841
93647,11215,12371,11926,12320,12401,12323,11874,84430
93648,16228,16120,16102,15648,15403,15068,15719,110288
93650,4170,3987,3767,3428,4063,4137,4055,27607
93651,1662,1526,1569,1830,1653,1561,1674,11475
93652,280,237,288,415,453,373,415,2461
93653,1352,1602,1357,1115,1193,1096,1229,8944
93654,31460,31259,31575,30665,30791,30658,29776,216184
93656,7194,7358,7194,6883,6826,6994,6313,48762
93657,34349,35129,35653,35768,35083,35191,34999,246172
93660,4587,4797,4621,4582,4465,4399,4675,32126
93662,30169,30774,30700,30340,29741,29711,30237,211672
93664,494,688,703,701,687,662,585,4520
93665,943,759,612,449,349,559,472,4143
93666,968,761,683,524,243,266,692,4137
93667,2626,2556,2089,1985,2156,2403,2604,16419
93668,957,941,1215,1285,1498,1668,1118,8682
93669,209,242,284,230,200,193,295,1653
93673,747,711,910,959,967,1046,713,6053
93675,3358,3097,2808,2566,2335,2563,3721,20448
93701,10369,10555,10788,10602,11057,11183,12529,77083
93702,46021,47013,47850,48181,47667,48368,48607,333707
93703,34166,33417,34122,35127,34551,32765,31868,236016
93704,27870,27009,26009,26369,26828,26249,27156,187490
93705,38093,38379,38130,38600,38597,37665,36703,266167
93706,40583,39929,39794,38963,38448,39076,41087,277880
93710,32249,32434,33114,32701,31980,31448,30202,224128
93711,37095,37317,37630,37651,39079,39723,36731,265226
93720,46402,46411,46153,46300,46351,46908,45191,323716
93721,6898,6811,6308,6445,6570,7227,6959,47218
93722,81832,82683,80455,79727,76672,76432,76448,554249
93723,10874,10214,9271,8809,8640,9137,9547,66492
93725,26809,26632,26879,25884,25386,24553,24979,181122
93726,42950,43115,42618,41140,40627,40978,40705,292133
93727,79314,76619,73671,70774,68590,67324,71820,508112
93728,15670,15496,14711,14791,15164,15532,15743,107107
93730,11397,10286,10137,10896,10098,9391,9941,72146
93901,27387,26800,26438,26642,25823,26409,26863,186362
93905,61494,61343,60887,60905,61000,59341,61087,426057
93906,63821,63897,63529,62073,61030,59947,59461,433758
93907,22513,21901,21812,21152,21987,22251,21726,153342
93908,11986,11953,12350,12675,12878,12948,13043,87833
93920,1082,941,839,765,715,977,1369,6688
93921,3407,3355,3164,3169,2864,3118,3281,22358
93923,12301,13043,12954,13141,13362,13310,12073,90184
93924,6457,6231,5967,5882,6133,6070,6279,43019
93925,1824,1853,1672,1708,1665,1720,1671,12113
93926,9506,9402,9128,8735,8494,8149,8726,62140
93927,18609,18222,17697,17270,16976,16406,17547,122727
93928,441,431,362,308,338,381,506,2767
93930,16536,16691,16843,16234,16222,15936,15866,114328
93932,618,626,564,466,443,452,592,3761
93933,23851,23451,22696,22634,22723,22920,22406,160681
93940,32727,32785,33760,33685,31952,31668,31615,228192
93943,0,0,6,7,42,62,6,123
93950,15577,15570,15365,15241,15102,14995,15046,106896
93953,4435,4554,4578,4766,4470,4312,4509,31624
93954,362,387,246,222,244,291,302,2054
93955,34421,34311,34084,33709,33314,33027,33359,236225
93960,26831,26946,27212,27334,27057,26631,27080,189091
93962,745,761,939,878,931,803,673,5730
94002,27116,26961,26679,26483,26141,25797,25992,185169
94005,4568,4496,4421,4330,4266,4179,4282,30542
94010,42569,42452,42223,41480,40907,40296,40737,290664
94014,48387,48691,48536,47818,47866,47087,47014,335399
94015,64712,64258,62941,61591,60446,59825,60927,434700
94019,19874,19050,18382,18199,17688,17984,18424,129601
94020,1170,1206,1483,1435,1651,1819,1559,10323
94021,159,149,211,115,93,83,192,1002
94022,19705,19578,19737,19358,19310,18850,18500,135038
94024,23057,23050,22573,22349,22536,22448,22385,158398
94025,41491,41234,40945,40372,40608,39790,40526,284966
94027,7317,7244,7230,7110,7083,7028,7089,50101
94028,6830,6686,6720,6788,6633,6740,6534,46931
94030,22552,22447,22203,21867,21567,21275,21536,153447
94037,2895,2903,2880,3080,2567,2739,2913,19977
94038,3628,3607,3435,3000,2814,2439,3040,21963
94040,35200,34792,33958,33852,33918,33366,32996,238082
94041,14162,13916,13551,13219,12929,12838,13292,93907
94043,29689,29458,29280,28189,27279,26940,28358,199193
94044,38844,38735,38416,37943,37558,37286,37296,266078
94060,1697,1758,1650,1764,1561,1671,1554,11655
94061,38709,37809,37667,37176,36343,35697,36245,259646
94062,27099,27567,27014,27142,26782,26346,25876,187826
94063,33396,32549,31881,31497,31427,30788,30949,222487
94065,12626,12241,11585,11109,11108,10954,11359,80982
94066,42777,42569,42100,41636,41383,40974,41130,292569
94070,30370,30287,29879,29531,29358,29044,29166,207635
94074,309,263,320,253,241,193,214,1793
94080,66876,66431,66002,65200,64363,63275,63975,456122
94085,23177,23683,23964,23476,22688,22898,21247,161133
94086,49851,48258,47051,45775,45531,43843,45697,326006
94087,55987,56411,55229,54362,53446,52495,54293,382223
94089,21403,20747,20476,20505,20282,19994,19245,142652
94102,29319,28926,28013,25881,25531,24754,31176,193600
94103,25747,24309,24108,23907,23909,23361,27170,172511
94104,489,304,223,211,305,286,406,2224
94105,6793,6108,6282,5553,4801,4225,5846,39608
94107,29384,28641,27792,27856,26762,27185,26599,194219
94108,14704,14252,13930,13709,13518,13851,13768,97732
94109,56019,56293,54768,55519,54412,53809,55984,386804
94110,73511,72528,71422,72128,70804,70174,69333,499900
94111,3432,3527,3477,3496,3493,3562,3713,24700
94112,84001,84145,83032,82726,80726,79915,79407,573952
94114,33504,32598,32229,31397,32328,32175,31124,225355
94115,34681,35154,34556,33782,32882,32180,33021,236256
94116,45936,45559,45552,45157,43923,43980,43698,313805
94117,43323,42462,42638,41568,40932,41214,39169,291306
94118,41662,41391,40102,40292,39567,38529,38319,279862
94121,42720,42622,42043,42104,43597,44169,41203,298458
94122,62029,60929,58547,57369,57805,56859,56023,409561
94123,25238,25273,25528,24500,23710,22350,23088,169687
94124,35446,35010,35201,35309,34296,33558,33996,242816
94127,20664,19446,19356,19576,19075,19300,19289,136706
94128,119,99,83,66,48,31,69,515
94129,3762,3639,3334,2787,2730,2690,3183,22125
94130,3090,3187,3083,2654,2501,2300,2880,19695
94131,28350,28472,28370,26908,27914,27718,26881,194613
94132,31289,32031,31926,31080,31425,30306,28129,216186
94133,27491,27485,27662,27970,27580,27357,26237,191782
94134,41677,40701,40343,38815,38889,39032,40798,280255
94158,5995,5747,5530,5219,4340,3144,4792,34767
94301,17409,16876,16927,16420,16819,16855,16995,118301
94303,47743,47550,47159,46357,45714,44714,45467,324704
94304,3658,3655,3688,3797,3791,3594,3627,25810
94305,14971,14228,13538,13515,13541,13397,13862,97052
94306,27259,27583,27094,27236,26448,26309,26469,188398
94401,36597,37298,36838,36691,35721,34845,34429,252419
94402,24517,24591,24306,23289,23622,23408,23981,167714
94403,42252,40548,40032,39720,39311,39102,39642,280607
94404,36086,35492,35045,34431,33792,32986,33749,241581
94501,63228,63118,62571,61639,60639,60099,60212,431506
94502,14181,13615,13192,13179,13384,13140,13600,94291
94503,20366,20285,20116,19902,19494,18776,19681,138620
94505,14820,14687,14353,13083,12680,12560,13403,95586
94506,24371,22622,21896,21096,21312,21283,22452,155032
94507,16205,16653,15973,15977,15817,15844,14889,111358
94508,4268,4255,4118,3740,3638,3607,3661,27287
94509,64412,64406,63351,62651,61665,61266,62439,440190
94510,27786,27723,27515,27294,27180,27163,27088,191749
94511,2199,2172,2158,2172,1910,1882,2137,14630
94512,96,207,214,231,241,300,108,1397
94513,59444,58399,56929,55488,53902,51493,54605,390260
94514,1358,1209,1174,1069,1020,1393,1360,8583
94515,7379,7404,7314,7241,6815,6843,7050,50046
94516,157,186,154,129,120,144,211,1101
94517,13139,12913,12781,12644,12582,12542,12385,88986
94518,27549,26966,26647,26965,26162,26322,26778,187389
94519,19594,19819,19927,19400,19819,18937,18453,135949
94520,39535,39484,38743,37489,37477,36321,37208,266257
94521,41854,41575,41138,41354,40854,41880,41249,289904
94523,34742,34707,34428,33923,33728,33545,33569,238642
94525,3103,3044,3151,3121,2866,2946,3127,21358
94526,32284,32340,32274,32755,31915,31644,31102,224314
94528,749,767,915,1124,1175,1043,964,6737
94530,24851,24482,24301,24101,23913,23742,23877,169267
94531,44263,43095,42587,41700,41237,40115,40290,293287
94533,72349,71487,70634,69067,66641,67287,69277,486742
94534,37794,37253,36499,36560,36026,33850,36416,254398
94535,4269,4254,4543,4728,6007,6549,3793,34143
94536,72597,71765,70696,69921,68924,66617,68790,489310
94538,66493,64696,63850,61784,60439,60461,61148,438871
94539,52141,52096,51459,51494,51369,51021,50031,359611
94541,65178,64282,62738,61311,60736,59173,61635,435053
94542,13491,13262,12498,12385,12446,12534,12717,89333
94544,78096,77213,76508,76542,75917,74499,73026,531801
94545,32015,32236,30936,30083,28966,28935,29707,212878
94546,43472,42754,43448,42650,42766,42100,42209,299399
94547,25037,24860,24622,24454,24060,23573,24092,170698
94548,379,373,400,338,430,396,412,2728
94549,29005,28719,28298,27784,27340,26822,26864,194832
94550,50122,48663,48050,47648,46915,45154,46896,333448
94551,42508,41250,39775,37705,36994,36815,36867,271914
94552,14852,15226,15209,14719,14199,14568,14454,103227
94553,49638,49256,48891,48018,47583,46823,47065,337274
94555,36750,36693,35654,34973,34463,33656,34143,246332
94556,16039,15861,15505,15064,14716,14342,15229,106756
94558,68366,68227,67967,66824,66743,65916,66830,470873
94559,28355,27900,27062,27167,27132,27331,27184,192131
94560,44677,44207,43635,43139,42712,42322,42573,303265
94561,40274,39435,38481,37679,36908,35383,36515,264675
94563,18803,18580,18284,18024,17779,17595,17672,126737
94564,19007,18887,18704,18612,18505,18470,18287,130472
94565,91323,89712,87395,86204,85275,84558,84641,609108
94566,43784,43413,42523,41638,41006,40443,40884,293691
94567,587,552,730,800,691,803,623,4786
94568,51248,49864,48097,47384,45695,44101,46016,332405
94569,243,327,320,325,361,274,198,2048
94571,8802,8418,8171,8025,7784,7515,7911,56626
94572,9798,9724,9648,8689,8867,8847,8684,64257
94573,86,192,142,117,127,100,94,858
94574,8996,9062,9300,9538,9288,9298,8742,64224
94575,1175,1146,1274,1420,1581,1770,974,9340
94576,102,91,87,88,116,89,164,737
94577,47053,46494,45808,44344,44778,44521,45560,318558
94578,40603,39642,38629,39225,38230,37757,38558,272644
94579,22431,22056,21842,21652,20528,20167,20571,149247
94580,29167,29445,29311,28701,28531,28430,27152,200737
94582,40460,40215,39721,38928,37131,35156,38537,270148
94583,35174,35631,35272,34937,35248,35147,34859,246268
94585,29501,29260,29205,28823,28972,28859,28263,202883
94586,978,976,984,866,848,785,925,6362
94587,73500,72690,71675,70687,69820,68830,69516,496718
94588,34611,32979,31910,30949,30435,29918,30842,221644
94589,30593,31289,30811,30364,31174,30961,29876,215068
94590,36807,35543,34859,35263,34960,34466,35420,247318
94591,54493,54126,54530,53548,52796,53310,53042,375845
94592,880,776,651,562,583,493,742,4687
94595,17675,16732,16837,16448,16400,16170,16425,116687
94596,20794,20524,20778,20307,20192,19869,20037,142501
94597,21923,21271,20645,20070,19933,20473,20277,144592
94598,27175,27328,26974,26672,26127,26180,25818,186274
94599,3148,3185,3187,3166,3071,3041,3021,21819
94601,50369,50024,49990,49279,49138,49479,50294,348573
94602,29628,29829,29794,28553,28559,28827,28329,203519
94603,33823,33116,32306,32977,33774,32716,31403,230115
94605,43116,42079,43168,42639,40890,40356,39016,291264
94606,37912,38055,37001,36214,36051,35835,36672,257740
94607,26089,26172,24830,25107,23602,22745,24978,173523
94608,28864,28125,26323,26288,25994,25847,28019,189460
94609,22331,21981,22059,21210,21389,20728,20596,150294
94610,31486,30537,29734,29978,30276,30242,29287,211540
94611,37900,38023,37225,36676,36277,37192,36565,259858
94612,15200,14782,14500,13816,13110,12492,14389,98289
94613,855,871,842,861,800,722,715,5666
94618,16620,16884,17007,17226,17074,16753,16046,117610
94619,24638,24005,24146,22809,23525,23581,23299,166003
94621,33423,33369,32269,31833,31410,30509,29870,222683
94702,17720,17016,16868,16324,16187,15994,15979,116088
94703,21234,21561,21421,21281,20758,20593,19846,146694
94704,27006,26573,26334,24906,24065,22873,25592,177349
94705,13215,13224,12790,12979,12687,12560,12762,90217
94706,20735,20652,20206,19918,19469,19168,19615,139763
94707,12173,12555,12402,12324,12100,12191,11710,85455
94708,11481,11071,11143,11073,11289,11120,10985,78162
94709,11854,11866,12030,12360,12643,12584,11806,85143
94710,7193,6802,6439,6478,5897,6205,6948,45962
94720,3166,3087,3059,3026,2960,2805,2964,21067
94801,29923,30462,29269,29825,29277,28215,29395,206366
94803,25283,25252,25998,26124,25641,26040,24904,179242
94804,41681,40907,40941,39995,39635,37841,38559,279559
94805,14850,14701,14329,14232,13242,13647,13648,98649
94806,61452,60627,60101,59720,59976,59944,59861,421681
94850,0,0,0,0,0,0,0,0
94901,42212,42488,42027,41056,40663,40364,41157,289967
94903,31219,30555,30110,30411,29709,29062,29040,210106
94904,12459,12458,12271,12087,12156,12384,11995,85810
94920,12725,12711,12583,12528,12490,12477,12474,87988
94922,565,458,492,323,270,212,425,2745
94923,737,781,736,668,970,1065,1411,6368
94924,1307,1387,1434,1164,1108,1140,1638,9178
94925,9694,9595,9478,9326,9267,9191,9253,65804
94928,43370,43028,42668,42361,42206,42021,43170,298824
94929,135,139,82,70,142,132,264,964
94930,8763,8796,8756,8606,8287,8367,8500,60075
94931,8436,8442,8570,8646,8578,8601,8470,59743
94933,658,812,1069,1078,1190,1236,865,6908
94937,785,782,970,1099,1129,1096,837,6698
94938,840,636,884,907,745,900,812,5724
94939,7130,6936,6935,6887,6779,6551,6859,48077
94940,223,235,194,228,215,170,268,1533
94941,31154,31168,30605,30650,31070,30571,30496,215714
94945,19095,18602,17973,18107,17496,16965,17167,125405
94946,749,747,682,669,532,507,699,4585
94947,26180,26252,25969,24540,24254,24007,24283,175485
94949,16905,16366,16386,16895,17000,16539,17202,117293
94950,100,72,74,47,53,42,89,477
94951,4464,4152,4812,4253,4318,3866,4124,29989
94952,34938,35011,35081,34039,32925,32063,32858,236915
94954,37943,37273,36624,36785,37384,37333,37365,260707
94956,1282,1351,1687,1779,1718,1911,1756,11484
94957,1314,1316,1063,969,1002,1034,1332,8030
94960,15789,15777,15999,15986,15749,15417,15740,110457
94963,713,701,461,448,539,494,569,3925
94964,3322,3884,4478,4827,5279,5770,5094,32654
94965,11227,11294,11114,10926,11029,10883,10847,77320
94970,675,573,495,595,525,519,683,4065
94971,378,339,362,357,483,548,337,2804
94972,20,0,39,38,35,233,52,417
94973,1542,1653,1831,1745,1454,1549,1429,11203
95002,1727,1764,1660,1728,1906,1716,2077,12578
95003,25187,24546,24383,24430,23946,24421,23974,170887
95004,3846,4109,3886,3689,3795,3494,3918,26737
95005,7116,6733,6615,6168,5945,6002,6311,44890
95006,8649,8555,9162,9597,9543,9176,8979,63661
95007,683,715,727,517,602,604,676,4524
95008,46507,46054,45495,45187,44909,44419,45260,317831
95010,9375,9335,9367,9241,8980,9109,9137,64544
95012,11080,10748,10470,10456,10490,10278,10320,73842
95013,66,57,32,22,0,0,80,257
95014,62632,62346,62478,61521,60690,59944,60717,430328
95017,627,658,654,741,698,760,834,4972
95018,6935,7632,7660,7993,8110,8316,7778,54424
95019,6252,7159,7374,7692,8157,8417,7727,52778
95020,61480,60203,59666,58246,56865,56708,57349,410517
95023,51045,50759,50625,50067,49598,49326,48841,350261
95030,13477,13389,13429,13791,13534,13477,12791,93888
95032,26027,26360,25898,25664,25039,24573,25089,178650
95033,10006,9772,9628,9309,9540,9193,9372,66820
95035,73652,71767,69635,68178,67380,66437,66943,483992
95037,48532,47560,46834,46100,45924,45429,45579,325958
95039,1252,1558,1545,1308,1253,1134,1377,9427
95041,410,222,146,215,202,150,160,1505
95043,734,721,636,616,595,524,639,4465
95045,4475,4334,3969,4010,3644,3633,4046,28111
95046,6299,6413,6303,6547,6691,6346,6417,45016
95050,38482,38024,37714,37057,36587,35088,35923,258875
95051,55634,55470,54406,53152,53394,53844,54327,380227
95053,3222,2911,2730,2513,2312,2369,2206,18263
95054,24718,23989,23914,24408,23188,22233,23364,165814
95060,47227,46695,47148,46688,46821,46942,46377,327898
95062,37365,37132,36358,36201,35827,34933,36079,253895
95064,9692,9385,8425,7865,7090,6020,7331,55808
95065,8551,8804,8331,8443,8620,8587,8113,59449
95066,15642,15670,15095,14993,15038,14836,14749,106023
95070,31268,31223,31093,30923,30533,30215,30617,215872
95073,11407,11265,10849,10571,10235,9828,10154,74309
95075,390,339,330,293,264,254,331,2201
95076,85678,84779,84587,82930,81736,80273,82474,582457
95110,19270,19682,19239,18739,18179,17717,18730,131556
95111,64247,62157,60907,59521,57125,56572,58466,418995
95112,61583,60130,57503,55481,53268,50940,55927,394832
95113,1332,1169,1163,838,702,713,893,6810
95116,55249,54217,52597,51010,49728,47858,51496,362155
95117,30686,31613,32074,32277,30980,29924,30067,217621
95118,31869,31871,31579,31858,31312,30455,31932,220876
95119,10617,10781,10595,10291,9466,10031,9970,71751
95120,37784,37644,37673,38366,38351,38552,37457,265827
95121,38445,38958,38603,37699,37135,38094,37469,266403
95122,58437,58350,57564,55438,54873,52829,56545,394036
95123,66500,65276,64602,63621,63495,61994,62228,447716
95124,49156,49402,48505,47446,47854,47031,47082,336476
95125,53896,54563,54696,54200,52805,51718,51939,373817
95126,35330,33842,34618,33711,31965,31343,31049,231858
95127,66282,65812,64498,65258,64392,65318,61325,452885
95128,36807,37870,37026,35898,36020,34776,34836,253233
95129,40325,40471,40530,39740,39436,38450,38720,277672
95130,14206,14413,14559,13954,14529,14265,13911,99837
95131,30027,29995,29660,28999,28990,28809,28565,205045
95132,40414,40518,41222,40838,40882,40779,40299,284952
95133,27431,28392,27381,26867,26189,25772,25401,187433
95134,21010,18743,16811,15517,15316,15467,15268,118132
95135,21957,21766,21349,20908,21159,20691,20120,147950
95136,44386,42725,41852,42464,42565,42382,42989,299363
95138,19503,19297,19136,18870,19104,20113,18889,134912
95139,7085,6784,6632,6545,6690,6515,6748,46999
95140,273,209,233,299,321,109,191,1635
95148,48201,48225,46993,45741,45677,45384,45528,325749
95202,6559,6067,5409,5404,5808,5591,6521,41359
95203,15489,15971,15711,14857,15431,15155,15696,108310
95204,28124,28625,29246,29227,29200,29342,27786,201550
95205,37362,37299,36928,35831,36300,36019,38069,257808
95206,65151,65448,65324,66092,63820,63292,65004,454131
95207,49632,48446,48748,47883,47604,47448,47965,337726
95209,43362,42154,41459,41221,41153,41533,39488,290370
95210,40718,40686,40820,40180,40502,41066,39009,282981
95211,1665,1730,1814,1904,1919,1957,1545,12534
95212,26094,26433,25244,25892,25219,24795,25239,178916
95215,23635,23824,23764,24067,23902,23088,23224,165504
95219,29506,28479,28354,27686,27913,27370,27884,197192
95220,7371,7015,7501,7395,6819,6721,7273,50095
95222,4976,4981,5228,5146,5062,5055,5292,35740
95223,2884,2780,3042,3056,3156,3709,4612,23239
95224,228,193,266,297,291,303,429,2007
95225,609,749,570,565,506,504,672,4175
95226,14,14,295,284,274,297,84,1262
95227,805,814,938,675,892,937,941,6002
95228,4498,4723,4576,4286,4365,4247,3976,30671
95230,869,776,635,711,833,564,718,5106
95231,4806,4823,4961,5179,5205,5496,4374,34844
95232,168,266,217,286,396,264,304,1901
95233,583,627,591,475,419,237,436,3368
95234,112,109,261,263,180,216,70,1211
95236,4196,3929,3829,3768,3752,3824,4223,27521
95237,3124,3097,2999,3269,3431,3321,3167,22408
95240,48065,47250,47297,46482,46811,46825,47172,329902
95242,25752,26343,26187,25525,25351,25033,25393,179584
95245,1958,2290,2064,2273,2217,2214,2277,15293
95246,1071,1256,1258,1207,1119,1291,1615,8817
95247,4709,4981,4689,4599,4518,4459,4368,32323
95248,127,121,178,131,205,227,301,1290
95249,4377,3865,3796,3575,3817,3769,4042,27241
95250,0,66,65,62,33,35,78,339
95251,538,872,874,1022,819,979,767,5871
95252,15068,13874,14143,14908,15050,15154,13460,101657
95254,897,955,682,463,511,144,480,4132
95255,1655,1774,1991,2162,2380,2516,2042,14520
95257,454,374,385,396,425,431,413,2878
95258,3882,3705,3973,3874,3799,4163,4018,27414
95301,38356,38022,38007,37593,36542,36199,37073,261792
95303,678,754,1019,1085,949,1049,912,6446
95304,15718,17442,17971,17314,17586,17191,15706,118928
95305,28,40,53,78,85,82,245,611
95306,823,822,952,918,872,933,970,6290
95307,42844,42208,42470,43160,43596,43518,42753,300549
95310,2163,2132,1934,1648,1820,1779,1882,13358
95311,1831,1912,2073,2182,2119,2544,2197,14858
95312,290,267,276,251,357,540,268,2249
95313,1077,1053,1006,1012,1472,1812,1386,8818
95314,0,0,0,0,0,0,0,0
95315,13108,12363,12381,12168,12916,12340,13018,88294
95316,6416,6961,6733,6820,6619,6581,6573,46703
95317,946,990,1033,972,942,837,817,6537
95318,403,467,601,549,471,520,541,3552
95319,1593,1591,1581,1490,1191,1428,1749,10623
95320,12759,13018,12739,13000,12947,13044,12819,90326
95321,3263,3432,3461,3401,3506,3423,3736,24222
95322,9025,8763,8727,9042,9646,10167,8942,64312
95323,1083,1077,998,1182,1131,1099,1260,7830
95324,7610,7522,7733,7546,6886,6607,7324,51228
95325,26,73,61,62,61,67,81,431
95326,9948,9790,9487,8922,8884,8561,9581,65173
95327,7901,8202,8679,9306,9776,9891,9806,63561
95328,6013,5048,4717,4726,4325,3749,3993,32571
95329,2650,2846,2654,2646,2744,2538,2460,18538
95330,20253,19596,17702,16889,16278,17328,17853,125899
95333,2793,2988,3064,3108,2896,3094,2942,20885
95334,16366,16444,16330,16057,15747,15777,15457,112178
95335,171,364,613,623,707,750,541,3769
95336,47808,47343,46433,45015,43753,42331,42675,315358
95337,34391,33432,31399,31302,30987,30478,31557,223546
95338,10784,10928,11075,11471,11834,11713,11062,78867
95340,36541,35309,34745,33512,31624,32014,33931,237676
95341,32787,33464,33744,33713,33934,33881,32967,234490
95345,580,422,448,344,264,198,708,2964
95346,1888,1842,1541,1191,970,815,1272,9519
95348,33555,33442,31387,30838,31570,29398,30805,220995
95350,51441,50908,50676,50260,50159,50103,51046,354593
95351,49243,49163,48437,47534,46681,46354,46458,333870
95354,25485,24838,24356,24856,24364,24643,25394,173936
95355,58872,59210,59955,59111,59392,59159,58311,414010
95356,32827,33370,32794,31134,31539,31669,30918,224251
95357,11717,11955,11353,11195,11099,11004,11559,79882
95358,32758,33194,31709,31639,31592,30664,31668,223224
95360,12243,12139,11756,11660,11583,11408,11712,82501
95361,33741,33163,32544,32374,32440,32328,31610,228200
95363,26291,25866,26087,26426,25603,25235,25237,180745
95364,0,0,0,0,0,0,53,53
95365,4855,4666,4796,5041,5300,4882,4985,34525
95366,17118,16848,16734,16651,16603,16022,16575,116551
95367,24657,24173,24045,23428,23076,22686,23173,165238
95368,13826,13439,14474,14656,14319,15128,13614,99456
95369,1011,956,977,1094,1161,1436,1099,7734
95370,28124,27043,26904,28021,27551,27767,26803,192213
95372,2068,1891,1969,1614,1549,1744,1963,12798
95374,1702,1851,1847,1778,1813,1819,2030,12840
95375,116,246,228,142,179,168,106,1185
95376,51245,49582,49398,49442,49357,48593,49859,347476
95377,32462,32723,32453,31597,30326,29649,30902,220112
95379,3296,3895,3837,3782,3716,3986,3898,26410
95380,41865,41254,41069,41109,39704,39661,41201,285863
95382,37138,37497,37163,36860,37570,36863,36176,259267
95383,3471,3456,3728,3440,3774,3885,3937,25691
95385,396,508,515,347,403,366,429,2964
95386,10324,10265,10066,9794,9816,9802,9877,69944
95387,520,609,768,943,850,759,636,5085
95388,13885,14371,14410,14274,14001,14248,13074,98263
95389,1651,1592,1312,1236,1234,1015,1272,9312
95391,14254,13185,12359,11996,10276,9066,9959,81095
95401,39400,38048,38604,36646,35882,35290,36981,260851
95403,46294,45596,44918,44914,46070,44676,45164,317632
95404,40699,41268,40253,39988,38817,38803,39761,279589
95405,21351,21695,21516,21168,20927,20898,21399,148954
95407,41249,40959,40657,40741,40068,39221,39352,282247
95409,26805,26586,25784,26055,26549,26843,27187,185809
95410,890,946,886,884,948,884,950,6388
95412,452,382,352,322,298,235,401,2442
95415,1312,1245,1591,1657,1631,1605,1592,10633
95417,237,219,170,197,218,123,297,1461
95420,684,611,442,358,591,494,374,3554
95421,1599,1474,1537,1490,1400,1405,1592,10497
95422,15358,15476,15453,15427,15379,15403,15585,108081
95423,3645,3260,3040,3234,3147,2949,3747,23022
95425,10675,10597,10699,10628,10555,10524,10841,74519
95426,1726,1544,1659,1895,2344,2287,2147,13602
95427,203,256,227,201,278,266,459,1890
95428,2540,2365,2491,2561,2528,2458,2516,17459
95429,58,74,77,84,114,150,70,627
95430,0,0,0,0,0,0,44,44
95431,430,621,511,525,538,435,631,3691
95432,445,421,348,375,514,516,426,3045
95435,166,334,355,322,166,193,82,1618
95436,5965,6052,5582,5092,5355,5107,5418,38571
95437,14578,14492,14351,14527,14193,13992,14799,100932
95439,825,779,566,791,727,812,675,5175
95441,1909,1970,1989,2226,2301,2538,2014,14947
95442,3080,3118,3154,3475,3575,3859,3178,23439
95443,312,284,268,370,251,219,233,1937
95444,653,710,774,660,903,905,748,5353
95445,1792,1728,1522,1709,1758,1754,2093,12356
95446,4529,4281,4419,4598,4788,5004,4750,32369
95448,17481,17631,17078,16910,16645,17448,16852,120045
95449,1679,1708,1583,1571,1518,1898,1507,11464
95450,283,262,228,224,191,257,387,1832
95451,12230,12212,12035,12248,11565,11311,11213,82814
95452,1409,1364,1314,1223,1070,801,1393,8574
95453,10362,10244,10345,10701,11054,11721,11256,75683
95454,2029,2075,2135,2279,2226,2256,2556,15556
95456,721,731,600,725,943,807,795,5322
95457,3076,3162,3331,3292,3369,3191,2893,22314
95458,3176,3176,3334,3126,3049,2493,3104,21458
95459,682,581,596,543,605,444,504,3955
95460,2301,2364,2338,2361,2406,2698,2285,16753
95461,2954,3298,3318,3439,3811,3598,3413,23831
95462,1164,1216,1216,1267,1377,1277,1417,8934
95463,49,29,18,0,0,0,169,265
95464,2412,2295,2208,2426,2132,2183,2673,16329
95465,2140,2237,2328,2274,2235,2279,2083,15576
95466,990,864,913,1192,956,910,946,6771
95467,5618,5986,6168,5410,5679,6243,5498,40602
95468,1381,1156,1192,1177,1222,1282,1258,8668
95469,1979,1963,1960,1906,1915,1890,1767,13380
95470,6514,7009,6874,6236,6070,5960,6032,44695
95471,599,536,528,453,425,452,522,3515
95472,30260,30281,29408,29381,29118,29119,28255,205822
95476,37534,37646,38822,38800,37602,36452,35394,262250
95482,31941,32892,33157,33538,33163,33119,31808,229618
95485,2607,2492,2508,2044,2115,2377,2557,16700
95486,41,40,54,42,17,45,62,301
95488,239,357,309,267,254,352,280,2058
95490,13054,12661,12905,12158,12602,12768,13264,89412
95492,29515,29486,29629,29552,28844,28079,28532,203637
95493,321,288,187,291,274,166,198,1725
95494,209,112,188,219,153,154,139,1174
95497,1092,1068,983,869,762,812,1305,6891
95501,23284,23689,23769,23704,23800,23564,23976,165786
95503,25830,25438,24900,24899,24717,25003,24152,174939
95511,331,430,452,398,430,306,360,2707
95514,254,215,170,191,187,134,254,1405
95519,19441,18538,18496,19055,19135,18992,17432,131089
95521,20911,20930,20769,20319,20108,20055,20199,143291
95524,1944,1956,1902,1964,2133,2002,1787,13688
95525,1569,1745,1668,1751,1768,1681,1733,11915
95526,197,213,237,273,410,517,378,2225
95527,586,600,553,491,562,496,627,3915
95528,1191,1044,1273,1207,1079,1071,1139,8004
95531,23500,23801,24202,24687,24301,24605,24528,169624
95536,3140,2984,3078,3156,3065,3030,2849,21302
95537,255,229,130,71,120,195,276,1276
95540,13418,13190,13012,12877,13159,13464,13657,92777
95542,2008,2360,2718,2252,2259,2105,2533,16235
95543,792,636,551,549,628,652,765,4573
95545,76,100,99,92,61,58,153,639
95546,3260,3286,3434,3476,3424,3387,3494,23761
95547,1158,1265,1347,1443,1244,1108,1222,8787
95548,1288,1486,1459,1398,1658,1685,1373,10347
95549,942,824,869,745,813,758,805,5756
95550,164,247,269,272,226,242,128,1548
95551,1453,1782,1826,1944,2009,2002,1739,12755
95552,635,635,587,554,425,554,697,4087
95553,1274,1090,1173,1381,1073,663,1062,7716
95554,336,392,325,455,476,485,533,3002
95555,338,326,329,360,335,360,410,2458
95556,643,652,655,637,649,600,605,4441
95558,458,398,360,353,312,300,425,2606
95559,108,95,103,113,164,130,182,895
95560,1351,1310,1374,1145,1098,1257,1648,9183
95562,3437,3438,3435,3409,3388,3378,3450,23935
95563,705,720,559,679,585,631,652,4531
95564,402,492,500,454,521,560,462,3391
95565,934,1044,1092,1064,1038,1150,1071,7393
95567,2048,1865,1854,1723,1909,1619,1930,12948
95568,161,126,94,93,128,118,136,856
95569,340,344,277,308,319,331,361,2280
95570,2079,2106,2083,2085,2103,2286,2579,15321
95571,228,237,152,133,59,87,271,1167
95573,1523,1557,1433,1443,1507,1197,1744,10404
95585,537,451,454,443,440,477,508,3310
95587,146,157,128,126,117,27,201,902
95589,966,1163,1226,1198,1127,1114,1612,8406
95595,156,153,180,128,176,191,262,1246
95601,178,137,161,139,183,213,198,1209
95602,18472,17955,18498,18049,17687,18263,17509,126433
95603,28826,29182,28652,28054,28113,28001,27844,198672
95604,104,64,44,44,0,0,75,331
95605,14595,14924,14326,14160,13706,13039,14179,98929
95606,129,18,35,98,114,187,196,777
95607,499,431,315,371,331,364,431,2742
95608,60199,61344,60729,60255,60288,61399,59418,423632
95610,44711,44085,43572,43333,43805,43566,44147,307219
95612,964,1070,1045,968,1056,1238,1239,7580
95614,4318,4284,4283,4341,3972,4059,3833,29090
95615,970,861,1090,999,1025,1047,834,6826
95616,49093,48822,48106,47995,49138,48127,47032,338313
95618,27926,27651,27222,27262,26397,26679,27281,190418
95619,5075,5073,4937,4893,5220,5246,4842,35286
95620,21685,21267,21005,20845,20638,20272,20553,146265
95621,41908,42063,41474,41573,40829,40944,39819,288610
95623,3911,4215,4317,3913,3934,3685,3806,27781
95624,64429,64225,63131,62335,59573,58693,61989,434375
95625,54,180,200,188,192,143,155,1112
95626,5871,6308,6335,5979,6050,5832,5975,42350
95627,3873,3618,3498,3171,3270,3481,3513,24424
95628,41649,41043,40767,40921,39863,39002,40196,283441
95629,676,820,1002,949,907,1041,832,6227
95630,74905,74180,73356,72462,71676,70520,72180,509279
95631,6375,6017,5910,5874,5624,6081,6076,41957
95632,30594,30208,30064,29892,29793,28909,29269,208729
95633,3610,2933,3247,3441,3442,3399,3349,23421
95634,3206,3216,3143,3080,3239,2964,3232,22080
95635,861,905,870,921,1109,1250,1262,7178
95636,846,880,771,937,878,923,1101,6336
95637,349,837,694,622,605,473,370,3950
95638,2238,2095,2047,1984,2213,2059,2255,14891
95639,333,293,311,299,244,206,283,1969
95640,10509,13097,10681,10825,11024,11152,11353,78641
95641,1843,1776,1732,1590,1704,1674,1986,12305
95642,6912,6581,6619,6705,6736,6330,7164,47047
95645,2091,2110,2110,1962,1716,1688,2037,13714
95646,64,75,98,66,105,123,158,689
95648,50341,49990,48869,48243,46870,44892,47354,336559
95650,13157,12696,12255,11741,11504,11596,12447,85396
95651,614,737,517,451,511,460,637,3927
95652,966,953,1010,836,776,946,739,6226
95653,657,599,565,481,444,308,527,3581
95655,4205,4190,4592,4802,4687,4643,4314,31433
95658,6709,6266,6261,6522,6664,6553,6285,45260
95659,788,777,775,760,679,759,702,5240
95660,34303,34464,33014,32835,31443,30695,30714,227468
95661,31034,30321,30559,30269,30373,30730,29791,213077
95662,32441,32293,31814,31411,31672,31712,31558,222901
95663,2443,2516,2485,2332,2749,2738,2377,17640
95664,1357,1334,1135,1095,1169,1032,1380,8502
95665,4901,4536,4862,4240,4392,4971,4426,32328
95666,5170,4498,5533,5525,5504,5310,5336,36876
95667,36859,36684,36639,35924,36175,36713,36726,255720
95668,794,780,752,844,908,980,815,5873
95669,2493,2043,2676,2864,2682,2509,2443,17710
95670,54277,53662,52886,53259,53678,52757,52973,373492
95672,5010,5432,5166,5273,5390,5374,4773,36418
95673,15140,14895,14773,15430,14641,14589,15455,104923
95674,891,1010,922,739,803,796,935,6096
95675,574,284,309,405,627,578,381,3158
95677,23906,23196,22808,22675,22928,23591,23333,162437
95678,41953,42153,41929,42606,42135,41215,41192,293183
95679,20,54,48,29,35,29,55,270
95680,278,291,260,245,152,42,146,1414
95681,1471,1596,1475,992,1317,1444,1226,9521
95682,30033,30013,29972,29590,29269,28938,29114,206929
95683,6233,6411,6555,6354,6651,7015,6180,45399
95684,3004,3102,2980,3069,2905,2918,3422,21400
95685,4356,3827,4278,4368,4405,4954,4680,30868
95686,1079,1007,965,1020,1014,1020,1405,7510
95687,66476,66350,65781,66129,65634,65467,65096,460933
95688,36763,36385,35820,34599,34385,33595,34379,245926
95689,1131,1022,904,1151,1130,1088,1244,7670
95690,2289,2122,1932,2015,2010,1678,2533,14579
95691,36932,35951,35929,35485,34676,34310,34737,248020
95692,5129,4867,4812,4992,4968,5145,4769,34682
95693,6153,6322,5943,5640,5616,5873,6758,42305
95694,9828,9428,9574,10008,9739,9764,9156,67497
95695,39144,38998,38790,37686,37556,37712,37946,267832
95697,430,569,554,307,455,335,425,3075
95698,232,221,219,177,263,164,236,1512
95699,143,217,148,267,163,138,154,1230
95701,782,792,718,759,760,755,983,5549
95703,829,998,1065,1055,1082,1038,897,6964
95709,5096,4857,4953,4942,4905,4173,4772,33698
95713,10296,10009,9920,9645,9428,8855,9495,67648
95714,368,311,284,271,335,354,382,2305
95715,89,92,80,88,67,96,115,627
95717,166,166,199,188,234,176,231,1360
95720,49,55,60,67,93,72,157,553
95721,13,13,13,14,13,14,37,117
95722,4636,4478,4524,4583,4417,4397,4585,31620
95724,0,0,0,0,0,0,27,27
95726,8816,8712,8566,8902,8769,9402,8842,62009
95728,366,481,495,495,352,227,386,2802
95735,27,26,30,31,29,17,68,228
95736,165,255,250,278,264,260,240,1712
95742,10494,10145,9780,8873,8141,7896,7749,63078
95746,23638,23516,23715,24012,23441,23220,21460,163002
95747,61869,58938,56415,53452,51513,49554,51870,383611
95757,46703,45259,44638,42752,41246,38705,40222,299525
95758,63778,62411,62099,61155,61247,59496,60435,430621
95762,40493,40039,40603,40829,39749,39336,38797,279846
95765,36980,36700,36391,35914,34508,32831,33974,247298
95776,23260,22559,21827,22083,21962,21848,21902,155441
95811,6711,7072,7131,7370,7309,7096,7595,50284
95814,10487,9706,10076,9802,9242,9155,9922,68390
95815,25206,25394,25772,25627,25406,25727,24680,177812
95816,17178,17203,16845,16624,16133,16195,15579,115757
95817,13918,13818,14472,14377,13978,13006,13534,97103
95818,20629,20542,20135,19960,19866,20317,19811,141260
95819,18846,18571,18374,17705,16805,16561,17141,124003
95820,35869,35425,34529,33967,33412,33573,34480,241255
95821,35530,34053,34439,33190,32558,32860,33550,236180
95822,44724,43427,42907,43024,42185,41315,42347,299929
95823,76478,76079,73641,74154,73832,74609,73985,522778
95824,30225,30053,29781,29344,30973,31097,30221,211694
95825,33385,31846,31083,31505,31870,30777,31084,221550
95826,36992,38256,38378,37215,37064,37748,36628,262281
95827,20382,20509,20294,20120,20095,20223,20269,141892
95828,60884,62016,61490,60993,59266,59409,57862,421920
95829,26588,26533,25786,25565,26010,25850,24755,181087
95830,953,792,762,725,787,856,934,5809
95831,41859,41233,41597,41224,42052,41345,41321,290631
95832,11313,11283,11908,12051,12507,12556,11924,83542
95833,40029,40129,39117,38264,37746,36997,37293,269575
95834,26560,24832,23986,24201,24063,23715,25899,173256
95835,38847,38942,39073,38606,38729,35980,35936,266113
95837,340,341,289,240,289,346,315,2160
95838,37286,37133,35935,35584,35849,35604,36764,254155
95841,19890,19730,19361,18612,18216,19143,19448,134400
95842,32184,31299,31671,31689,31965,31547,31806,222161
95843,47666,46972,47172,46775,46143,45549,45048,325325
95864,23527,23007,22698,21554,21538,21646,22447,156417
95901,32804,32586,32742,32569,32278,32266,31314,226559
95903,1622,1690,1772,1981,2039,2279,1732,13115
95910,134,116,115,135,83,82,86,751
95912,4693,4755,4550,4814,4799,4548,4685,32844
95914,649,625,555,629,739,614,578,4389
95915,9,10,58,63,59,56,44,299
95916,1102,1300,1291,1244,1210,1370,1441,8958
95917,3313,3320,3508,3336,3073,3541,3155,23246
95918,2468,1905,1805,1549,1740,1773,2339,13579
95919,1184,1255,1529,1305,1595,1672,1378,9918
95920,320,243,417,449,381,475,274,2559
95922,539,571,595,637,560,610,687,4199
95923,9,10,12,33,25,22,58,169
95925,143,95,83,47,305,247,295,1215
95926,38465,38315,38276,37747,37613,38064,37725,266205
95928,36374,36029,36081,36194,36517,37059,36511,254765
95930,155,155,72,0,0,0,69,451
95932,7651,7671,7808,7776,7795,7716,7718,54135
95934,367,394,504,317,305,249,274,2410
95935,654,592,594,366,322,359,631,3518
95936,234,224,244,250,326,192,352,1822
95937,1400,1266,1133,1320,1160,1278,1491,9048
95938,4229,3888,3936,4015,4000,3797,3787,27652
95939,578,543,512,488,474,579,604,3778
95941,586,398,505,589,410,491,563,3542
95942,782,892,1098,1362,1398,1352,1301,8185
95943,886,886,805,894,889,903,879,6142
95944,41,14,12,0,67,156,46,336
95945,25712,25510,25223,24762,24235,24162,25199,174803
95946,9694,10339,10206,9874,10155,9814,9790,69872
95947,1770,1760,1663,1795,1698,1899,1899,12484
95948,10751,10645,10349,10289,10501,10251,10810,73596
95949,19575,19575,19640,19999,20810,20505,19741,139845
95950,519,615,724,664,839,805,569,4735
95951,3073,3013,2948,2671,2654,2769,2601,19729
95953,10476,10241,10631,10575,10447,10241,10718,73329
95954,12509,11976,12535,12464,12336,12262,12251,86333
95955,1325,1399,1384,1251,1189,1500,1517,9565
95956,419,431,459,346,421,376,401,2853
95957,837,929,773,875,950,890,761,6015
95959,17534,17341,17013,17668,17697,18235,17838,123326
95960,752,915,974,989,929,876,796,6231
95961,27141,27745,26979,26753,26300,25552,26510,186980
95962,1235,1214,1285,1527,1282,1073,1567,9183
95963,14943,15093,15018,15214,15302,15003,15493,106066
95965,20473,20630,20599,20130,20709,19735,20384,142660
95966,30557,31069,30916,30983,30909,31303,30643,216380
95968,1250,1605,1438,1494,1534,1544,1412,10277
95969,27850,27538,27443,27298,27385,27735,27549,192798
95970,500,458,482,525,402,418,530,3315
95971,5952,5968,5798,5639,5789,5940,5970,41056
95973,35297,34569,33511,33046,32008,30415,31957,230803
95974,65,63,0,0,0,0,8,136
95975,1811,2034,2072,2005,1914,1645,1769,13250
95977,1730,1656,1887,1971,1394,1410,1678,11726
95978,115,110,0,24,27,58,143,477
95979,750,646,685,631,475,517,597,4301
95981,96,83,102,169,180,82,97,809
95982,3487,3475,3251,3154,3082,3241,3221,22911
95983,500,541,440,557,693,558,428,3717
95984,39,31,0,21,80,79,120,370
95986,79,24,17,36,19,19,162,356
95987,6142,6088,5979,5931,6059,6013,5992,42204
95988,8663,8767,8913,8937,8789,8664,8857,61590
95991,40683,41635,41212,41309,40172,40719,40593,286323
95993,36617,35469,35847,35628,36715,35798,36067,252141
96001,34260,34597,34469,33702,33805,33577,33865,238275
96002,32943,32958,33202,33730,33360,34875,33298,234366
96003,44929,44714,44398,44405,45295,44404,44461,312606
96006,389,314,400,532,582,615,557,3389
96007,23354,23130,22942,22785,22304,22469,22841,159825
96008,1483,1108,1128,983,1196,839,1231,7968
96009,288,294,329,443,552,585,569,3060
96010,194,169,187,214,209,192,239,1404
96011,116,148,155,134,116,181,218,1068
96013,4538,4111,3881,3626,3358,3614,4212,27340
96014,146,116,152,190,251,210,211,1276
96015,587,626,814,704,645,647,465,4488
96016,497,573,532,687,530,624,366,3809
96017,160,175,234,212,232,200,171,1384
96019,10121,10126,10129,10094,10114,10063,10082,70729
96020,2438,2287,2246,2211,2488,2008,2416,16094
96021,16322,16122,16121,16352,15932,15417,16097,112363
96022,16904,17736,17488,17023,17063,16335,15768,118317
96023,1096,1184,1339,1193,1190,1166,1240,8408
96024,962,967,1163,1204,1190,1274,1145,7905
96025,2121,2089,2102,2179,2243,2444,2310,15488
96027,2390,2464,2462,2379,2353,2271,2227,16546
96028,1403,1635,1633,1637,1552,1676,1464,11000
96029,200,158,165,131,130,136,124,1044
96031,175,149,165,204,169,131,158,1151
96032,2518,2345,2339,2223,2258,2378,2407,16468
96033,561,580,526,463,402,343,432,3307
96034,220,255,285,338,300,334,294,2026
96035,3398,3431,3604,3253,3372,3359,3324,23741
96037,216,180,220,215,303,395,308,1837
96038,602,636,599,549,478,480,589,3933
96039,1044,1078,1206,1285,1279,1180,1251,8323
96040,275,292,229,219,177,198,341,1731
96041,3061,3019,2795,2993,2790,2391,2747,19796
96044,937,962,1040,946,1122,1186,1022,7215
96046,134,183,255,200,257,214,304,1547
96047,799,783,775,779,826,716,1004,5682
96048,701,822,977,1053,1078,1039,736,6406
96049,28,76,90,89,109,101,95,588
96050,387,411,408,411,460,467,414,2958
96051,1264,1304,1110,1120,1126,996,1139,8059
96052,1417,1533,1652,1580,1817,1624,1460,11083
96054,260,276,294,250,291,332,366,2069
96055,4002,3987,4097,4067,4399,4358,3935,28845
96056,1693,1368,1407,1496,1516,1332,1642,10454
96057,1305,1348,1332,1475,1543,1622,1355,9980
96058,779,806,752,848,760,672,798,5415
96059,604,740,711,783,649,703,688,4878
96061,27,25,19,27,41,46,36,221
96062,1180,1245,1253,1123,1247,1023,1105,8176
96063,188,199,222,212,193,133,125,1272
96064,4881,5001,4762,4482,4277,4173,4574,32150
96065,360,445,387,338,330,341,357,2558
96067,6828,6991,6994,7313,7152,7320,7165,49763
96068,131,148,135,183,219,279,183,1278
96069,792,758,880,799,812,929,982,5952
96071,180,125,77,85,88,49,125,729
96073,4174,4207,4502,4664,4740,4484,4082,30853
96074,196,223,199,226,247,230,260,1581
96075,304,299,308,345,355,355,369,2335
96076,139,122,88,177,147,134,166,973
96080,27564,27524,27650,28084,28149,29057,28764,196792
96084,416,484,530,593,579,629,625,3856
96085,91,67,50,46,31,37,85,407
96086,304,359,379,368,402,384,338,2534
96087,600,521,525,576,487,456,600,3765
96088,4410,4200,4099,4317,4377,4412,4506,30321
96090,467,410,397,390,419,383,421,2887
96091,561,521,578,694,732,755,699,4540
96092,300,300,277,242,269,213,496,2097
96093,4031,4032,4006,3755,3786,4259,4133,28002
96094,6446,6145,6370,6422,6432,6385,6630,44830
96096,733,771,814,842,828,724,695,5407
96097,9744,9860,9790,9932,10159,10084,10031,69600
96101,5378,5531,5260,4915,4928,4760,5490,36262
96103,1369,1331,1357,1200,1254,1334,1725,9570
96104,576,559,548,675,768,775,748,4649
96105,70,47,165,406,625,665,527,2505
96106,223,217,275,224,249,239,479,1906
96107,1129,1306,1077,1329,1514,1498,1269,9122
96108,7,10,7,16,19,0,122,181
96109,741,804,731,783,701,659,2197,6616
96110,167,157,129,128,100,120,166,967
96111,30,40,69,60,53,64,160,476
96112,332,266,230,254,151,169,214,1616
96113,2100,2158,2294,2058,2001,1884,1000,13495
96114,3387,3531,3315,3260,3226,3075,3220,23014
96115,179,119,212,194,238,195,145,1282
96116,127,129,162,214,199,340,233,1404
96117,300,227,244,227,182,225,405,1810
96118,1629,1717,1590,1592,1500,1512,1627,11167
96119,100,124,71,74,59,36,90,554
96120,1079,1064,1091,1045,1054,1012,957,7302
96121,302,298,249,262,274,262,368,2015
96122,3532,3864,4382,4697,4147,4575,3883,29080
96123,46,35,36,6,20,15,48,206
96124,385,380,366,351,366,445,326,2619
96125,227,242,285,340,318,298,258,1968
96126,39,55,133,105,128,229,215,904
96128,840,831,758,647,537,491,752,4856
96129,132,123,35,133,164,215,261,1063
96130,20812,21456,21920,21963,22317,22192,23150,153810
96132,119,105,103,64,29,46,119,585
96133,202,235,160,108,110,113,110,1038
96134,2203,2357,2506,2869,2798,2641,2512,17886
96135,172,15,0,0,78,79,128,472
96136,47,103,135,157,161,170,104,877
96137,3707,3733,3606,3826,3554,3605,3297,25328
96140,805,999,1126,1116,1298,1248,1170,7762
96141,464,585,669,761,741,607,744,4571
96142,766,706,731,669,726,785,1037,5420
96143,3737,4124,3855,4225,3994,3582,4414,27931
96145,2399,2872,3215,2997,3283,3017,3161,20944
96146,968,857,823,853,879,921,1366,6667
96148,776,853,781,786,637,855,788,5476
96150,29001,28912,28618,28686,29024,29206,29792,203239
96155,0,0,0,0,0,0,8,8
96161,18255,18256,18475,18113,17935,17887,18451,127372
96701,39697,39270,38526,39324,40268,41307,40281,278673
96703,2049,2162,2388,2491,2375,2428,2368,16261
96704,7874,7873,7425,7117,7101,7016,6505,50911
96705,2651,2512,2624,2611,2357,2416,2319,17490
96706,68881,67146,66440,65260,63491,61990,62730,455938
96707,45588,45771,42793,39967,37138,36108,38817,286182
96708,9753,10110,9724,10598,10586,9757,10220,70748
96710,226,222,298,572,510,482,613,2923
96712,7614,8441,8371,8192,7720,8018,7352,55708
96713,1471,1571,1672,1735,1801,1791,1990,12031
96714,633,715,818,886,968,1080,1390,6490
96716,2808,2757,2611,3007,2982,2894,2823,19882
96717,4895,4965,5069,5232,5129,4867,5555,35712
96719,1900,2423,2629,2847,2548,2432,1692,16471
96720,48182,47938,47115,47109,47796,49342,46165,333647
96722,2286,2629,2689,2633,2604,2573,2484,17898
96725,3492,3475,4091,3995,4215,3946,3592,26806
96726,878,862,864,825,579,562,661,5231
96727,5739,5575,6028,5625,5043,5039,4878,37927
96728,498,427,496,554,553,718,610,3856
96729,1374,1242,1327,1249,1003,1000,1303,8498
96730,1287,1276,1321,1200,1226,1176,1541,9027
96731,3194,3085,2785,3034,3148,3155,3292,21693
96732,28074,26622,25770,25065,24808,24062,24816,179217
96734,52340,52811,53555,53068,52650,51949,50746,367119
96737,4477,4302,3955,3766,3664,3897,4552,28613
96738,6593,6619,7070,6785,6353,6667,6609,46696
96740,37192,36655,35334,35818,37265,35361,33321,250946
96741,6350,5770,5422,5601,5277,5162,5929,39511
96742,91,85,73,71,66,57,90,533
96743,13357,13294,12177,12113,11377,11773,12160,86251
96744,53761,52221,52637,53818,53095,52837,54247,372616
96746,19478,19139,18682,18195,17465,17894,18319,129172
96747,908,940,1007,918,794,802,749,6118
96748,4453,4300,4086,4232,4284,4741,4503,30599
96749,18088,17764,17852,16095,15588,13984,17047,116418
96750,3503,3616,3516,3817,3627,3267,3793,25139
96751,70,50,128,130,176,128,175,857
96752,3237,3211,2933,3234,3248,3410,3680,22953
96753,27855,28134,28485,28182,28097,26956,26892,194601
96754,3467,4012,4361,4198,4524,4337,4084,28983
96755,3404,3057,2949,2803,2727,2709,3575,21224
96756,5766,5546,5693,5450,5557,5442,5190,38644
96757,698,756,734,780,836,709,758,5271
96759,442,431,488,689,682,548,457,3737
96760,2562,2645,2287,2424,2453,2583,3001,17955
96761,22355,21954,21825,20826,19717,20035,22156,148868
96762,6061,5811,5675,5749,5767,5763,6419,41245
96763,3455,3539,3526,3315,3429,3460,3135,23859
96764,685,626,635,743,844,787,799,5119
96765,560,633,580,517,413,381,553,3637
96766,18024,17608,16550,15780,16226,15452,14683,114323
96768,17787,17825,17647,17353,17687,18649,17668,124616
96769,356,317,361,364,323,324,464,2509
96770,849,823,738,771,686,848,691,5406
96771,7820,7073,7033,6576,6185,6304,8339,49330
96772,2471,2126,2303,2298,2165,1679,2304,15346
96773,148,158,132,180,238,170,210,1236
96774,289,239,336,376,408,270,342,2260
96776,1489,1667,1448,1646,1987,1996,1490,11723
96777,1444,1501,1382,1442,1333,1405,1479,9986
96778,14481,14375,14565,14056,13334,13518,14409,98738
96779,3052,2998,2854,2805,2704,2775,3088,20276
96780,721,760,813,799,711,559,557,4920
96781,1588,1647,1784,1917,2140,2032,1670,12778
96782,40318,40444,40632,41139,39561,38996,40496,281586
96783,1999,2057,2191,2149,2066,2138,2060,14660
96785,2580,2506,2674,2597,2589,2361,2646,17953
96786,45277,46611,45280,43264,39677,37041,40859,298009
96789,54237,54351,54320,54731,54479,55351,54129,381598
96790,9465,9581,8750,8549,8734,8331,8065,61475
96791,7609,7361,7528,6974,7790,7566,8014,52842
96792,48302,48350,47774,46812,46723,46875,48519,333355
96793,31770,31366,31627,31125,30565,29793,29549,215795
96795,10781,10685,10508,10519,10037,10151,10034,72715
96796,1804,1690,1898,1857,1824,1583,1881,12537
96797,76020,75196,75350,74752,75313,75988,72289,524908
96813,23105,22391,22041,22118,23134,22191,22881,157861
96814,18710,18680,18846,18195,18601,18340,18721,130093
96815,26839,27812,29480,29784,31274,31496,31470,208155
96816,50118,50378,50656,51209,51067,49766,49368,352562
96817,57413,57405,55601,55812,56018,54848,54628,391725
96818,58458,57281,55380,51522,51220,49735,50586,374182
96819,54989,55043,53482,52416,50175,48762,49492,364359
96821,19077,18914,19415,19652,19827,20121,19856,136862
96822,45908,45979,46195,45292,44980,44731,45007,318092
96825,29151,29416,29770,30142,29661,29750,30263,208153
96826,31385,31143,31346,30698,31619,31483,30842,218516
96850,0,0,0,0,0,0,0,0
96853,578,588,349,308,252,235,462,2772
96857,2879,2889,2858,2691,2544,2385,2522,18768
96859,124,134,0,0,0,0,156,414
96860,1915,1848,1192,1091,924,758,1124,8852
96863,46,51,27,24,25,0,52,225
97001,373,297,364,306,288,235,229,2092
97002,5989,5887,5412,5556,5781,5199,5623,39447
97004,4022,4338,4333,4735,4860,4309,4388,30985
97005,26437,26248,25523,24655,23745,23744,24906,175258
97006,69158,67918,67004,65482,64347,63113,63036,460058
97007,71711,71664,70228,69469,69030,67737,66954,486793
97008,29036,29258,29642,29684,29750,28923,28969,205262
97009,8231,7933,7476,7423,7998,8256,7762,55079
97011,623,754,831,854,712,677,582,5033
97013,23389,23417,23316,23269,23219,22699,22688,161997
97014,1266,1116,1184,1129,1109,1116,1288,8208
97015,21677,20807,20190,20872,19894,18870,19521,141831
97016,6282,6442,6519,6714,6551,6671,6083,45262
97017,2867,3010,2411,2462,2506,3015,2922,19193
97018,2151,2419,2351,2276,2147,1947,1952,15243
97019,2978,3123,3417,3573,3168,3145,3161,22565
97020,955,962,857,750,692,787,791,5794
97021,1263,1125,939,843,758,695,1089,6712
97022,3105,3106,3430,3208,3241,3200,3722,23012
97023,10894,10457,10570,10759,10333,10001,9832,72846
97024,10339,10443,10103,9914,9907,9739,10242,70687
97026,4419,4228,4000,3917,3952,3329,3815,27660
97027,12456,12365,12401,12434,12455,12346,12131,86588
97028,136,120,81,139,133,120,217,946
97029,261,291,324,295,330,378,285,2164
97030,38105,38147,38011,37723,37265,36324,36693,262268
97031,19322,19210,18990,18762,18674,18309,18375,131642
97032,4946,4958,4978,4749,4815,4795,5043,34284
97033,64,54,67,72,43,63,60,423
97034,19165,19290,19201,18962,18891,18301,18905,132715
97035,24630,24085,23762,23925,23820,24338,23912,168472
97037,1032,1003,1028,887,882,817,849,6498
97038,15758,15691,16178,15085,15265,14814,15113,107904
97039,616,568,514,540,411,403,472,3524
97040,1494,1156,1146,1218,1254,1136,1244,8648
97041,2350,2471,2492,2603,2522,2601,2817,17856
97042,3823,3676,3542,3246,3448,3147,2923,23805
97045,54297,52746,52182,51040,50773,50552,51359,362949
97048,6622,6759,6588,6405,6728,6718,6691,46511
97049,1764,1816,1864,1696,1967,2195,1899,13201
97050,229,242,244,225,262,302,272,1776
97051,15783,15536,15536,15744,15904,15852,15957,110312
97053,3045,2921,3020,2955,3124,2900,3247,21212
97054,1860,1701,1415,1393,1243,1239,1579,10430
97055,18039,17251,17303,16506,15957,15866,17350,118272
97056,11742,11271,11555,11572,11380,11370,11497,80387
97057,7,6,7,7,13,8,36,84
97058,19775,19984,20024,20274,20305,20521,19838,140721
97060,22663,22379,21739,21530,21305,20796,21226,151638
97062,28458,28066,27475,27625,27309,27008,27434,193375
97063,949,1084,990,880,842,913,1074,6732
97064,3385,3505,3492,3430,3575,3724,3464,24575
97065,535,640,641,733,819,762,676,4806
97067,2353,2540,2373,1873,1835,1794,2138,14906
97068,29481,28750,28983,28747,28303,28190,28305,200759
97070,23389,22877,22154,21921,21114,20749,20957,153161
97071,28604,28578,28907,28527,28716,29047,28803,201182
97080,42486,41542,40501,40718,40102,39927,40888,286164
97086,28373,28001,27466,26425,25919,26163,26010,188357
97089,12692,12215,12140,11998,11689,11682,11986,84402
97101,3744,3738,3684,3903,4056,4132,3794,27051
97102,182,173,242,234,246,189,205,1471
97103,17620,17587,17138,17085,17036,17215,16859,120540
97106,4836,4812,4549,4133,4153,4457,4550,31490
97107,1670,1612,1650,1567,1395,1413,1530,10837
97108,360,387,339,409,430,416,490,2831
97109,608,515,744,825,744,746,577,4759
97110,1358,1173,1313,1305,1173,1015,1284,8621
97111,3683,3561,3363,3471,3064,2882,3156,23180
97112,2275,2193,2202,2000,1949,1912,1901,14432
97113,14440,14275,14051,14262,14134,14002,14155,99319
97114,4927,5082,5100,4935,4980,4606,4762,34392
97115,4137,4116,4030,4073,3908,3954,4139,28357
97116,25954,26139,25346,24816,24440,24558,24104,175357
97117,504,483,491,412,407,561,679,3537
97118,820,782,805,736,736,728,775,5382
97119,4180,4447,4518,4377,4486,4522,4420,30950
97121,1644,1659,1567,1498,1469,1470,1383,10690
97122,419,381,471,616,651,659,460,3657
97123,47729,46204,45660,45035,44019,42246,44537,315430
97124,52026,50601,49358,48406,48132,48520,48349,345392
97125,64,74,88,204,217,228,157,1032
97127,3885,3824,3770,3733,3709,3644,3740,26305
97128,37986,37269,36995,36250,36276,35804,36141,256721
97130,334,430,442,457,438,385,710,3196
97131,2458,2453,2549,2719,2751,2588,2498,18016
97132,29367,29039,28885,28687,28162,27999,28278,200417
97133,3826,4251,4336,4558,4514,4205,4000,29690
97134,237,239,106,106,95,77,175,1035
97135,835,815,748,696,963,1069,861,5987
97136,1632,1649,1589,1545,1532,1402,1761,11110
97137,1300,1415,1392,1404,1372,1423,1307,9613
97138,9761,9684,10050,9996,10019,9911,10021,69442
97140,25049,24649,24474,23697,23309,22701,23474,167353
97141,13597,13605,13495,13675,13607,13797,13140,94916
97144,113,114,128,186,194,95,195,1025
97145,315,376,229,248,200,242,441,2051
97146,6009,5838,5824,5795,5898,5822,5905,41091
97147,422,397,349,358,273,378,408,2585
97148,3404,3218,3295,3096,3485,3891,3406,23795
97149,468,407,513,361,345,400,574,3068
97201,16946,16688,15732,15133,14744,14511,15484,109238
97202,41719,41193,39901,39229,38951,38334,38762,278089
97203,33715,32628,32033,31895,30003,30214,31042,221530
97204,1033,1032,1275,1387,1557,1538,1036,8858
97205,7262,7068,6957,6736,6526,6503,7688,48740
97206,49935,48723,48448,48384,47544,46663,47596,337293
97208,0,0,0,0,0,0,0,0
97209,15578,15486,15519,14698,14095,13181,14950,103507
97210,11371,11574,11708,11422,10836,10680,10887,78478
97211,34303,33454,33014,32376,30731,29974,31254,225106
97212,26256,25676,24498,24433,24565,24101,24126,173655
97213,31889,30869,30597,30186,29940,29805,29219,212505
97214,25024,24578,24673,24072,24399,23511,23813,170070
97215,17499,16893,16165,16158,16302,16035,16375,115427
97216,16863,16216,16381,16445,15572,14800,15594,111871
97217,32371,32275,31708,31929,31170,31553,31438,222444
97218,15454,15611,15325,15252,15335,15039,14561,106577
97219,40946,41085,39966,39392,39061,38727,38709,277886
97220,29810,29776,29730,28847,29397,28717,28495,204772
97221,12615,12323,12241,12348,11853,11845,11630,84855
97222,35866,36222,35323,35108,34608,35527,34979,247633
97223,49348,47747,46538,46574,46095,44437,46699,327438
97224,33442,33022,32538,31981,31658,32785,31122,226548
97225,25519,25658,26118,25737,25684,24749,24176,177641
97227,4433,4530,4393,4111,4052,3936,3847,29302
97229,63867,62132,60679,59983,57851,56876,58217,419605
97230,40433,41029,40997,40197,41010,40137,39752,283555
97231,3655,3740,3842,4131,4269,4356,4280,28273
97232,12545,12038,11838,11784,11404,11339,11472,82420
97233,41697,41332,41571,39849,39263,39108,39367,282187
97236,39237,38663,37418,37033,36217,35375,36852,260795
97239,16190,15950,15906,15530,15349,14838,14150,107913
97266,35299,35181,34119,33933,33185,32431,33300,237448
97267,31526,31841,31665,31897,32173,31337,30839,221278
97301,54743,54844,54972,55437,53608,52884,53518,380006
97302,38093,37800,38091,37969,37725,38436,37131,265245
97303,39234,38811,38718,38694,38480,37965,38663,270565
97304,30795,30124,29493,28871,28834,28094,28454,204665
97305,41790,40585,39617,38466,38212,38354,40176,277200
97306,29654,29307,27748,27820,27611,26983,27360,196483
97317,24257,24490,25415,24921,24888,25332,24355,173658
97321,26729,25614,25468,24852,24617,24395,24928,176603
97322,34388,35303,35032,34766,34558,33834,34039,241920
97324,1213,1107,1179,1237,1281,1184,1126,8327
97325,7191,6963,7046,6980,6729,6493,6614,48016
97326,1026,944,984,953,1012,1053,961,6933
97327,3089,2907,2969,2784,2875,3066,2871,20561
97329,202,153,124,56,93,103,90,821
97330,41913,41572,41976,42120,41947,41833,41472,292833
97331,2726,2494,2449,2488,2405,2363,2408,17333
97333,21545,21492,20875,20867,21144,21004,21377,148304
97338,20491,20236,20093,20176,19895,20234,20045,141170
97341,2353,2527,2721,2650,2505,2604,2325,17685
97342,171,216,255,168,177,218,267,1472
97343,219,128,198,292,381,649,434,2301
97344,1082,1130,1082,1178,1276,1272,1076,8096
97345,362,397,308,319,337,310,574,2607
97346,757,787,911,966,1013,1020,883,6337
97347,2034,2007,1832,1726,1585,1703,1878,12765
97348,1697,1883,1752,1863,1518,1593,1625,11931
97350,206,227,166,161,285,294,182,1521
97351,10067,9965,9992,10118,10014,9870,10307,70333
97352,6963,6623,6226,6094,5920,5460,5604,42890
97355,28774,28386,28120,28234,28206,28027,28613,198360
97357,261,246,285,310,150,180,253,1685
97358,2641,2584,2323,2315,2381,2456,2576,17276
97360,2405,2413,2244,2144,2142,1996,2249,15593
97361,11889,11722,11781,11286,11279,10938,11258,80153
97362,4197,4171,4251,4161,4163,4310,4338,29591
97364,811,950,922,846,847,566,446,5388
97365,11052,11008,10943,10863,10779,11099,10744,76488
97366,1435,1287,1252,1301,1214,1256,1460,9205
97367,9283,9236,9220,9358,9062,9126,9416,64701
97368,3427,3477,3416,3349,3604,3614,3435,24322
97369,186,186,225,300,325,322,193,1737
97370,8206,8179,8023,7931,8037,8049,8271,56696
97371,504,530,500,721,709,839,730,4533
97373,194,195,172,190,199,162,178,1290
97374,5787,5900,5993,5636,5284,4912,5266,38778
97375,1514,1566,1478,1149,1026,1047,1252,9032
97376,1260,1361,1281,1297,1266,1172,1301,8938
97377,658,592,642,1018,1233,1174,917,6234
97378,8286,8203,8393,8483,8479,8459,8882,59185
97380,3110,3174,2941,2604,2945,2585,2449,19808
97381,15189,14911,14987,15193,15365,15011,14711,105367
97383,9444,9441,9633,9781,9831,9918,9587,67635
97384,0,0,0,0,0,0,23,23
97385,3212,3368,3310,3121,3123,3154,3257,22545
97386,14347,13944,13963,14236,13639,13637,13567,97333
97388,534,643,799,876,738,878,888,5356
97389,1757,1723,1802,1576,1694,1734,1676,11962
97390,817,640,594,409,706,659,555,4380
97391,5065,4923,4976,5030,5103,5178,5344,35619
97392,6074,5708,4808,5156,5426,5068,5191,37431
97394,4908,4387,4109,4236,4012,3871,4643,30166
97396,2971,2871,2841,2827,2880,2712,3154,20256
97401,41610,40414,40428,40482,39955,40401,40521,283811
97402,52041,51363,50831,51025,50797,50088,50342,356487
97403,12590,12566,12397,12374,12481,12179,11622,86209
97404,32792,32860,32973,33229,32682,32322,32255,229113
97405,46593,46616,45516,44220,43685,43839,44645,315114
97406,26,44,55,108,94,123,105,555
97408,12112,11815,11715,11654,11470,11254,11711,81731
97410,852,727,697,705,761,677,759,5178
97411,7476,7365,7496,7093,6444,6010,6953,48837
97412,487,463,499,527,542,481,521,3520
97413,784,891,986,1063,1076,1010,915,6725
97414,338,266,185,216,211,74,273,1563
97415,13816,13773,13738,14146,13610,14364,14051,97498
97416,1259,1247,957,925,883,937,937,7145
97417,2762,2835,2627,2577,2522,2253,2439,18015
97419,1162,1239,1248,1336,1471,1464,1066,8986
97420,27496,27265,26607,26761,27785,27423,27473,190810
97423,6345,6803,6884,7112,7238,7478,6809,48669
97424,18036,17755,17766,17111,17068,17220,17594,122550
97426,9276,9639,9610,9661,9704,9904,9716,67510
97429,779,816,743,653,581,601,684,4857
97430,342,358,343,256,294,336,385,2314
97431,2591,2384,2353,2450,2373,2125,2335,16611
97434,804,850,807,831,848,1255,928,6323
97435,2086,2186,2184,2108,2169,2088,2349,15170
97436,888,839,861,857,870,936,841,6092
97437,2598,2530,2501,2421,2548,2614,2572,17784
97438,950,951,1015,1041,1126,1284,1191,7558
97439,14232,14303,14303,14715,14795,14317,14343,101008
97441,190,207,195,202,94,96,260,1244
97442,1956,1864,1968,2159,2083,2191,2232,14453
97443,2376,2280,2386,2404,1942,1851,2232,15471
97444,5364,5251,5332,4711,5266,4765,5181,35870
97446,5173,4890,4847,4862,5187,5155,4812,34926
97447,710,764,738,841,883,798,794,5528
97448,12312,12597,12308,12441,11954,12187,12244,86043
97449,1910,1789,1911,1965,1760,1984,1959,13278
97450,502,563,598,732,749,641,671,4456
97451,388,346,324,401,466,389,387,2701
97452,1659,1747,1667,1466,1399,1273,1420,10631
97453,893,841,731,708,693,676,897,5439
97454,1410,1551,1507,1476,1464,1479,1337,10224
97455,2672,2515,2552,2580,2662,2259,2538,17778
97456,2880,3002,3118,3227,2944,2862,2985,21018
97457,9872,9628,9678,9710,9916,10013,10208,69025
97458,4653,4592,4347,4184,4206,4642,4733,31357
97459,13819,13843,14275,14341,14301,14636,14096,99311
97461,927,753,733,559,607,499,683,4761
97462,3901,3621,3846,4074,4013,3892,3938,27285
97463,3739,3803,3729,3736,3809,3864,3877,26557
97465,2454,2602,2494,2618,2542,2381,2145,17236
97466,930,908,1037,1142,1115,1021,816,6969
97467,4949,5042,5168,5308,5280,5281,5339,36367
97469,2695,2676,2739,2566,2498,2431,2596,18201
97470,20035,20320,20074,19972,20153,20042,19985,140581
97471,29369,29924,30390,30300,30748,31103,29100,210934
97473,304,297,290,304,350,381,328,2254
97476,202,105,124,46,83,99,217,876
97477,37074,36403,36833,36962,36886,36347,36874,257379
97478,38743,38604,38205,37934,37798,37400,37011,265695
97479,9516,9535,9529,9314,9419,9312,9505,66130
97480,288,286,341,334,305,344,379,2277
97481,603,495,595,471,619,621,679,4083
97484,187,226,235,280,266,298,235,1727
97486,750,599,538,566,507,531,714,4205
97487,8337,8216,8122,7884,8019,8349,8449,57376
97488,1080,1035,1096,1051,811,801,1011,6885
97489,816,885,646,706,793,830,868,5544
97490,360,252,371,464,407,374,326,2554
97492,770,644,667,642,694,644,597,4658
97493,296,247,225,258,369,403,323,2121
97494,29,29,0,0,0,0,49,107
97495,1689,1425,1026,1157,1032,1130,1450,8909
97496,7349,7163,7141,7353,7147,7201,7634,50988
97497,1639,1747,2076,1952,2043,2094,1523,13074
97498,1584,1779,1875,2007,1836,1700,1814,12595
97499,1882,1961,1963,1922,2038,1921,1957,13644
97501,44558,44381,43864,43209,42391,40579,42117,301099
97502,28735,27982,28282,27993,27797,27204,27694,195687
97503,12188,12592,11610,10890,10208,10460,10528,78476
97504,46980,45257,44807,45144,44802,45106,44444,316540
97520,25274,24970,24705,24689,24541,24431,24469,173079
97522,488,528,600,590,715,729,658,4308
97523,6628,6327,6783,6323,5793,5556,6264,43674
97524,13796,13446,14197,13231,13433,13421,14459,95983
97525,4244,4349,4422,4419,4186,4599,4601,30820
97526,34399,34914,34290,35208,34808,34328,34205,242152
97527,34606,33948,33880,33322,33363,33543,33713,236375
97530,6363,6586,6697,7283,7141,7096,6916,48082
97531,778,709,311,212,397,482,522,3411
97532,2349,2442,2455,2343,2244,2385,2378,16596
97534,679,440,279,339,250,356,756,3099
97535,5383,5742,5502,5382,5388,5245,5047,37689
97536,1126,1017,1044,1028,1021,1117,965,7318
97537,7632,7300,6798,7012,7628,7458,6918,50746
97538,1558,1729,1653,1671,1999,2125,2063,12798
97539,3280,3397,3432,3490,3373,3364,3329,23665
97540,8143,8061,8065,8168,8250,8333,7930,56950
97541,1325,1073,813,897,835,920,1478,7341
97543,573,688,801,734,1177,1070,736,5779
97544,2255,2147,2238,2371,2466,2633,2206,16316
97601,21937,21962,21616,22540,22748,22706,22459,155968
97603,29435,29587,29689,29450,29360,30326,29525,207372
97604,147,151,130,90,70,51,28,667
97620,181,166,104,84,59,77,111,782
97621,182,180,262,203,323,345,320,1815
97622,389,456,459,407,431,340,558,3040
97623,2380,2422,2365,2446,2402,2312,2310,16637
97624,3410,3391,3242,2998,3093,3141,3500,22775
97625,380,205,207,224,182,154,199,1551
97626,114,183,209,203,205,107,88,1109
97627,876,816,870,827,852,690,780,5711
97630,5319,5190,5409,5142,5080,5020,5096,36256
97632,1589,1471,1431,1363,1333,1281,1466,9934
97633,1224,1300,1437,1416,1379,1326,1361,9443
97634,187,258,430,330,265,290,212,1972
97635,196,326,303,464,536,709,289,2823
97636,492,495,437,497,485,489,387,3282
97637,68,65,54,87,107,147,76,604
97638,357,414,367,470,498,553,507,3166
97639,688,486,514,497,527,512,570,3794
97640,98,101,94,72,133,143,99,740
97641,1107,1065,1073,1045,1045,906,1313,7554
97701,63734,62227,60788,58602,59089,59008,58993,422441
97702,45529,43594,42260,42272,41433,40708,40583,296379
97707,6388,6375,6156,5971,5863,5279,5814,41846
97710,157,175,161,180,172,187,120,1152
97711,81,75,119,123,132,132,61,723
97712,10,26,58,65,87,55,38,339
97720,4330,4349,4098,4106,4217,4199,4530,29829
97721,386,407,395,610,484,397,271,2950
97722,99,77,83,88,135,125,91,698
97730,250,353,396,363,331,381,252,2326
97731,239,401,531,506,444,384,278,2783
97732,170,172,215,188,193,162,139,1239
97733,327,391,581,678,715,816,770,4278
97734,2839,2742,3020,3091,2976,2896,2786,20350
97735,92,141,163,136,155,170,165,1022
97736,114,123,117,175,111,77,73,790
97737,696,444,402,356,293,310,496,2997
97738,1611,1579,1856,1644,1766,2001,1941,12398
97739,11039,11038,10807,11142,10779,10858,11018,76681
97741,12009,11989,11787,11616,11976,11871,11912,83160
97750,344,362,366,366,377,319,386,2520
97751,32,47,66,136,136,133,129,679
97752,36,39,43,43,14,0,44,219
97753,1981,1927,1768,1969,2212,2261,2016,14134
97754,18978,18657,18631,18512,18467,18736,18574,130555
97756,36882,36319,35822,34639,34020,32999,33554,244235
97758,116,117,113,117,75,66,101,705
97759,6220,6239,6287,6675,6478,6728,6294,44921
97760,6458,6315,6177,6082,6295,6493,6757,44577
97761,4537,4416,4129,4116,3912,3614,3987,28711
97801,21243,21533,21843,21829,21478,21699,21521,151146
97810,758,797,787,794,780,773,815,5504
97812,913,847,876,968,894,920,851,6269
97813,1257,1217,1233,1120,1240,1138,1302,8507
97814,12265,12500,12268,12215,12420,12654,12382,86704
97817,14,23,39,39,34,34,38,221
97818,4344,4235,4181,4010,3827,3926,4159,28682
97819,30,31,27,26,25,29,29,197
97820,1081,1079,983,789,947,952,1095,6926
97823,923,961,966,844,927,930,948,6499
97824,1930,1847,1922,1891,2010,1861,1661,13122
97825,313,296,282,269,261,247,244,1912
97826,1070,1047,980,1016,990,926,1085,7114
97827,2298,2471,2558,2380,2306,2425,2628,17066
97828,3061,3000,2902,2978,2854,2779,3124,20698
97830,719,740,739,686,595,534,748,4761
97833,1125,1072,1087,950,976,782,895,6887
97834,827,758,883,942,981,918,986,6295
97835,332,346,376,444,423,459,361,2741
97836,1963,2000,1972,2030,2148,2137,1983,14233
97837,72,59,85,94,69,84,95,558
97838,26202,25948,25584,25598,25511,25213,25346,179402
97839,333,398,546,484,539,582,475,3357
97840,158,182,168,173,95,72,98,946
97841,542,546,444,402,417,387,476,3214
97842,137,141,159,176,164,272,153,1202
97843,607,635,660,675,637,551,647,4412
97844,3918,3859,3717,3860,3859,3666,3806,26685
97845,2588,2678,2635,2606,2767,2933,2652,18859
97846,1804,1888,1949,1866,1857,1833,1891,13088
97848,241,236,252,233,236,212,195,1605
97850,16833,16705,16881,17095,16708,16933,16955,118110
97856,293,365,415,406,426,482,366,2753
97857,714,649,598,576,559,540,457,4093
97859,5,60,63,74,77,87,123,489
97862,11454,11842,11952,12033,11767,11826,11666,82540
97864,190,182,218,253,277,270,262,1652
97865,1208,1109,1166,1224,1068,880,1160,7815
97867,896,914,888,887,898,718,763,5964
97868,1885,1977,2072,1998,2027,2071,1991,14021
97869,1077,1057,1115,1331,1159,1124,1135,7998
97870,512,472,405,419,382,392,573,3155
97873,180,188,148,131,125,157,228,1157
97874,369,308,307,302,353,378,349,2366
97875,2944,2798,2814,2707,2689,2742,2610,19304
97876,836,853,875,914,1078,998,837,6391
97877,266,235,240,192,172,176,283,1564
97880,323,264,249,201,183,191,272,1683
97882,7812,7769,7610,7404,7696,7345,7760,53396
97883,2438,2478,2266,2380,2428,2311,2473,16774
97884,189,171,163,117,124,124,157,1045
97885,1120,1179,1285,1328,1504,1525,1383,9324
97886,1360,1237,1258,1262,1132,1124,1140,8513
97901,742,587,590,610,612,593,692,4426
97903,199,220,221,173,137,160,109,1219
97904,193,205,224,196,172,156,176,1322
97905,160,167,236,208,148,243,133,1295
97906,266,279,297,253,292,283,249,1919
97907,419,411,416,542,552,622,560,3522
97908,49,54,52,70,63,56,56,400
97909,90,102,8,8,22,25,51,306
97910,550,600,607,617,717,741,641,4473
97911,71,66,73,60,58,50,109,487
97913,5341,5527,5638,5678,5534,5553,5531,38802
97914,18774,18451,18518,18726,19234,19343,19205,132251
97918,4201,4464,4587,4569,4348,4453,4537,31159
97920,165,156,108,95,22,12,60,618
98001,31664,32194,31742,33655,32403,32076,31911,225645
98002,33991,33817,34240,33281,32826,31653,31647,231455
98003,47407,46008,45632,45131,43564,43829,44151,315722
98004,33124,32587,31254,30072,27978,26754,27946,209715
98005,18059,17733,17880,17346,16892,17276,17714,122900
98006,37819,37519,37059,36327,37858,36878,36364,259824
98007,27050,26269,25521,24926,25434,25231,24889,179320
98008,24763,24751,24452,24408,24544,24399,24411,171728
98010,5143,4918,4789,4825,4827,4667,5025,34194
98011,31674,31650,30787,30069,30539,30105,29212,214036
98012,58206,56010,53837,52351,51109,50265,51136,372914
98014,6946,6973,6902,7211,6851,6922,6765,48570
98019,11272,11143,10815,10964,10564,10342,10725,75825
98020,19996,20101,19109,18561,18678,18951,18304,133700
98021,29885,29151,28593,27547,26209,25238,26722,193345
98022,21908,21567,21353,21670,21335,20752,20987,149572
98023,50333,50065,49402,48964,48937,47949,47510,343160
98024,6220,5847,5988,5921,5888,5705,5650,41219
98026,36844,35638,36173,36370,35426,34760,35921,251132
98027,28879,27855,27147,27909,27685,27388,26141,193004
98028,21791,21568,21232,20896,20574,20248,20419,146728
98029,26486,26586,26193,26054,25583,24542,24348,179792
98030,37213,36730,35302,33074,30864,28600,33769,235552
98031,36990,36390,36953,35936,33874,32573,36581,249297
98032,36414,36368,35935,33791,31733,29531,33853,237625
98033,37629,36105,35605,32502,34130,33761,34338,244070
98034,42665,42590,42335,38234,43130,42855,40407,292216
98036,38536,38532,37380,36597,35336,35032,36000,257413
98037,28359,27994,27676,27546,28064,27794,26889,194322
98038,34932,34362,34076,33468,31881,30970,31171,230860
98039,3169,3120,3080,3024,2996,2967,2971,21327
98040,24467,24120,23636,23301,22922,22592,22699,163737
98042,45860,44894,44599,43666,42368,40316,43673,305376
98043,20774,20557,20358,20195,20066,20074,19943,141967
98045,14484,14635,14643,13898,13912,13415,13888,98875
98047,6775,6676,6457,6495,6399,6328,6339,45469
98050,186,114,208,176,174,208,322,1388
98051,3320,3677,3402,3852,3930,3487,3270,24938
98052,63724,62216,60920,59822,58681,57812,58442,421617
98053,21809,21185,20739,21816,20872,19746,18784,144951
98055,22906,22659,21532,21660,20839,20386,21904,151886
98056,35140,33944,33878,33492,32487,31106,32489,232536
98057,12963,13204,12187,10875,10948,10153,10613,80943
98058,43747,44430,42764,43971,43758,42986,41938,303594
98059,37217,36409,36504,37181,35990,35562,34463,253326
98065,14642,13977,13202,12690,12502,12007,12699,91719
98068,256,259,240,366,348,292,403,2164
98070,9844,10189,10447,11122,10854,10759,10624,73839
98072,23006,22779,22485,22370,22078,22025,22312,157055
98074,27184,26530,26386,26158,24792,25040,25748,181838
98075,23413,23363,22483,21408,21441,20771,20715,153594
98077,14678,14246,14154,14885,14283,13792,13585,99623
98087,36649,34603,32833,31120,30525,29936,29976,225642
98092,43156,42380,40610,39964,39119,39264,39816,284309
98101,12044,11291,10803,10643,9851,9426,10238,74296
98102,24030,23655,22776,22493,21805,20983,20756,156498
98103,49364,48600,47559,47019,44766,44639,45911,327858
98104,13989,13690,13177,12871,12630,12191,13095,91643
98105,46514,45515,44981,45332,45268,44647,43924,316181
98106,25846,24603,25023,23855,23380,22230,22873,167810
98107,24179,23488,22772,21996,21793,21182,21147,156557
98108,24351,24681,24220,24026,23587,22583,22374,165822
98109,25906,24450,22401,22030,21221,20490,20715,157213
98110,23576,23343,23206,23084,22933,22700,23025,161867
98112,23082,22230,22290,21622,21678,21900,21077,153879
98115,50258,50134,48558,47611,46336,45667,46206,334770
98116,25234,23968,23780,23671,23056,22255,22241,164205
98117,32682,31921,31778,30719,31391,30042,31365,219898
98118,44686,44839,44440,43618,43765,44554,42731,308633
98119,24567,23912,23506,22360,21971,21181,21039,158536
98121,14678,13474,12753,12183,11914,11551,12628,89181
98122,35445,35052,34054,32722,31287,30956,31454,230970
98125,39692,39254,37560,36644,36028,36581,37081,262840
98126,22632,22849,21648,20631,20448,20078,20698,148984
98133,47522,46329,46227,46405,44307,43530,44555,318875
98134,847,797,850,856,915,872,644,5781
98136,16090,15415,15302,14899,14544,14573,14770,105593
98144,30090,28302,27496,26429,26329,25487,26881,191014
98146,27456,26730,25722,25281,24572,26234,25922,181917
98148,11257,10659,10207,10521,9504,10882,10010,73040
98154,0,0,0,0,0,0,0,0
98155,34174,34081,33850,32942,32805,32467,32778,233097
98158,0,0,0,0,0,0,0,0
98164,135,106,73,57,29,101,141,642
98166,21018,21087,21187,20154,18706,19659,20301,142112
98168,32605,32569,33604,33585,32677,33416,33734,232190
98174,0,0,72,63,57,55,0,247
98177,19925,19328,18867,18642,19476,20080,19030,135348
98178,26251,25363,23866,24844,24559,23505,24092,172480
98188,24912,24836,24373,23478,22916,22958,23111,166584
98195,52,45,39,29,12,4,0,181
98198,36768,36495,35748,35197,35353,34943,34584,249088
98199,21017,20871,20548,20623,20308,20308,19686,143361
98201,28437,27806,28380,28423,28466,28704,29582,199798
98203,34628,35046,34901,35378,34633,34416,34354,243356
98204,41576,41441,41337,40843,40850,38927,39380,284354
98205,12783,12644,11957,11845,11353,11512,12283,84377
98207,1440,1380,1173,1346,1553,1566,758,9216
98208,56922,55775,53600,52683,50834,49945,51802,371561
98220,849,592,733,667,742,674,634,4891
98221,20860,20510,20466,20305,20340,20355,20429,143265
98222,48,47,53,44,44,52,33,321
98223,41489,41315,41037,40833,40293,39403,40815,285185
98224,233,260,261,315,280,260,294,1903
98225,49240,48720,47032,46251,45783,45743,46172,328941
98226,41740,41453,41445,41481,41464,40048,41235,288866
98229,30812,30492,31522,31119,30862,30993,30321,216121
98230,15906,15762,16080,15753,16136,15933,15710,111280
98232,4113,3875,3568,3858,3458,3203,3920,25995
98233,14896,14799,14429,14287,14839,15058,14871,103179
98235,57,69,46,50,97,211,103,633
98236,6004,5732,5840,5959,6244,6040,5635,41454
98237,4370,4348,4106,3990,4052,4143,4025,29034
98238,11,10,12,39,70,79,85,306
98239,7113,6709,7020,6969,6758,6542,6646,47757
98240,3099,2824,2862,3346,3140,2925,3061,21257
98241,2041,2200,2173,2328,2069,2077,2129,15017
98243,472,520,406,330,370,364,507,2969
98244,3108,3049,2912,2653,2922,2387,3001,20032
98245,3854,3849,3746,3651,3494,3362,3651,25607
98247,10391,10263,10458,10016,9379,9744,9072,69323
98248,23163,23167,22741,22518,22117,22437,22361,158504
98249,4146,4472,4435,4571,4394,4464,4561,31043
98250,7683,7483,7771,7929,8050,8292,7664,54872
98251,4259,4804,4737,4839,5011,5049,4567,33266
98252,9459,9169,9167,8747,8233,8089,8777,61641
98253,1722,1755,1776,1668,1719,1627,1837,12104
98255,137,180,196,360,369,390,245,1877
98256,407,406,510,462,390,448,420,3043
98257,3828,3849,4099,4147,4191,4528,4134,28776
98258,32370,31820,31952,31339,30987,30355,30524,219347
98260,5600,5560,5516,5294,5085,5443,5278,37776
98261,2595,2621,2497,2435,2332,2207,2383,17070
98262,951,965,1079,1098,1044,1098,964,7199
98263,86,83,60,69,70,85,76,529
98264,19932,19306,18096,18319,17963,17355,18893,129864
98266,3566,3735,4043,4310,4198,4527,3642,28021
98267,448,535,516,406,415,495,534,3349
98270,48987,47835,47288,46105,46490,45890,45899,328494
98271,28509,28658,27806,27625,26793,26004,27184,192579
98272,29539,29017,29049,27983,27758,27856,27942,199144
98273,29994,30137,29963,29400,29708,28246,28717,206165
98274,17580,16921,17051,17215,16743,16647,16613,118770
98275,20994,20818,20635,20457,20263,20084,20256,143507
98276,689,760,625,553,561,382,450,4020
98277,37932,37999,37706,37484,37983,37503,37823,264430
98278,1628,1602,1457,1405,938,1363,1065,9458
98279,562,634,610,619,653,585,608,4271
98280,456,415,368,373,352,342,480,2786
98281,1203,1270,1323,1287,1309,1371,1314,9077
98282,15968,15500,15201,15456,15586,15617,15661,108989
98283,328,415,503,574,605,496,434,3355
98284,25940,25641,24583,24427,23475,23333,24331,171730
98286,199,210,221,249,274,263,240,1656
98288,155,175,169,194,178,187,333,1391
98290,34218,33629,32942,33018,33228,32913,32714,232662
98292,21766,21517,21472,21307,21414,20450,20987,148913
98294,6659,6525,6654,6498,6579,6409,6595,45919
98295,2727,2571,2448,2129,2245,2215,2409,16744
98296,29124,28902,29304,28905,28225,28655,27956,201071
98297,64,49,68,83,104,129,106,603
98303,1150,1053,877,904,852,873,1037,6746
98304,602,636,561,720,809,735,759,4822
98305,328,284,234,257,291,212,358,1964
98310,20499,20218,19542,19220,18939,19061,18703,136182
98311,27750,27182,26680,26280,25970,25474,25880,185216
98312,31524,30721,31331,31059,32040,32303,30203,219181
98314,2521,2642,2175,1849,1484,1401,3329,15401
98315,6046,6392,6355,5637,5419,5337,6054,41240
98320,1211,1168,1263,1201,1264,1122,1250,8479
98321,15144,14894,14272,14051,14066,14838,15152,102417
98323,760,619,600,688,742,650,702,4761
98325,1625,1730,1657,1845,1908,1834,1848,12447
98326,679,665,759,955,1113,1173,1412,6756
98327,9285,9192,9006,8672,8205,7694,8267,60321
98328,9300,9761,9526,9469,9714,10423,10433,68626
98329,10682,10741,10581,10330,10176,9402,10545,72457
98330,104,167,167,155,178,166,149,1086
98331,6382,6373,6243,6243,6240,6360,6261,44102
98332,17208,16412,16332,15982,15234,14482,15855,111505
98333,3829,3731,3556,3816,3366,3398,3633,25329
98335,25830,25260,25605,25646,25006,23999,24925,176271
98336,875,964,866,855,858,627,970,6015
98337,6765,6252,6260,6952,7220,7323,6697,47469
98338,26856,25313,24352,23560,23463,22756,24098,170398
98339,3197,3109,3040,3024,3302,3435,3326,22433
98340,3126,2900,2639,2912,2567,2310,2537,18991
98342,1422,1394,1421,1310,1263,1160,1370,9340
98345,442,488,543,466,378,345,554,3216
98346,10016,10206,10531,10300,9777,9292,9297,69419
98349,4509,4698,4415,4304,4281,3688,4614,30509
98350,433,399,448,451,539,501,460,3231
98351,940,666,987,1270,1216,1192,1115,7386
98353,29,29,24,0,0,0,4,86
98354,7128,7167,7201,7136,7114,6937,6976,49659
98355,638,603,563,513,580,559,628,4084
98356,2173,2211,1987,1762,1888,1799,2149,13969
98357,1608,1531,1631,1473,1444,1454,1414,10555
98358,1152,1242,1218,1237,965,905,897,7616
98359,4479,4595,4493,4790,5338,5129,4887,33711
98360,12944,12620,11914,12018,11862,11519,12221,85098
98361,982,887,1043,1010,1384,1316,1158,7780
98362,23026,23165,22558,22052,21515,21953,22230,156499
98363,14210,13915,13927,13866,14108,13617,13343,96986
98364,137,113,121,132,0,26,45,574
98365,4501,4583,4507,4345,4636,4892,4528,31992
98366,32916,33197,33311,33176,34581,35052,34258,236491
98367,28520,28266,27616,28126,27096,26376,27693,193693
98368,15478,15232,14961,14588,14395,13941,14724,103319
98370,29480,29197,28482,28900,28786,29260,29528,203633
98371,20409,20174,19748,20227,20519,20862,20468,142407
98372,24849,24074,23190,22730,22773,21751,22475,161842
98373,22885,23113,23096,22890,22517,22463,22246,159210
98374,38927,39143,38570,37619,38487,38499,37360,268605
98375,29732,28641,28969,27748,27510,29177,26863,198640
98376,1668,1566,1927,2011,1911,2077,1998,13158
98377,1690,1927,1768,1906,1831,1936,1922,12980
98380,4835,5224,5028,4960,4161,3980,4173,32361
98381,350,455,465,654,616,764,371,3675
98382,27454,27063,27164,27411,26966,26546,26856,189460
98383,20319,20055,20816,20479,20438,19969,19727,141803
98385,303,317,395,502,489,498,459,2963
98387,45428,45344,44765,44393,44136,43679,43173,310918
98388,6556,6537,6784,6889,7092,7349,7508,48715
98390,10822,10615,10558,10320,10207,10050,10461,73033
98391,48861,47150,45890,44930,44711,43320,44309,319171
98392,3086,3027,3019,2987,2930,2662,2994,20705
98394,1219,1291,1525,1567,1474,1193,1107,9376
98396,589,574,613,540,522,491,662,3991
98402,6023,6116,6486,6848,6745,6651,6356,45225
98403,7758,7764,7931,7257,7209,7074,7713,52706
98404,34119,33994,33462,32500,32741,31798,32086,230700
98405,24125,23834,23846,22957,22838,22695,22851,163146
98406,23034,22389,21824,22313,22178,22138,21610,155486
98407,21347,20654,20415,21025,20094,20274,19885,143694
98408,19585,18872,18713,19704,19653,19604,18830,134961
98409,23411,23682,23260,23423,23367,24743,22989,164875
98416,995,966,1087,1245,1361,1395,1014,8063
98418,9822,10237,10234,9597,9755,9560,10069,69274
98421,729,303,1,2,28,24,1308,2395
98422,20876,20558,20344,20711,20523,20757,20151,143920
98424,10705,10531,10353,10214,9967,9716,10140,71626
98430,21,18,20,21,0,0,13,93
98433,18335,17951,18416,17906,17860,18355,14584,123407
98438,442,443,259,271,274,316,366,2371
98439,5558,5574,5752,5520,5443,5258,4839,37944
98443,5821,5810,5542,5338,5354,5253,5371,38489
98444,34771,34791,35392,35693,34654,33160,33956,242417
98445,30869,30076,30199,29948,29799,29721,29661,210273
98446,9887,10306,9897,10065,9767,9616,10173,69711
98447,785,814,842,877,849,857,842,5866
98465,6344,6809,6544,6167,6138,5918,6340,44260
98466,27103,27057,26498,26760,26942,26451,26944,187755
98467,16009,15160,15836,14748,14440,14422,14728,105343
98498,27614,26901,27272,27848,28148,27528,27546,192857
98499,30630,31010,30237,29829,29351,29774,29750,210581
98501,41415,40236,40618,40035,39154,39191,38133,278782
98502,31492,30487,30299,30490,30621,30341,30491,214221
98503,37678,36964,36729,35316,36469,37388,36611,257155
98506,18418,18732,18288,17503,17079,17237,18199,125456
98512,29666,29467,28627,29447,28330,27472,28130,201139
98513,34174,34320,33792,33436,32672,32167,31975,232536
98516,22697,22310,21702,21786,20666,18985,20166,148312
98520,23904,23952,23809,23969,24275,24177,23814,167900
98524,4212,3676,3486,3125,2689,2191,3232,22611
98526,258,269,277,269,224,218,398,1913
98527,248,217,204,157,179,236,324,1565
98528,9402,8834,9286,9399,10072,10353,9983,67329
98530,593,622,522,510,580,524,565,3916
98531,25297,24881,24054,23889,23486,23753,24121,169481
98532,24078,23461,23977,23647,23766,24183,23596,166708
98533,514,605,764,810,718,740,609,4760
98535,464,473,461,502,422,249,445,3016
98536,196,162,169,138,114,58,211,1048
98537,2018,2148,2143,2119,2132,2153,2129,14842
98538,236,201,226,284,273,283,304,1807
98541,9799,10041,10178,10339,9958,9984,10101,70400
98542,517,454,459,680,609,686,656,4061
98544,0,0,0,0,0,0,73,73
98546,3118,3600,3356,3488,2931,2922,2909,22324
98547,1114,1154,1086,1586,1619,1776,1436,9771
98548,2466,2507,2389,2360,2387,2009,2193,16311
98550,11194,11218,11311,11616,12064,12204,11382,80989
98552,560,589,625,680,446,529,508,3937
98555,218,357,336,332,282,276,599,2400
98557,3262,3189,3137,3238,3138,3155,3225,22344
98558,318,319,149,207,158,235,192,1578
98559,142,164,157,144,0,0,93,700
98560,180,188,201,164,195,195,142,1265
98562,0,0,73,85,132,139,195,624
98563,7575,7957,8320,8031,8196,8152,8001,56232
98564,2031,2345,2395,2492,2584,2885,2459,17191
98565,768,625,516,617,581,490,618,4215
98568,2714,2781,2784,2687,2701,2669,2519,18855
98569,6126,6000,5923,5890,5759,5596,5784,41078
98570,4174,4397,4161,3952,3801,3851,3889,28225
98571,639,281,293,298,401,456,483,2851
98572,768,703,775,712,608,589,797,4952
98575,142,144,153,198,193,245,228,1303
98576,4883,4552,4691,4685,4297,4186,4667,31961
98577,6752,6535,6649,6680,6880,6957,6338,46791
98579,13894,13422,13494,13367,13276,12539,12870,92862
98580,11046,11207,11090,10676,10013,10252,11099,75383
98581,325,305,216,225,239,285,424,2019
98582,403,495,504,649,716,529,611,3907
98583,94,85,102,69,90,81,124,645
98584,36731,36497,35968,35611,36016,36535,36630,253988
98585,895,845,660,594,538,464,655,4651
98586,1796,1927,2029,1952,1905,1876,1944,13429
98587,779,932,896,895,827,909,942,6180
98588,1570,1711,2165,2278,2122,1960,1829,13635
98589,6944,7447,7142,6637,7050,6930,7320,49470
98590,449,443,432,331,277,276,356,2564
98591,3292,3546,3569,3837,3696,3401,3952,25293
98592,1313,1455,1511,1622,1720,1801,1764,11186
98593,1125,932,926,771,775,882,1113,6524
98595,2780,2606,2474,2229,2406,2210,2917,17622
98596,7027,7333,7670,7772,7741,7473,6524,51540
98597,22489,22126,21840,21333,20957,19879,21557,150181
98601,3316,3144,2643,2345,2492,2361,2982,19283
98602,210,186,96,90,100,65,200,947
98603,1239,1085,1013,836,827,747,1017,6764
98604,35577,35282,34840,34033,33812,33076,34232,240852
98605,1165,1365,1349,1473,1578,1749,1225,9904
98606,9015,9013,9339,8810,8902,9014,9027,63120
98607,30963,29826,28944,28582,27988,27573,27899,201775
98610,3169,2939,2820,2810,2746,2823,2871,20178
98611,10174,10082,10021,10402,9529,9295,9133,68636
98612,2676,2476,2618,2569,2498,2669,2704,18210
98613,457,554,630,546,526,724,400,3837
98614,179,268,198,253,227,257,353,1735
98616,174,153,186,189,157,91,150,1100
98617,1487,1122,1090,1103,1298,1136,1042,8278
98619,498,503,484,509,533,473,457,3457
98620,7095,7087,7114,7785,7585,7650,7123,51439
98621,510,474,540,567,593,365,276,3325
98624,1728,1660,1578,1466,1393,1213,1532,10570
98625,6846,6514,6590,6923,6197,6008,6133,45211
98626,24068,24255,24352,23927,24538,24266,24523,169929
98628,454,481,413,307,420,393,385,2853
98629,8382,8597,8479,8716,8536,8166,8364,59240
98631,3595,3470,3659,3656,3549,3275,3243,24447
98632,48512,49119,48647,48786,49014,49245,49205,342528
98635,1637,1850,1730,1644,1610,1658,1735,11864
98638,1225,1301,1365,1422,1451,1628,1525,9917
98639,1033,1127,964,848,810,647,847,6276
98640,3942,3907,3772,3982,4039,4383,4380,28405
98641,0,0,0,0,0,0,5,5
98642,17519,16769,16294,15973,15420,15386,15696,113057
98643,425,495,436,457,517,461,362,3153
98644,332,353,338,439,524,458,473,2917
98645,1263,1359,1193,1276,1337,1182,1429,9039
98647,249,364,247,242,225,335,404,2066
98648,2775,2668,2836,2971,3098,3505,3100,20953
98649,1195,1026,1182,1052,1000,1038,895,7388
98650,996,1008,876,999,819,855,959,6512
98651,816,847,814,877,869,550,939,5712
98660,12359,11893,12345,12539,12032,11956,11858,84982
98661,44829,44144,42480,42097,41954,41988,41740,299232
98662,32457,33427,33688,33132,32273,31465,31644,228086
98663,13427,13317,13566,12925,13604,13625,14115,94579
98664,22018,21439,21205,21361,21641,21829,21771,151264
98665,26275,25550,24496,23462,22923,23519,24057,170282
98670,73,94,91,84,110,111,113,676
98671,22896,22849,22633,22496,21969,20977,21220,155040
98672,6065,5941,5731,5237,5086,5106,6146,39312
98673,570,459,422,414,406,388,404,3063
98674,11776,10973,11174,10836,11559,12008,12029,80355
98675,7395,6895,7335,6844,6497,6267,6713,47946
98682,56211,56243,56326,55759,55129,53994,52893,386555
98683,33652,32567,31908,31182,30769,30305,30832,221215
98684,27550,27661,27442,28078,27179,26922,26968,191800
98685,28145,27977,26954,26528,26691,26323,26217,188835
98686,19212,18513,18060,18362,17783,16770,17385,126085
98801,42670,42041,41526,41416,40522,40383,40977,289535
98802,29791,29224,28672,28557,28477,28045,28719,201485
98811,39,70,87,95,102,107,71,571
98812,5098,5215,4799,4456,4466,4137,4899,33070
98813,3017,3050,3189,3409,3479,3184,3176,22504
98814,376,287,345,346,420,448,466,2688
98815,7444,7580,7335,7105,7432,7082,7233,51211
98816,6504,6720,6986,6929,6867,6805,6394,47205
98817,274,306,429,403,566,966,366,3310
98819,193,172,153,123,144,161,258,1204
98821,362,415,327,576,566,576,519,3341
98822,2057,2118,2093,2143,2359,2075,1953,14798
98823,11336,11177,10821,10982,10423,10326,11055,76120
98824,502,442,453,340,340,174,181,2432
98826,6827,6467,6639,6438,6057,5935,6504,44867
98827,274,695,676,750,572,672,312,3951
98828,2900,2740,2310,1785,1774,1934,2146,15589
98829,694,670,750,645,486,306,564,4115
98830,464,461,507,434,457,602,494,3419
98831,2931,3309,3446,3522,3626,3558,3708,24100
98832,334,318,263,285,156,151,320,1827
98833,143,123,190,152,208,192,150,1158
98834,154,182,200,177,218,165,239,1335
98836,948,800,1058,764,671,714,584,5539
98837,41130,40741,40917,40819,40860,40062,39722,284251
98840,4563,4692,4652,4932,4837,5041,4851,33568
98841,8538,8926,8803,8819,8920,9237,9197,62440
98843,1894,1826,1611,1588,1419,1691,1817,11846
98844,4532,4608,4483,4341,4513,4609,4740,31826
98845,231,181,233,221,173,166,128,1333
98846,1344,1247,1114,1137,1077,944,1173,8036
98847,1814,1714,1617,2047,2060,1785,1920,12957
98848,12234,12200,11991,12323,11980,11651,11518,83897
98849,1250,1117,1436,1531,1551,1736,1078,9699
98850,1394,1561,1555,1450,1514,1618,1543,10635
98851,3904,4102,3930,3539,3493,3757,4014,26739
98852,15,15,7,15,24,34,104,214
98853,14,2,2,2,5,6,23,54
98855,6559,6322,6415,6380,6458,5993,5863,43990
98856,2631,2395,2403,2448,2110,2203,2464,16654
98857,3829,3888,3983,4088,4135,3853,4082,27858
98858,2285,2324,2300,2046,1841,1604,1521,13921
98859,197,136,164,144,192,213,238,1284
98860,311,214,252,322,318,279,259,1955
98862,2360,2237,2147,2050,2100,1731,2218,14843
98901,32349,31011,29800,29573,29745,29186,30169,211833
98902,46300,46913,46904,46412,46682,46674,46322,326207
98903,14299,14411,15341,15194,14845,14549,14517,103156
98908,35660,35427,35926,36063,35331,34857,35240,248504
98921,963,1063,1222,648,548,230,516,5190
98922,5959,5725,5734,5668,5145,5512,5468,39211
98923,1555,1396,1053,1213,969,1141,1434,8761
98925,517,535,578,489,524,568,689,3900
98926,31848,31108,30624,30484,30841,30430,30239,215574
98929,0,0,0,0,0,0,0,0
98930,16599,17168,16904,16725,16347,15970,15252,114965
98932,5079,4953,4986,5086,4959,5092,5032,35187
98933,1172,1222,1296,1112,1113,986,1267,8168
98934,1057,1158,1019,1030,1149,1022,1117,7552
98935,3364,3359,3305,3575,3843,3729,4190,25365
98936,5929,5991,5562,5826,5645,5692,5872,40517
98937,3646,3889,3838,3879,3967,3857,4112,27188
98938,3518,2852,2593,1945,1475,1386,2177,15946
98939,89,125,93,163,235,317,167,1189
98940,385,383,572,550,502,423,760,3575
98941,788,911,947,901,1019,918,919,6403
98942,17015,17178,16724,16869,16074,15898,16973,116731
98943,977,936,827,760,688,646,660,5494
98944,22554,22186,22693,22498,22205,21913,22014,156063
98946,545,595,588,574,525,500,495,3822
98947,3119,3102,3036,2615,2831,2865,2902,20470
98948,13196,13098,13067,13596,13273,13280,13225,92735
98950,475,555,563,583,263,102,177,2718
98951,13582,13674,13816,13854,13964,13662,13739,96291
98952,2221,2146,2293,2295,2536,2307,2330,16128
98953,6936,7520,7113,6878,7078,7432,6681,49638
99001,6553,6500,6227,6095,6035,5847,6151,43408
99003,4744,4736,5130,4654,4998,4760,4848,33870
99004,19492,18719,18234,18162,17763,17713,18376,128459
99005,8488,8772,8291,8422,8435,8421,8574,59403
99006,12155,11509,10903,10999,10665,11266,11946,79443
99008,1242,941,594,684,559,368,641,5029
99009,3739,3788,4055,4731,4732,4272,3947,29264
99011,2904,2947,3097,3092,3262,3223,2776,21301
99012,787,931,1051,1087,1211,1230,1064,7361
99013,1566,1621,1811,1836,1851,1874,1785,12344
99016,13634,13290,12908,12912,12621,11951,12480,89796
99017,155,189,191,185,197,182,161,1260
99018,313,308,306,337,288,214,282,2048
99019,10594,10134,9681,10227,9939,9903,9502,69980
99020,0,15,15,66,104,145,82,427
99021,8765,8752,8897,9180,9160,8965,9174,62893
99022,8890,9071,9088,8974,8670,8493,8820,62006
99023,720,662,605,495,407,228,529,3646
99025,5067,5270,5029,4946,4771,4719,5232,35034
99026,10002,9990,9888,8921,8735,8629,9042,65207
99027,6169,6258,6187,6138,6270,6153,6101,43276
99029,1341,1331,1512,1551,1686,1443,1289,10153
99030,942,869,980,967,1087,1234,1032,7111
99031,1058,961,915,803,722,822,1137,6418
99032,710,780,692,720,667,722,691,4982
99033,1020,989,962,861,847,908,895,6482
99034,2,82,131,208,208,197,209,1037
99036,1528,1420,1255,1184,1197,1309,1448,9341
99037,12928,12646,12604,12387,13306,13039,12973,89883
99039,72,85,100,95,78,74,87,591
99040,731,759,644,585,554,466,734,4473
99101,1564,1574,1645,1474,1685,1643,1453,11038
99102,556,490,444,519,442,421,500,3372
99103,538,525,478,481,446,362,497,3327
99105,49,42,50,33,42,27,61,304
99109,5245,5308,5120,5178,4972,4853,5109,35785
99110,1482,1351,1589,1568,1596,1911,1667,11164
99111,4269,4137,4226,4095,4151,4300,4047,29225
99113,750,719,652,624,649,548,761,4703
99114,11764,11552,11689,12132,12289,12281,12018,83725
99115,1303,1318,1309,1119,1066,1015,1143,8273
99116,1600,1670,1665,1988,1859,2017,1439,12238
99117,449,430,498,537,523,611,485,3533
99118,882,913,850,836,921,988,931,6321
99119,1209,971,948,1006,1169,1048,1204,7555
99121,119,135,160,164,182,293,145,1198
99122,3509,3399,3458,3695,3742,3817,3773,25393
99123,935,1205,1209,1159,1293,1614,1058,8473
99124,328,307,317,340,355,343,240,2230
99125,461,460,504,511,583,581,527,3627
99126,1154,1223,1050,1100,1194,1064,877,7662
99128,209,333,368,396,468,482,321,2577
99129,832,837,829,810,722,703,793,5526
99130,779,717,725,741,723,727,828,5240
99131,156,128,153,166,175,160,170,1108
99133,1675,1833,1562,1645,1670,1593,1493,11471
99134,468,600,648,551,565,610,643,4085
99135,363,282,260,267,167,191,255,1785
99136,27,35,33,44,34,43,29,245
99137,340,315,316,278,276,294,343,2162
99138,1224,1181,1195,1258,1074,1151,1209,8292
99139,1455,1430,1424,1384,1204,1345,1301,9543
99140,435,404,409,360,382,407,475,2872
99141,5140,4948,5263,5260,5171,5034,5240,36056
99143,640,613,631,552,574,609,650,4269
99144,27,18,37,34,56,71,43,286
99146,77,78,89,60,91,62,56,513
99147,129,116,115,131,124,162,190,967
99148,1889,2035,1999,2199,2124,1996,2106,14348
99149,180,168,173,182,153,129,208,1193
99150,395,260,253,248,266,310,380,2112
99151,132,145,153,155,134,123,164,1006
99152,160,206,195,206,211,234,197,1409
99153,390,349,379,385,505,574,467,3049
99154,36,37,31,19,8,11,20,162
99155,1137,950,1129,1001,957,964,1350,7488
99156,8122,8167,8256,8260,8058,7994,8114,56971
99157,817,845,842,905,835,782,697,5723
99158,653,737,710,685,595,494,603,4477
99159,1482,1420,1354,1479,1306,1444,1375,9860
99160,116,140,127,125,108,104,149,869
99161,1422,1436,1422,1371,1350,1239,1400,9640
99163,33822,33097,32285,32148,31579,30790,31404,225125
99164,0,0,1,2,3,4,0,10
99166,3174,3509,3606,3652,3721,3593,3222,24477
99167,532,584,659,650,590,667,625,4307
99169,2521,2577,2780,2822,2911,2668,2459,18738
99170,992,1026,1000,1005,1095,1193,1072,7383
99171,938,1035,979,963,988,1008,959,6870
99173,1774,1710,1595,1588,1601,1320,1532,11120
99174,51,45,61,61,67,64,44,393
99176,183,179,197,191,164,186,145,1245
99179,547,556,603,562,563,475,437,3743
99180,1015,1125,1030,982,1079,962,939,7132
99181,1808,1864,1850,1836,1749,1763,1901,12771
99185,1267,1161,1178,1096,1153,1178,1295,8328
99201,13634,13901,13884,12761,12945,12523,13342,92990
99202,19730,18882,19814,20707,20895,22350,21580,143958
99203,20994,21149,20721,20361,20324,19992,20192,143733
99204,5832,6205,6521,6958,6824,6831,6681,45852
99205,43031,41693,41347,42064,42036,42371,42137,294679
99206,36768,36964,36760,36010,35821,35721,34802,252846
99207,29652,30907,30559,29868,29723,29273,30854,210836
99208,52316,51734,50686,50372,49284,47741,49193,351326
99212,19090,19235,19129,19459,19150,19133,19197,134393
99216,25259,24384,24089,23571,23294,24010,24362,168969
99217,18864,17789,18241,17720,17173,16831,17423,124041
99218,16255,16020,15975,15334,15785,15514,15531,110414
99223,31331,30630,30757,29918,30023,30524,29273,212456
99224,21048,21379,20531,20500,19485,18179,18289,139411
99301,76388,75273,74025,71473,69086,66100,68191,500536
99320,9122,8737,8791,8738,8589,8578,9201,61756
99321,528,621,661,734,919,675,531,4669
99322,207,174,215,229,296,275,217,1613
99323,3594,3518,3451,3516,3646,3575,3684,24984
99324,9522,9422,9273,9143,8816,8709,9202,64087
99326,6178,6283,5912,5689,5107,4806,4956,38931
99328,3683,3713,3753,3830,3759,3727,3733,26198
99329,222,218,192,183,130,117,160,1222
99330,993,1070,806,680,568,636,907,5660
99333,24,34,38,46,42,81,50,315
99335,301,291,245,390,481,376,340,2424
99336,50529,50065,49982,48749,48276,47229,48753,343583
99337,30222,30726,29798,30233,29968,29974,29845,210766
99338,14698,13534,12914,12244,11701,11119,11555,87765
99341,744,720,786,795,771,848,884,5548
99343,3491,3271,3115,3003,3000,2551,3040,21471
99344,17311,17161,17064,16898,16341,16525,16817,118117
99345,170,202,192,202,281,273,213,1533
99346,457,436,367,545,401,329,352,2887
99347,2310,2272,2315,2287,2292,2307,2293,16076
99348,1249,1383,1709,1811,1857,2011,1364,11384
99349,8842,8755,8538,8076,7689,7384,8483,57767
99350,13359,13629,14387,13636,12962,12447,12979,93399
99352,29963,29180,28409,27833,27785,26742,26975,196887
99353,14952,14595,14124,13652,13478,13061,13306,97168
99354,22911,22898,22653,22294,21173,20754,21343,154026
99356,231,260,285,254,392,288,294,2004
99357,4287,3953,4005,3294,3462,3524,4323,26848
99359,117,107,107,70,98,94,158,751
99360,1402,1163,1345,1274,1250,1222,1350,9006
99361,1747,1707,1600,1715,1764,1745,1902,12180
99362,41752,42086,41952,41513,41274,40856,41056,290489
99363,394,302,21,20,0,22,216,975
99371,414,365,364,311,224,232,311,2221
99401,264,294,237,209,231,204,273,1712
99402,1794,1831,1904,1749,1619,1635,1875,12407
99403,20080,19988,19886,19917,19880,19751,19548,139050
99501,17130,17213,16976,16521,16693,16585,17603,118721
99502,24253,23649,24012,24059,24122,24061,24168,168324
99503,14148,14107,14661,14042,14242,13604,14563,99367
99504,42908,42189,41365,40824,40786,39662,40914,288648
99505,6240,6479,6766,6649,6327,6859,6174,45494
99506,7094,7541,7531,7499,7213,6655,7749,51282
99507,39460,40013,39555,39015,39010,38769,37850,273672
99508,34649,35437,35135,36534,35835,36048,35857,249495
99510,362,332,315,289,257,339,353,2247
99513,0,0,0,0,0,0,0,0
99515,23747,22661,22530,22821,22097,22033,22441,158330
99516,21775,21459,21671,20781,20818,20125,20095,146724
99517,17226,16809,16797,16442,15527,15635,16645,115081
99518,9872,10285,10321,10786,10804,10654,10225,72947
99519,542,589,1005,868,745,432,1316,5497
99540,286,374,324,291,324,224,320,2143
99546,122,122,114,108,127,124,326,1043
99547,51,66,66,60,87,60,61,451
99548,71,70,58,60,66,83,73,481
99549,73,81,84,69,70,75,102,554
99550,240,231,230,238,259,251,197,1646
99551,584,562,590,606,638,644,627,4251
99552,407,399,407,392,364,331,346,2646
99553,782,899,896,951,932,946,1027,6433
99554,737,777,733,675,570,533,677,4702
99555,189,199,231,208,208,254,221,1510
99556,2595,2497,2710,2742,2694,2671,2510,18419
99557,693,696,714,728,701,721,726,4979
99558,86,87,86,99,94,102,85,639
99559,7907,7869,7808,7769,7693,7571,7632,54249
99561,507,516,474,493,489,451,418,3348
99563,1194,1082,986,1062,953,943,938,7158
99564,40,70,86,101,116,142,91,646
99565,59,73,60,72,76,77,78,495
99566,104,189,213,194,248,218,192,1358
99567,9651,9853,10090,9544,9256,8610,9211,66215
99568,321,275,224,197,198,118,279,1612
99569,47,56,75,84,72,63,64,461
99571,106,88,83,101,82,55,160,675
99572,502,457,323,227,315,531,296,2651
99573,763,799,794,816,798,788,1115,5873
99574,3099,2696,2721,2692,2548,2475,2348,18579
99575,65,98,104,120,152,148,105,792
99576,2467,2464,2445,2400,2471,2535,2603,17385
99577,28317,28565,27955,27158,26446,26143,25771,190355
99578,472,455,425,349,281,204,296,2482
99579,80,68,74,55,47,25,109,458
99580,79,78,100,139,119,161,115,791
99581,808,835,819,858,847,823,762,5752
99583,64,37,31,15,18,15,35,215
99585,343,350,320,344,365,362,417,2501
99586,309,463,519,623,644,682,605,3845
99587,2271,2255,2446,2278,1975,1726,2250,15201
99588,657,936,879,854,980,1033,980,6319
99589,216,230,237,331,353,372,243,1982
99590,165,171,151,171,186,215,194,1253
99591,74,53,33,62,88,118,102,530
99602,216,214,209,221,183,202,178,1423
99603,10389,10130,9894,9628,9518,9378,9840,68777
99604,1114,1140,1259,1222,1195,1270,1093,8293
99605,108,65,89,119,98,141,211,831
99606,374,382,369,376,401,371,469,2742
99607,264,284,257,231,228,231,216,1711
99609,635,599,537,532,557,555,569,3984
99610,2010,2326,2340,2399,2240,2075,2167,15557
99611,16271,15811,15549,15779,15671,15455,15122,109658
99612,1080,1074,900,831,892,844,938,6559
99613,400,392,375,310,360,432,434,2703
99614,682,686,700,644,626,553,639,4530
99615,13135,13197,13096,13009,12770,12609,12899,90715
99620,662,643,636,572,565,565,577,4220
99621,787,824,763,702,705,672,723,5176
99622,332,331,325,317,252,275,321,2153
99624,47,61,52,74,95,78,90,497
99625,97,114,131,123,112,89,72,738
99626,280,312,334,297,267,286,282,2058
99627,383,397,401,429,416,474,406,2906
99628,787,691,673,588,475,383,443,4040
99630,191,174,177,190,173,177,191,1273
99631,354,428,464,464,348,256,228,2542
99632,838,749,781,760,768,758,813,5467
99633,544,567,600,600,578,586,544,4019
99634,404,352,365,364,340,358,354,2537
99636,566,609,574,563,521,518,510,3861
99637,503,549,650,671,650,682,590,4295
99638,30,37,34,39,30,40,18,228
99639,983,966,956,912,863,691,1131,6502
99640,191,187,220,192,208,223,174,1395
99641,642,554,459,420,403,416,496,3390
99643,302,249,268,229,243,221,218,1730
99644,194,235,278,300,343,329,175,1854
99645,28127,27818,26573,26202,24992,24754,25176,183642
99647,13,12,22,26,26,18,44,161
99648,94,98,116,123,98,104,113,746
99649,63,65,60,58,71,42,80,439
99650,600,582,567,521,510,493,568,3841
99651,28,42,42,62,53,44,61,332
99652,3863,4059,4235,4347,4071,4029,3703,28307
99653,156,147,147,138,158,203,159,1108
99654,58889,56325,55319,53456,52551,50944,52168,379652
99655,729,661,616,596,635,645,669,4551
99656,33,22,32,32,27,20,25,191
99657,401,410,404,360,402,357,329,2663
99658,649,719,687,678,704,651,616,4704
99659,446,396,406,385,393,367,401,2794
99660,525,576,612,675,643,716,479,4226
99661,1267,1206,1386,1243,1190,1224,978,8494
99662,529,498,454,491,534,543,480,3529
99663,445,475,486,491,449,397,414,3157
99664,4467,4892,5255,5073,5014,5392,4932,35025
99665,59,43,58,74,64,94,83,475
99666,118,129,132,135,143,175,189,1021
99667,96,71,61,50,35,24,65,402
99668,84,94,98,85,77,80,86,604
99669,15159,14464,14174,14572,14178,13775,14191,100513
99670,55,63,60,57,57,68,79,439
99671,513,547,538,591,576,572,556,3893
99672,3569,4035,3820,3157,3423,3466,3704,25174
99674,1358,1370,1241,1207,1315,1261,1444,9196
99676,1578,1372,1383,1392,1329,1245,1546,9845
99677,132,86,69,62,47,58,88,542
99678,845,882,858,941,1021,931,891,6369
99679,431,436,421,418,433,454,373,2966
99680,447,466,437,376,409,358,408,2901
99681,315,294,297,277,312,367,325,2187
99682,464,400,403,403,465,372,373,2880
99683,398,529,544,591,604,484,524,3674
99684,705,720,716,699,743,692,688,4963
99685,4452,4386,4321,4207,4167,4110,4224,29867
99686,3934,3982,4007,4000,3976,3956,4005,27860
99688,2755,2837,2645,2663,2834,2656,2759,19149
99689,618,597,587,569,570,633,662,4236
99690,233,259,281,331,343,336,280,2063
99691,120,113,75,66,47,63,95,579
99692,258,233,215,155,95,47,152,1155
99693,320,299,252,244,222,238,248,1823
99694,1586,1608,1678,1457,1438,1342,1512,10621
99695,0,0,0,0,0,0,7,7
99701,18758,18900,18575,19067,18748,18651,19019,131718
99702,2826,2630,2647,2584,2628,2814,2647,18776
99703,7926,7726,7764,7348,6968,6548,7065,51345
99704,37,41,20,30,37,20,24,209
99705,23539,24421,24311,24098,23904,22224,22544,165041
99706,3,0,0,0,0,0,13,16
99709,32355,31594,31658,31376,31235,31289,29830,219337
99712,12339,12016,12134,11945,11798,12482,13866,86580
99714,1193,1102,1084,1025,1164,1152,1385,8105
99720,178,145,145,137,126,154,208,1093
99721,273,247,233,304,344,407,324,2132
99722,137,138,118,127,104,84,152,860
99723,4377,4351,4321,4303,4224,4154,4213,29943
99724,46,60,86,98,88,77,84,539
99726,47,38,32,38,64,54,30,303
99727,616,596,582,577,527,483,416,3797
99729,219,222,197,195,180,168,231,1412
99730,45,59,110,124,122,159,144,763
99732,0,0,0,0,0,0,10,10
99733,116,118,103,103,74,61,104,679
99734,1970,2122,1566,1250,831,233,845,8817
99736,150,144,128,97,87,68,122,796
99737,4983,5005,5037,4964,5012,4796,5011,34808
99738,105,106,85,131,155,138,187,907
99739,300,328,319,358,354,363,330,2352
99740,582,565,522,516,517,540,585,3827
99741,524,554,539,566,559,526,470,3738
99742,690,718,702,757,719,747,681,5014
99743,1115,1130,1159,1109,1013,937,1069,7532
99744,131,160,192,188,208,383,226,1488
99745,83,62,63,61,80,80,78,507
99746,443,429,388,336,352,273,277,2498
99747,166,155,176,208,258,393,239,1595
99748,152,192,200,196,193,187,190,1310
99749,342,380,371,391,348,347,363,2542
99750,671,576,532,448,453,377,374,3431
99751,137,159,159,130,121,95,151,952
99752,3379,3381,3428,3503,3596,3650,3553,24490
99753,261,272,265,279,340,329,332,2078
99754,79,80,89,104,112,110,96,670
99755,619,514,429,422,359,262,217,2822
99756,86,89,80,79,92,74,119,619
99757,32,24,23,19,16,0,17,131
99758,213,257,252,217,239,184,210,1572
99759,306,285,246,274,301,314,189,1915
99760,644,691,851,908,976,856,785,5711
99761,403,443,452,442,465,525,514,3244
99762,4218,4146,4084,4008,3980,3854,4038,28328
99763,605,608,598,692,708,648,668,4527
99764,339,346,305,271,322,395,290,2268
99765,286,285,272,278,289,276,264,1950
99766,625,562,628,718,894,1139,678,5244
99767,10,7,15,20,20,38,24,134
99768,214,202,208,209,224,221,175,1453
99769,932,883,872,828,726,701,671,5613
99770,807,794,754,693,688,703,841,5280
99771,246,223,212,209,233,245,251,1619
99772,611,640,699,623,633,659,567,4432
99773,290,342,308,361,368,376,262,2307
99774,20,25,69,66,61,65,78,384
99775,1290,1346,1179,1146,1008,892,1251,8112
99776,157,120,154,116,132,101,124,904
99777,279,277,248,261,252,303,246,1866
99778,206,205,227,267,274,311,254,1744
99780,1594,1660,1724,1783,1569,1717,1535,11582
99781,171,177,171,168,160,138,167,1152
99782,488,458,482,540,645,764,556,3933
99783,166,155,165,118,108,118,145,975
99784,168,179,148,166,164,159,190,1174
99785,417,442,439,407,337,326,388,2756
99786,295,280,329,290,240,260,259,1953
99788,120,101,85,65,59,50,69,549
99789,347,345,371,405,487,564,402,2921
99790,7,20,20,43,58,62,20,230
99791,167,159,219,276,290,325,237,1673
99801,30205,30262,29855,29639,29356,29056,29164,207537
99820,459,408,425,457,427,427,479,3082
99824,2299,2249,2328,2242,2263,2188,2111,15680
99825,70,100,109,91,67,64,120,621
99826,472,496,529,538,511,454,442,3442
99827,2592,2626,2623,2656,2629,2632,2602,18360
99829,774,821,818,775,760,774,777,5499
99830,644,628,592,487,413,470,561,3795
99832,96,87,62,64,110,113,104,636
99833,3196,3221,3212,3277,3380,3278,3202,22766
99835,8921,8943,8957,8945,8909,8879,8880,62434
99836,42,31,30,42,29,83,52,309
99840,1014,999,996,1080,1050,1105,968,7212
99841,172,150,117,106,138,77,133,893
99901,13745,13717,13694,13651,13577,13458,13508,95350
99903,16,22,29,30,7,32,31,167
99918,193,162,141,130,102,75,231,1034
99919,718,637,603,528,558,534,531,4109
99921,1800,1950,2123,2104,2031,2100,1920,14028
99922,291,277,356,364,411,431,384,2514
99923,0,13,12,81,77,116,87,386
99925,908,826,728,668,673,689,819,5311
99926,1667,1711,1622,1630,1624,1488,1460,11202
99927,81,123,131,111,75,67,94,682
99929,2385,2365,2354,2341,2361,2321,2338,16465